"Week","Day","Date","Outcome","OT","Record","Home","Opponent","ThisTeamScore","OpponentScore","ThisTeam1D","ThisTeamTotalYards","ThisTeamPassYards","ThisTeamRushYards","ThisTeamTO","Opponent1D","OpponentTotalYards","OpponentPassYards","OpponentRushYards","OpponentTO","GameDate","TODiff","Win","ThisTeam","ScoreDifference"
"1","Sun","September 8","L","","0-1",FALSE,"Los Angeles Raiders",0,31,14,193,131,62,2,19,356,234,122,0,1985-09-08,-2,0,"nyj",-31
"2","Sun","September 15","W","","1-1",TRUE,"Buffalo Bills",42,3,27,532,244,288,0,16,270,188,82,5,1985-09-15,5,1,"nyj",39
"3","Sun","September 22","W","","2-1",FALSE,"Green Bay Packers",24,3,15,226,120,106,0,10,193,122,71,4,1985-09-22,4,1,"nyj",21
"4","Sun","September 29","W","","3-1",TRUE,"Indianapolis Colts",25,20,23,392,227,165,1,17,320,217,103,1,1985-09-29,0,1,"nyj",5
"5","Sun","October 6","W","","4-1",FALSE,"Cincinnati Bengals",29,20,21,255,178,77,1,25,301,212,89,1,1985-10-06,0,1,"nyj",9
"6","Mon","October 14","W","","5-1",TRUE,"Miami Dolphins",23,7,27,476,231,245,0,13,200,126,74,1,1985-10-14,1,1,"nyj",16
"7","Sun","October 20","L","","5-2",FALSE,"New England Patriots",13,20,13,303,220,83,3,20,284,155,129,1,1985-10-20,-2,0,"nyj",-7
"8","Sun","October 27","W","","6-2",TRUE,"Seattle Seahawks",17,14,22,335,123,212,3,14,252,114,138,3,1985-10-27,0,1,"nyj",3
"9","Sun","November 3","W","","7-2",FALSE,"Indianapolis Colts",35,17,19,349,148,201,3,15,258,205,53,5,1985-11-03,2,1,"nyj",18
"10","Sun","November 10","L","","7-3",FALSE,"Miami Dolphins",17,21,27,491,371,120,2,19,400,347,53,5,1985-11-10,3,0,"nyj",-4
"11","Sun","November 17","W","","8-3",TRUE,"Tampa Bay Buccaneers",62,28,35,581,379,202,3,15,212,190,22,5,1985-11-17,2,1,"nyj",34
"12","Sun","November 24","W","OT","9-3",TRUE,"New England Patriots",16,13,20,401,291,110,2,21,399,225,174,2,1985-11-24,0,1,"nyj",3
"13","Thu","November 28","L","","9-4",FALSE,"Detroit Lions",20,31,23,357,239,118,2,18,330,264,66,1,1985-11-28,-1,0,"nyj",-11
"14","Sun","December 8","W","","10-4",FALSE,"Buffalo Bills",27,7,24,485,367,118,2,22,436,350,86,4,1985-12-08,2,1,"nyj",20
"15","Sat","December 14","L","","10-5",TRUE,"Chicago Bears",6,19,11,159,89,70,3,20,319,203,116,1,1985-12-14,-2,0,"nyj",-13
"16","Sun","December 22","W","","11-5",TRUE,"Cleveland Browns",37,10,23,361,226,135,2,12,242,104,138,3,1985-12-22,1,1,"nyj",27
"WildCard","Sat","December 28","L","","11-6",TRUE,"New England Patriots",14,26,15,240,182,58,4,12,258,159,99,0,1985-12-28,-4,0,"nyj",-12
"1","Sun","September 7","W","","1-0",FALSE,"Buffalo Bills",28,24,19,390,287,103,0,19,368,289,79,2,1986-09-07,2,1,"nyj",4
"2","Thu","September 11","L","","1-1",TRUE,"New England Patriots",6,20,14,221,151,70,3,21,265,138,127,1,1986-09-11,-2,0,"nyj",-14
"3","Sun","September 21","W","OT","2-1",TRUE,"Miami Dolphins",51,45,32,581,449,132,4,27,485,435,50,3,1986-09-21,-1,1,"nyj",6
"4","Sun","September 28","W","","3-1",FALSE,"Indianapolis Colts",26,7,17,251,166,85,5,16,282,230,52,4,1986-09-28,-1,1,"nyj",19
"5","Sun","October 5","W","","4-1",TRUE,"Buffalo Bills",14,13,20,382,272,110,1,16,320,194,126,1,1986-10-05,0,1,"nyj",1
"6","Sun","October 12","W","","5-1",FALSE,"New England Patriots",31,24,24,322,145,177,0,19,400,383,17,2,1986-10-12,2,1,"nyj",7
"7","Mon","October 20","W","","6-1",TRUE,"Denver Broncos",22,10,20,211,74,137,0,19,279,232,47,3,1986-10-20,3,1,"nyj",12
"8","Sun","October 26","W","","7-1",TRUE,"New Orleans Saints",28,23,20,281,226,55,2,21,304,243,61,5,1986-10-26,3,1,"nyj",5
"9","Sun","November 2","W","","8-1",FALSE,"Seattle Seahawks",38,7,22,553,427,126,0,16,322,271,51,3,1986-11-02,3,1,"nyj",31
"10","Sun","November 9","W","","9-1",FALSE,"Atlanta Falcons",28,14,22,426,322,104,0,23,393,305,88,2,1986-11-09,2,1,"nyj",14
"11","Sun","November 16","W","","10-1",TRUE,"Indianapolis Colts",31,16,19,360,218,142,4,23,408,350,58,6,1986-11-16,2,1,"nyj",15
"12","Mon","November 24","L","","10-2",FALSE,"Miami Dolphins",3,45,17,280,191,89,4,31,514,325,189,0,1986-11-24,-4,0,"nyj",-42
"13","Sun","November 30","L","","10-3",TRUE,"Los Angeles Rams",3,17,19,350,261,89,4,14,293,155,138,2,1986-11-30,-2,0,"nyj",-14
"14","Sun","December 7","L","","10-4",FALSE,"San Francisco 49ers",10,24,16,199,161,38,3,27,432,234,198,1,1986-12-07,-2,0,"nyj",-14
"15","Sat","December 13","L","","10-5",TRUE,"Pittsburgh Steelers",24,45,22,369,223,146,4,25,364,189,175,1,1986-12-13,-3,0,"nyj",-21
"16","Sun","December 21","L","","10-6",FALSE,"Cincinnati Bengals",21,52,16,199,73,126,3,32,621,416,205,2,1986-12-21,-1,0,"nyj",-31
"WildCard","Sun","December 28","W","","11-6",TRUE,"Kansas City Chiefs",35,15,19,306,141,165,0,15,241,174,67,3,1986-12-28,3,1,"nyj",20
"Division","Sat","January 3","L","OT","11-7",FALSE,"Cleveland Browns",20,23,14,287,183,104,0,33,558,483,75,2,1987-01-03,2,0,"nyj",-3
"1","Sun","September 13","W","","1-0",FALSE,"Buffalo Bills",31,28,26,394,261,133,1,23,359,292,67,1,1987-09-13,0,1,"nyj",3
"2","Mon","September 21","W","","2-0",TRUE,"New England Patriots",43,24,21,408,281,127,2,17,193,145,48,2,1987-09-21,0,1,"nyj",19
"3","Sun","October 4","L","","2-1",TRUE,"Dallas Cowboys",24,38,22,241,159,82,5,14,246,132,114,4,1987-10-04,-1,0,"nyj",-14
"4","Sun","October 11","L","","2-2",FALSE,"Indianapolis Colts",0,6,16,211,145,66,5,14,270,96,174,2,1987-10-11,-3,0,"nyj",-6
"5","Sun","October 18","W","OT","3-2",TRUE,"Miami Dolphins",37,31,24,477,294,183,5,30,414,286,128,6,1987-10-18,1,1,"nyj",6
"6","Sun","October 25","L","","3-3",FALSE,"Washington Redskins",16,17,14,200,126,74,1,16,378,275,103,2,1987-10-25,1,0,"nyj",-1
"7","Sun","November 1","L","","3-4",TRUE,"Indianapolis Colts",14,19,15,230,129,101,3,21,377,191,186,0,1987-11-01,-3,0,"nyj",-5
"8","Mon","November 9","W","","4-4",TRUE,"Seattle Seahawks",30,14,23,342,210,132,1,17,275,164,111,4,1987-11-09,3,1,"nyj",16
"9","Sun","November 15","W","","5-4",FALSE,"Kansas City Chiefs",16,9,19,329,102,227,0,18,299,195,104,3,1987-11-15,3,1,"nyj",7
"10","Sun","November 22","L","","5-5",TRUE,"Buffalo Bills",14,17,21,318,192,126,1,15,331,204,127,1,1987-11-22,0,0,"nyj",-3
"11","Sun","November 29","W","","6-5",TRUE,"Cincinnati Bengals",27,20,20,328,205,123,2,21,339,233,106,2,1987-11-29,0,1,"nyj",7
"12","Mon","December 7","L","","6-6",FALSE,"Miami Dolphins",28,37,13,256,216,40,2,30,432,293,139,1,1987-12-07,-1,0,"nyj",-9
"13","Sun","December 13","L","","6-7",FALSE,"New England Patriots",20,42,24,308,197,111,3,19,300,171,129,0,1987-12-13,-3,0,"nyj",-22
"14","Sun","December 20","L","","6-8",TRUE,"Philadelphia Eagles",27,38,21,354,276,78,3,22,408,265,143,1,1987-12-20,-2,0,"nyj",-11
"15","Sun","December 27","L","","6-9",FALSE,"New York Giants",7,20,13,234,166,68,0,23,420,264,156,0,1987-12-27,0,0,"nyj",-13
"1","Sun","September 4","L","","0-1",FALSE,"New England Patriots",3,28,16,179,92,87,2,20,343,249,94,2,1988-09-04,0,0,"nyj",-25
"2","Sun","September 11","W","","1-1",FALSE,"Cleveland Browns",23,3,22,402,248,154,1,12,222,186,36,3,1988-09-11,2,1,"nyj",20
"3","Sun","September 18","W","","2-1",TRUE,"Houston Oilers",45,3,28,395,302,93,1,15,237,102,135,4,1988-09-18,3,1,"nyj",42
"4","Sun","September 25","W","","3-1",FALSE,"Detroit Lions",17,10,19,316,230,86,1,12,183,97,86,1,1988-09-25,0,1,"nyj",7
"5","Sun","October 2","T","OT","3-1-1",TRUE,"Kansas City Chiefs",17,17,31,542,270,272,4,17,385,261,124,2,1988-10-02,-2,0,"nyj",0
"6","Sun","October 9","L","","3-2-1",FALSE,"Cincinnati Bengals",19,36,16,226,117,109,1,23,402,196,206,2,1988-10-09,1,0,"nyj",-17
"7","Mon","October 17","L","","3-3-1",TRUE,"Buffalo Bills",14,37,10,199,154,45,2,24,427,292,135,1,1988-10-17,-1,0,"nyj",-23
"8","Sun","October 23","W","","4-3-1",FALSE,"Miami Dolphins",44,30,24,333,174,159,1,29,584,521,63,6,1988-10-23,5,1,"nyj",14
"9","Sun","October 30","W","","5-3-1",TRUE,"Pittsburgh Steelers",24,20,15,196,112,84,1,15,352,209,143,4,1988-10-30,3,1,"nyj",4
"10","Sun","November 6","L","","5-4-1",FALSE,"Indianapolis Colts",14,38,20,273,182,91,2,22,336,196,140,3,1988-11-06,1,0,"nyj",-24
"11","Sun","November 13","L","","5-5-1",TRUE,"New England Patriots",13,14,17,298,109,189,3,13,255,78,177,3,1988-11-13,0,0,"nyj",-1
"12","Sun","November 20","L","OT","5-6-1",FALSE,"Buffalo Bills",6,9,16,259,119,140,1,20,341,112,229,2,1988-11-20,1,0,"nyj",-3
"13","Sun","November 27","W","","6-6-1",TRUE,"Miami Dolphins",38,34,39,597,426,171,2,20,440,353,87,1,1988-11-27,-1,1,"nyj",4
"14","Sun","December 4","L","","6-7-1",FALSE,"Kansas City Chiefs",34,38,21,371,192,179,2,26,430,267,163,2,1988-12-04,0,0,"nyj",-4
"15","Sat","December 10","W","","7-7-1",TRUE,"Indianapolis Colts",34,16,22,331,158,173,3,18,329,220,109,3,1988-12-10,0,1,"nyj",18
"16","Sun","December 18","W","","8-7-1",TRUE,"New York Giants",27,21,15,298,198,100,0,24,367,170,197,1,1988-12-18,1,1,"nyj",6
"1","Sun","September 10","L","","0-1",TRUE,"New England Patriots",24,27,14,304,255,49,1,26,427,273,154,3,1989-09-10,2,0,"nyj",-3
"2","Sun","September 17","L","","0-2",FALSE,"Cleveland Browns",24,38,21,382,246,136,4,18,277,192,85,1,1989-09-17,-3,0,"nyj",-14
"3","Sun","September 24","W","","1-2",FALSE,"Miami Dolphins",40,33,25,411,309,102,2,30,524,446,78,2,1989-09-24,0,1,"nyj",7
"4","Sun","October 1","L","","1-3",TRUE,"Indianapolis Colts",10,17,18,245,182,63,2,17,316,242,74,2,1989-10-01,0,0,"nyj",-7
"5","Mon","October 9","L","","1-4",TRUE,"Los Angeles Raiders",7,14,20,392,302,90,2,14,315,185,130,1,1989-10-09,-1,0,"nyj",-7
"6","Sun","October 15","L","","1-5",FALSE,"New Orleans Saints",14,29,15,251,199,52,4,20,418,266,152,4,1989-10-15,0,0,"nyj",-15
"7","Sun","October 22","L","","1-6",FALSE,"Buffalo Bills",3,34,9,154,115,39,3,22,343,139,204,0,1989-10-22,-3,0,"nyj",-31
"8","Sun","October 29","L","","1-7",TRUE,"San Francisco 49ers",10,23,19,251,121,130,2,20,399,240,159,1,1989-10-29,-1,0,"nyj",-13
"9","Sun","November 5","W","","2-7",FALSE,"New England Patriots",27,26,19,486,374,112,0,27,453,318,135,1,1989-11-05,1,1,"nyj",1
"10","Sun","November 12","L","","2-8",TRUE,"Miami Dolphins",23,31,23,410,274,136,3,19,447,344,103,3,1989-11-12,0,0,"nyj",-8
"11","Sun","November 19","L","","2-9",FALSE,"Indianapolis Colts",10,27,22,354,244,110,3,23,424,239,185,0,1989-11-19,-3,0,"nyj",-17
"12","Sun","November 26","W","","3-9",TRUE,"Atlanta Falcons",27,7,24,318,138,180,2,12,213,147,66,1,1989-11-26,-1,1,"nyj",20
"13","Sun","December 3","W","","4-9",FALSE,"San Diego Chargers",20,17,19,249,68,181,4,14,258,187,71,2,1989-12-03,-2,1,"nyj",3
"14","Sun","December 10","L","","4-10",TRUE,"Pittsburgh Steelers",0,13,19,313,243,70,3,17,317,160,157,1,1989-12-10,-2,0,"nyj",-13
"15","Sun","December 17","L","","4-11",FALSE,"Los Angeles Rams",14,38,14,291,199,92,4,21,422,272,150,1,1989-12-17,-3,0,"nyj",-24
"16","Sat","December 23","L","","4-12",TRUE,"Buffalo Bills",0,37,11,200,146,54,2,28,441,208,233,1,1989-12-23,-1,0,"nyj",-37
"1","Sun","September 9","L","","0-1",FALSE,"Cincinnati Bengals",20,25,21,342,270,72,3,18,303,192,111,2,1990-09-09,-1,0,"nyj",-5
"2","Sun","September 16","W","","1-1",TRUE,"Cleveland Browns",24,21,21,362,192,170,0,13,259,215,44,2,1990-09-16,2,1,"nyj",3
"3","Mon","September 24","L","","1-2",TRUE,"Buffalo Bills",7,30,17,249,125,124,2,23,451,159,292,1,1990-09-24,-1,0,"nyj",-23
"4","Sun","September 30","W","","2-2",FALSE,"New England Patriots",37,13,25,499,275,224,2,18,258,169,89,4,1990-09-30,2,1,"nyj",24
"5","Sun","October 7","L","","2-3",FALSE,"Miami Dolphins",16,20,22,342,228,114,0,21,334,262,72,0,1990-10-07,0,0,"nyj",-4
"6","Sun","October 14","L","","2-4",TRUE,"San Diego Chargers",3,39,9,148,53,95,2,22,412,188,224,3,1990-10-14,1,0,"nyj",-36
"7","Sun","October 21","L","","2-5",FALSE,"Buffalo Bills",27,30,23,342,192,150,1,24,405,276,129,1,1990-10-21,0,0,"nyj",-3
"8","Sun","October 28","W","","3-5",FALSE,"Houston Oilers",17,12,13,229,142,87,1,28,425,343,82,2,1990-10-28,1,1,"nyj",5
"9","Sun","November 4","W","","4-5",TRUE,"Dallas Cowboys",24,9,15,187,71,116,0,18,321,226,95,2,1990-11-04,2,1,"nyj",15
"10","Sun","November 11","L","","4-6",TRUE,"Miami Dolphins",3,17,11,154,66,88,3,24,320,192,128,3,1990-11-11,0,0,"nyj",-14
"11","Sun","November 18","L","","4-7",FALSE,"Indianapolis Colts",14,17,22,425,304,121,1,15,313,225,88,1,1990-11-18,0,0,"nyj",-3
"12","Sun","November 25","L","","4-8",TRUE,"Pittsburgh Steelers",7,24,8,173,100,73,2,22,333,175,158,3,1990-11-25,1,0,"nyj",-17
"13","Sun","December 2","L","","4-9",FALSE,"San Diego Chargers",17,38,21,352,207,145,3,20,409,220,189,1,1990-12-02,-2,0,"nyj",-21
"15","Sun","December 16","L","","4-10",TRUE,"Indianapolis Colts",21,29,21,300,146,154,1,18,373,217,156,0,1990-12-16,-1,0,"nyj",-8
"16","Sun","December 23","W","","5-10",TRUE,"New England Patriots",42,7,29,465,226,239,2,18,301,210,91,1,1990-12-23,-1,1,"nyj",35
"17","Sun","December 30","W","","6-10",FALSE,"Tampa Bay Buccaneers",16,14,17,317,162,155,1,16,238,168,70,3,1990-12-30,2,1,"nyj",2
"1","Sun","September 1","W","","1-0",TRUE,"Tampa Bay Buccaneers",16,13,19,271,152,119,0,15,277,190,87,2,1991-09-01,2,1,"nyj",3
"2","Sun","September 8","L","","1-1",FALSE,"Seattle Seahawks",13,20,18,316,158,158,4,18,290,193,97,2,1991-09-08,-2,0,"nyj",-7
"3","Sun","September 15","L","","1-2",TRUE,"Buffalo Bills",20,23,25,388,220,168,2,22,304,240,64,2,1991-09-15,0,0,"nyj",-3
"4","Mon","September 23","L","OT","1-3",FALSE,"Chicago Bears",13,19,24,346,177,169,1,26,393,289,104,1,1991-09-23,0,0,"nyj",-6
"5","Sun","September 29","W","","2-3",TRUE,"Miami Dolphins",41,23,20,427,221,206,0,19,324,278,46,2,1991-09-29,2,1,"nyj",18
"6","Sun","October 6","W","","3-3",FALSE,"Cleveland Browns",17,14,18,287,211,76,1,14,237,131,106,1,1991-10-06,0,1,"nyj",3
"7","Sun","October 13","L","","3-4",TRUE,"Houston Oilers",20,23,21,279,236,43,1,25,436,409,27,3,1991-10-13,2,0,"nyj",-3
"8","Sun","October 20","W","","4-4",FALSE,"Indianapolis Colts",17,6,19,331,193,138,1,11,170,79,91,1,1991-10-20,0,1,"nyj",11
"10","Sun","November 3","W","OT","5-4",TRUE,"Green Bay Packers",19,16,17,293,172,121,1,15,262,171,91,3,1991-11-03,2,1,"nyj",3
"11","Sun","November 10","L","","5-5",TRUE,"Indianapolis Colts",27,28,24,436,318,118,1,16,282,239,43,3,1991-11-10,2,0,"nyj",-1
"12","Sun","November 17","W","","6-5",FALSE,"New England Patriots",28,21,25,422,309,113,2,24,426,351,75,4,1991-11-17,2,1,"nyj",7
"13","Sun","November 24","W","","7-5",TRUE,"San Diego Chargers",24,3,21,314,176,138,1,18,291,105,186,4,1991-11-24,3,1,"nyj",21
"14","Sun","December 1","L","","7-6",FALSE,"Buffalo Bills",13,24,20,293,172,121,3,24,394,242,152,4,1991-12-01,1,0,"nyj",-11
"15","Sun","December 8","L","","7-7",FALSE,"Detroit Lions",20,34,19,286,154,132,5,15,336,235,101,1,1991-12-08,-4,0,"nyj",-14
"16","Sun","December 15","L","","7-8",TRUE,"New England Patriots",3,6,18,268,159,109,1,14,226,100,126,3,1991-12-15,2,0,"nyj",-3
"17","Sun","December 22","W","OT","8-8",FALSE,"Miami Dolphins",23,20,23,359,128,231,1,22,333,287,46,1,1991-12-22,0,1,"nyj",3
"WildCard","Sun","December 29","L","","8-9",FALSE,"Houston Oilers",10,17,18,285,214,71,3,21,303,232,71,2,1991-12-29,-1,0,"nyj",-7
"1","Sun","September 6","L","","0-1",FALSE,"Atlanta Falcons",17,20,21,411,343,68,2,17,306,189,117,0,1992-09-06,-2,0,"nyj",-3
"2","Sun","September 13","L","","0-2",FALSE,"Pittsburgh Steelers",10,27,12,239,129,110,7,17,370,155,215,5,1992-09-13,-2,0,"nyj",-17
"3","Sun","September 20","L","","0-3",TRUE,"San Francisco 49ers",14,31,15,311,245,66,1,19,335,204,131,2,1992-09-20,1,0,"nyj",-17
"4","Sun","September 27","L","","0-4",FALSE,"Los Angeles Rams",10,18,21,330,181,149,4,15,269,151,118,3,1992-09-27,-1,0,"nyj",-8
"5","Sun","October 4","W","","1-4",TRUE,"New England Patriots",30,21,20,312,195,117,2,14,282,207,75,3,1992-10-04,1,1,"nyj",9
"6","Sun","October 11","L","OT","1-5",FALSE,"Indianapolis Colts",3,6,8,147,73,74,1,22,282,183,99,1,1992-10-11,0,0,"nyj",-3
"8","Mon","October 26","L","","1-6",TRUE,"Buffalo Bills",20,24,22,326,184,142,2,21,373,208,165,2,1992-10-26,0,0,"nyj",-4
"9","Sun","November 1","W","","2-6",TRUE,"Miami Dolphins",26,14,21,363,203,160,1,11,296,213,83,2,1992-11-01,1,1,"nyj",12
"10","Sun","November 8","L","","2-7",FALSE,"Denver Broncos",16,27,15,341,182,159,2,19,375,261,114,4,1992-11-08,2,0,"nyj",-11
"11","Sun","November 15","W","","3-7",TRUE,"Cincinnati Bengals",17,14,17,271,98,173,2,16,227,79,148,3,1992-11-15,1,1,"nyj",3
"12","Sun","November 22","L","","3-8",FALSE,"New England Patriots",3,24,11,166,89,77,3,17,260,96,164,1,1992-11-22,-2,0,"nyj",-21
"13","Sun","November 29","L","","3-9",TRUE,"Kansas City Chiefs",7,23,15,251,189,62,1,21,296,203,93,0,1992-11-29,-1,0,"nyj",-16
"14","Sun","December 6","W","","4-9",FALSE,"Buffalo Bills",24,17,17,275,151,124,1,21,351,204,147,4,1992-12-06,3,1,"nyj",7
"15","Sun","December 13","L","","4-10",TRUE,"Indianapolis Colts",6,10,15,246,142,104,5,15,284,220,64,2,1992-12-13,-3,0,"nyj",-4
"16","Sun","December 20","L","","4-11",FALSE,"Miami Dolphins",17,19,12,270,158,112,2,14,294,203,91,3,1992-12-20,1,0,"nyj",-2
"17","Sat","December 26","L","","4-12",TRUE,"New Orleans Saints",0,20,10,172,117,55,3,17,280,185,95,4,1992-12-26,1,0,"nyj",-20
"1","Sun","September 5","L","","0-1",TRUE,"Denver Broncos",20,26,20,422,351,71,3,18,353,254,99,1,1993-09-05,-2,0,"nyj",-6
"2","Sun","September 12","W","","1-1",FALSE,"Miami Dolphins",24,14,22,429,323,106,1,14,294,267,27,2,1993-09-12,1,1,"nyj",10
"4","Sun","September 26","W","","2-1",TRUE,"New England Patriots",45,7,21,388,221,167,0,15,211,180,31,3,1993-09-26,3,1,"nyj",38
"5","Sun","October 3","L","","2-2",TRUE,"Philadelphia Eagles",30,35,19,412,297,115,3,18,303,191,112,2,1993-10-03,-1,0,"nyj",-5
"6","Sun","October 10","L","","2-3",FALSE,"Los Angeles Raiders",20,24,21,286,190,96,2,22,414,309,105,5,1993-10-10,3,0,"nyj",-4
"8","Sun","October 24","L","","2-4",TRUE,"Buffalo Bills",10,19,15,237,159,78,4,27,413,216,197,3,1993-10-24,-1,0,"nyj",-9
"9","Sun","October 31","W","","3-4",FALSE,"New York Giants",10,6,17,256,129,127,1,17,265,141,124,2,1993-10-31,1,1,"nyj",4
"10","Sun","November 7","W","","4-4",TRUE,"Miami Dolphins",27,10,24,356,256,100,1,15,337,289,48,2,1993-11-07,1,1,"nyj",17
"11","Sun","November 14","W","","5-4",FALSE,"Indianapolis Colts",31,17,27,458,256,202,1,15,215,123,92,1,1993-11-14,0,1,"nyj",14
"12","Sun","November 21","W","","6-4",TRUE,"Cincinnati Bengals",17,12,21,288,177,111,0,14,226,176,50,2,1993-11-21,2,1,"nyj",5
"13","Sun","November 28","W","","7-4",FALSE,"New England Patriots",6,0,14,294,174,120,1,14,289,134,155,2,1993-11-28,1,1,"nyj",6
"14","Sun","December 5","L","","7-5",TRUE,"Indianapolis Colts",6,9,15,267,145,122,3,7,169,102,67,1,1993-12-05,-2,0,"nyj",-3
"15","Sat","December 11","W","","8-5",FALSE,"Washington Redskins",3,0,17,308,98,210,1,7,150,111,39,1,1993-12-11,0,1,"nyj",3
"16","Sat","December 18","L","","8-6",TRUE,"Dallas Cowboys",7,28,23,295,214,81,4,19,364,235,129,5,1993-12-18,1,0,"nyj",-21
"17","Sun","December 26","L","","8-7",FALSE,"Buffalo Bills",14,16,19,352,232,120,1,19,346,256,90,3,1993-12-26,2,0,"nyj",-2
"18","Sun","January 2","L","","8-8",FALSE,"Houston Oilers",0,24,9,164,110,54,2,25,363,255,108,2,1994-01-02,0,0,"nyj",-24
"1","Sun","September 4","W","","1-0",FALSE,"Buffalo Bills",23,3,17,330,214,116,1,13,209,166,43,3,1994-09-04,2,1,"nyj",20
"2","Sun","September 11","W","OT","2-0",TRUE,"Denver Broncos",25,22,19,366,287,79,2,22,401,316,85,1,1994-09-11,-1,1,"nyj",3
"3","Sun","September 18","L","","2-1",FALSE,"Miami Dolphins",14,28,18,343,284,59,4,26,444,289,155,2,1994-09-18,-2,0,"nyj",-14
"4","Sun","September 25","L","","2-2",TRUE,"Chicago Bears",7,19,17,325,161,164,3,17,226,122,104,0,1994-09-25,-3,0,"nyj",-12
"5","Sun","October 2","L","","2-3",FALSE,"Cleveland Browns",7,27,19,346,274,72,3,18,363,246,117,0,1994-10-02,-3,0,"nyj",-20
"6","Sun","October 9","W","","3-3",TRUE,"Indianapolis Colts",16,6,14,250,100,150,1,10,231,90,141,4,1994-10-09,3,1,"nyj",10
"7","Sun","October 16","W","","4-3",TRUE,"New England Patriots",24,17,17,242,70,172,2,19,324,220,104,4,1994-10-16,2,1,"nyj",7
"9","Sun","October 30","L","","4-4",FALSE,"Indianapolis Colts",25,28,14,256,199,57,1,22,330,151,179,5,1994-10-30,4,0,"nyj",-3
"10","Sun","November 6","W","","5-4",TRUE,"Buffalo Bills",22,17,17,268,174,94,1,18,282,187,95,2,1994-11-06,1,1,"nyj",5
"11","Sun","November 13","L","","5-5",FALSE,"Green Bay Packers",10,17,16,315,199,116,1,14,234,172,62,1,1994-11-13,0,0,"nyj",-7
"12","Sun","November 20","W","","6-5",FALSE,"Minnesota Vikings",31,21,17,282,220,62,1,26,461,374,87,4,1994-11-20,3,1,"nyj",10
"13","Sun","November 27","L","","6-6",TRUE,"Miami Dolphins",24,28,25,441,365,76,2,22,397,359,38,4,1994-11-27,2,0,"nyj",-4
"14","Sun","December 4","L","","6-7",FALSE,"New England Patriots",13,24,13,219,155,64,1,20,326,191,135,2,1994-12-04,1,0,"nyj",-11
"15","Sat","December 10","L","","6-8",TRUE,"Detroit Lions",7,18,14,261,141,120,1,19,326,189,137,1,1994-12-10,0,0,"nyj",-11
"16","Sun","December 18","L","","6-9",TRUE,"San Diego Chargers",6,21,14,243,167,76,1,24,403,251,152,2,1994-12-18,1,0,"nyj",-15
"17","Sat","December 24","L","","6-10",FALSE,"Houston Oilers",10,24,14,216,127,89,3,25,381,206,175,3,1994-12-24,0,0,"nyj",-14
"1","Sun","September 3","L","","0-1",FALSE,"Miami Dolphins",14,52,16,259,195,64,6,22,362,251,111,4,1995-09-03,-2,0,"nyj",-38
"2","Sun","September 10","L","OT","0-2",TRUE,"Indianapolis Colts",24,27,21,344,198,146,3,25,361,239,122,3,1995-09-10,0,0,"nyj",-3
"3","Sun","September 17","W","","1-2",TRUE,"Jacksonville Jaguars",27,10,23,375,296,79,1,20,251,105,146,3,1995-09-17,2,1,"nyj",17
"4","Sun","September 24","L","","1-3",FALSE,"Atlanta Falcons",3,13,16,270,176,94,4,24,348,200,148,2,1995-09-24,-2,0,"nyj",-10
"5","Sun","October 1","L","","1-4",TRUE,"Oakland Raiders",10,47,15,241,147,94,3,25,457,237,220,0,1995-10-01,-3,0,"nyj",-37
"6","Sun","October 8","L","","1-5",FALSE,"Buffalo Bills",10,29,14,173,122,51,4,22,318,98,220,2,1995-10-08,-2,0,"nyj",-19
"7","Sun","October 15","L","","1-6",FALSE,"Carolina Panthers",15,26,7,138,113,25,3,15,265,132,133,3,1995-10-15,0,0,"nyj",-11
"8","Sun","October 22","W","","2-6",TRUE,"Miami Dolphins",17,16,12,200,143,57,2,21,320,174,146,4,1995-10-22,2,1,"nyj",1
"9","Sun","October 29","L","","2-7",FALSE,"Indianapolis Colts",10,17,19,241,140,101,1,10,114,62,52,0,1995-10-29,-1,0,"nyj",-7
"10","Sun","November 5","L","","2-8",TRUE,"New England Patriots",7,20,20,255,123,132,2,18,345,173,172,2,1995-11-05,0,0,"nyj",-13
"12","Sun","November 19","L","","2-9",TRUE,"Buffalo Bills",26,28,17,351,277,74,3,20,373,285,88,1,1995-11-19,-2,0,"nyj",-2
"13","Sun","November 26","W","","3-9",FALSE,"Seattle Seahawks",16,10,17,255,143,112,1,14,192,118,74,3,1995-11-26,2,1,"nyj",6
"14","Sun","December 3","L","","3-10",TRUE,"St. Louis Rams",20,23,13,249,188,61,2,13,210,134,76,4,1995-12-03,2,0,"nyj",-3
"15","Sun","December 10","L","","3-11",FALSE,"New England Patriots",28,31,23,346,254,92,4,18,327,167,160,3,1995-12-10,-1,0,"nyj",-3
"16","Sun","December 17","L","","3-12",FALSE,"Houston Oilers",6,23,10,164,134,30,0,21,274,166,108,0,1995-12-17,0,0,"nyj",-17
"17","Sun","December 24","L","","3-13",TRUE,"New Orleans Saints",0,12,11,206,139,67,3,13,239,199,40,0,1995-12-24,-3,0,"nyj",-12
"1","Sun","September 1","L","","0-1",FALSE,"Denver Broncos",6,31,12,188,72,116,4,21,367,167,200,3,1996-09-01,-1,0,"nyj",-25
"2","Sun","September 8","L","","0-2",TRUE,"Indianapolis Colts",7,21,21,359,290,69,2,17,291,225,66,1,1996-09-08,-1,0,"nyj",-14
"3","Sun","September 15","L","","0-3",FALSE,"Miami Dolphins",27,36,20,378,304,74,3,20,445,251,194,2,1996-09-15,-1,0,"nyj",-9
"4","Sun","September 22","L","","0-4",TRUE,"New York Giants",6,13,13,208,130,78,2,12,201,110,91,2,1996-09-22,0,0,"nyj",-7
"5","Sun","September 29","L","","0-5",FALSE,"Washington Redskins",16,31,27,443,287,156,1,18,396,257,139,0,1996-09-29,-1,0,"nyj",-15
"6","Sun","October 6","L","","0-6",TRUE,"Oakland Raiders",13,34,20,282,171,111,2,26,404,182,222,1,1996-10-06,-1,0,"nyj",-21
"7","Sun","October 13","L","","0-7",FALSE,"Jacksonville Jaguars",17,21,23,367,276,91,2,10,289,217,72,0,1996-10-13,-2,0,"nyj",-4
"8","Sun","October 20","L","","0-8",TRUE,"Buffalo Bills",22,25,19,317,253,64,4,23,333,195,138,1,1996-10-20,-3,0,"nyj",-3
"9","Sun","October 27","W","","1-8",FALSE,"Arizona Cardinals",31,21,27,454,246,208,3,19,353,246,107,1,1996-10-27,-2,1,"nyj",10
"11","Sun","November 10","L","","1-9",TRUE,"New England Patriots",27,31,28,422,280,142,1,21,343,275,68,3,1996-11-10,2,0,"nyj",-4
"12","Sun","November 17","L","","1-10",FALSE,"Indianapolis Colts",29,34,21,419,332,87,5,14,303,151,152,3,1996-11-17,-2,0,"nyj",-5
"13","Sun","November 24","L","","1-11",FALSE,"Buffalo Bills",10,35,22,341,229,112,5,17,348,267,81,2,1996-11-24,-3,0,"nyj",-25
"14","Sun","December 1","L","","1-12",TRUE,"Houston Oilers",10,35,15,264,185,79,3,18,385,142,243,1,1996-12-01,-2,0,"nyj",-25
"15","Sun","December 8","L","","1-13",FALSE,"New England Patriots",10,34,16,244,202,42,2,27,367,248,119,1,1996-12-08,-1,0,"nyj",-24
"16","Sat","December 14","L","","1-14",TRUE,"Philadelphia Eagles",20,21,14,244,173,71,5,15,323,172,151,4,1996-12-14,-1,0,"nyj",-1
"17","Sun","December 22","L","","1-15",TRUE,"Miami Dolphins",28,31,21,278,195,83,2,26,416,259,157,1,1996-12-22,-1,0,"nyj",-3
"1","Sun","August 31","W","","1-0",FALSE,"Seattle Seahawks",41,3,28,434,270,164,0,16,247,163,84,2,1997-08-31,2,1,"nyj",38
"2","Sun","September 7","L","","1-1",TRUE,"Buffalo Bills",22,28,12,202,163,39,2,15,269,193,76,3,1997-09-07,1,0,"nyj",-6
"3","Sun","September 14","L","OT","1-2",FALSE,"New England Patriots",24,27,22,355,225,130,3,23,375,162,213,3,1997-09-14,0,0,"nyj",-3
"4","Sun","September 21","W","","2-2",TRUE,"Oakland Raiders",23,22,16,303,220,83,1,26,468,339,129,0,1997-09-21,-1,1,"nyj",1
"5","Sun","September 28","W","","3-2",FALSE,"Cincinnati Bengals",31,14,28,402,212,190,1,10,215,149,66,1,1997-09-28,0,1,"nyj",17
"6","Sun","October 5","W","","4-2",FALSE,"Indianapolis Colts",16,12,13,206,128,78,1,20,310,265,45,3,1997-10-05,2,1,"nyj",4
"7","Sun","October 12","L","","4-3",TRUE,"Miami Dolphins",20,31,20,369,288,81,1,25,465,372,93,0,1997-10-12,-1,0,"nyj",-11
"8","Sun","October 19","W","","5-3",TRUE,"New England Patriots",24,19,22,330,254,76,0,19,372,267,105,1,1997-10-19,1,1,"nyj",5
"10","Sun","November 2","W","OT","6-3",TRUE,"Baltimore Ravens",19,16,15,225,160,65,0,23,447,288,159,2,1997-11-02,2,1,"nyj",3
"11","Sun","November 9","L","","6-4",FALSE,"Miami Dolphins",17,24,20,382,303,79,2,21,296,176,120,0,1997-11-09,-2,0,"nyj",-7
"12","Sun","November 16","W","","7-4",FALSE,"Chicago Bears",23,15,11,193,116,77,1,27,356,307,49,5,1997-11-16,4,1,"nyj",8
"13","Sun","November 23","W","","8-4",TRUE,"Minnesota Vikings",23,21,22,357,227,130,3,19,386,312,74,1,1997-11-23,-2,1,"nyj",2
"14","Sun","November 30","L","","8-5",FALSE,"Buffalo Bills",10,20,16,294,264,30,2,19,336,139,197,1,1997-11-30,-1,0,"nyj",-10
"15","Sun","December 7","L","","8-6",TRUE,"Indianapolis Colts",14,22,12,126,93,33,1,19,366,173,193,0,1997-12-07,-1,0,"nyj",-8
"16","Sun","December 14","W","","9-6",TRUE,"Tampa Bay Buccaneers",31,0,14,234,112,122,1,6,111,21,90,3,1997-12-14,2,1,"nyj",31
"17","Sun","December 21","L","","9-7",FALSE,"Detroit Lions",10,13,20,315,207,108,3,13,301,95,206,0,1997-12-21,-3,0,"nyj",-3
"1","Sun","September 6","L","OT","0-1",FALSE,"San Francisco 49ers",30,36,25,465,406,59,1,26,557,350,207,1,1998-09-06,0,0,"nyj",-6
"2","Sun","September 13","L","","0-2",TRUE,"Baltimore Ravens",10,24,18,276,224,52,3,16,331,209,122,1,1998-09-13,-2,0,"nyj",-14
"3","Sun","September 20","W","","1-2",TRUE,"Indianapolis Colts",44,6,28,505,203,302,2,21,310,190,120,2,1998-09-20,0,1,"nyj",38
"5","Sun","October 4","W","","2-2",TRUE,"Miami Dolphins",20,9,22,289,172,117,1,11,153,119,34,3,1998-10-04,2,1,"nyj",11
"6","Sun","October 11","L","","2-3",FALSE,"St. Louis Rams",10,30,14,177,123,54,5,18,319,178,141,1,1998-10-11,-4,0,"nyj",-20
"7","Mon","October 19","W","","3-3",FALSE,"New England Patriots",24,14,25,392,271,121,0,19,291,181,110,1,1998-10-19,1,1,"nyj",10
"8","Sun","October 25","W","","4-3",TRUE,"Atlanta Falcons",28,3,21,311,192,119,0,13,207,152,55,3,1998-10-25,3,1,"nyj",25
"9","Sun","November 1","W","","5-3",FALSE,"Kansas City Chiefs",20,17,17,306,253,53,1,13,204,112,92,3,1998-11-01,2,1,"nyj",3
"10","Sun","November 8","W","","6-3",TRUE,"Buffalo Bills",34,12,23,398,277,121,3,11,182,134,48,2,1998-11-08,-1,1,"nyj",22
"11","Sun","November 15","L","","6-4",FALSE,"Indianapolis Colts",23,24,20,369,212,157,2,23,357,267,90,2,1998-11-15,0,0,"nyj",-1
"12","Sun","November 22","W","","7-4",FALSE,"Tennessee Oilers",24,3,22,361,231,130,0,12,223,129,94,1,1998-11-22,1,1,"nyj",21
"13","Sun","November 29","W","","8-4",TRUE,"Carolina Panthers",48,21,21,456,255,201,0,15,216,134,82,1,1998-11-29,1,1,"nyj",27
"14","Sun","December 6","W","","9-4",TRUE,"Seattle Seahawks",32,31,31,488,418,70,3,13,377,271,106,4,1998-12-06,1,1,"nyj",1
"15","Sun","December 13","W","","10-4",FALSE,"Miami Dolphins",21,16,16,314,232,82,2,22,357,278,79,2,1998-12-13,0,1,"nyj",5
"16","Sat","December 19","W","","11-4",FALSE,"Buffalo Bills",17,10,14,269,177,92,0,21,366,217,149,2,1998-12-19,2,1,"nyj",7
"17","Sun","December 27","W","","12-4",TRUE,"New England Patriots",31,10,21,339,190,149,1,9,249,119,130,1,1998-12-27,0,1,"nyj",21
"Division","Sun","January 10","W","","13-4",TRUE,"Jacksonville Jaguars",34,24,29,429,278,151,3,14,251,156,95,4,1999-01-10,1,1,"nyj",10
"ConfChamp","Sun","January 17","L","","13-5",FALSE,"Denver Broncos",10,23,18,370,356,14,6,14,331,153,178,0,1999-01-17,-6,0,"nyj",-13
"1","Sun","September 12","L","","0-1",TRUE,"New England Patriots",28,30,19,363,257,106,4,16,396,326,70,2,1999-09-12,-2,0,"nyj",-2
"2","Sun","September 19","L","","0-2",FALSE,"Buffalo Bills",3,17,11,190,116,74,0,23,384,160,224,1,1999-09-19,1,0,"nyj",-14
"3","Sun","September 26","L","","0-3",TRUE,"Washington Redskins",20,27,19,337,195,142,2,21,333,237,96,0,1999-09-26,-2,0,"nyj",-7
"4","Sun","October 3","W","","1-3",FALSE,"Denver Broncos",21,13,23,334,224,110,2,17,326,218,108,6,1999-10-03,4,1,"nyj",8
"5","Mon","October 11","L","","1-4",TRUE,"Jacksonville Jaguars",6,16,13,230,141,89,2,16,322,197,125,1,1999-10-11,-1,0,"nyj",-10
"6","Sun","October 17","L","","1-5",TRUE,"Indianapolis Colts",13,16,16,281,125,156,2,19,318,210,108,1,1999-10-17,-1,0,"nyj",-3
"7","Sun","October 24","L","","1-6",FALSE,"Oakland Raiders",23,24,14,324,147,177,2,24,461,344,117,4,1999-10-24,2,0,"nyj",-1
"9","Sun","November 7","W","","2-6",TRUE,"Arizona Cardinals",12,7,15,295,111,184,0,10,206,151,55,1,1999-11-07,1,1,"nyj",5
"10","Mon","November 15","W","","3-6",FALSE,"New England Patriots",24,17,19,341,153,188,2,16,229,150,79,3,1999-11-15,1,1,"nyj",7
"11","Sun","November 21","W","","4-6",TRUE,"Buffalo Bills",17,7,14,208,113,95,0,14,273,205,68,3,1999-11-21,3,1,"nyj",10
"12","Sun","November 28","L","","4-7",FALSE,"Indianapolis Colts",6,13,14,214,88,126,0,23,287,187,100,3,1999-11-28,3,0,"nyj",-7
"13","Sun","December 5","L","","4-8",FALSE,"New York Giants",28,41,18,291,276,15,0,25,490,338,152,1,1999-12-05,1,0,"nyj",-13
"14","Sun","December 12","W","","5-8",TRUE,"Miami Dolphins",28,20,18,320,225,95,1,20,319,246,73,2,1999-12-12,1,1,"nyj",8
"15","Sun","December 19","W","","6-8",FALSE,"Dallas Cowboys",22,21,19,355,229,126,2,16,347,152,195,2,1999-12-19,0,1,"nyj",1
"16","Mon","December 27","W","","7-8",FALSE,"Miami Dolphins",38,31,16,290,189,101,1,25,422,322,100,3,1999-12-27,2,1,"nyj",7
"17","Sun","January 2","W","","8-8",TRUE,"Seattle Seahawks",19,9,20,379,202,177,2,14,266,233,33,2,2000-01-02,0,1,"nyj",10
"1","Sun","September 3","W","","1-0",FALSE,"Green Bay Packers",20,16,24,379,261,118,1,13,211,149,62,2,2000-09-03,1,1,"nyj",4
"2","Mon","September 11","W","","2-0",TRUE,"New England Patriots",20,19,18,330,271,59,1,21,293,193,100,0,2000-09-11,-1,1,"nyj",1
"3","Sun","September 17","W","","3-0",TRUE,"Buffalo Bills",27,14,15,279,188,91,1,16,354,274,80,4,2000-09-17,3,1,"nyj",13
"4","Sun","September 24","W","","4-0",FALSE,"Tampa Bay Buccaneers",21,17,16,296,198,98,3,12,239,120,119,4,2000-09-24,1,1,"nyj",4
"6","Sun","October 8","L","","4-1",TRUE,"Pittsburgh Steelers",3,20,12,206,94,112,4,21,330,137,193,0,2000-10-08,-4,0,"nyj",-17
"7","Sun","October 15","W","","5-1",FALSE,"New England Patriots",34,17,20,294,130,164,1,16,249,198,51,6,2000-10-15,5,1,"nyj",17
"8","Mon","October 23","W","OT","6-1",TRUE,"Miami Dolphins",40,37,31,455,376,79,4,20,433,235,198,3,2000-10-23,-1,1,"nyj",3
"9","Sun","October 29","L","","6-2",FALSE,"Buffalo Bills",20,23,19,337,286,51,4,18,338,252,86,0,2000-10-29,-4,0,"nyj",-3
"10","Sun","November 5","L","","6-3",TRUE,"Denver Broncos",23,30,22,381,293,88,3,23,447,317,130,1,2000-11-05,-2,0,"nyj",-7
"11","Sun","November 12","L","","6-4",FALSE,"Indianapolis Colts",15,23,22,367,271,96,2,25,358,210,148,1,2000-11-12,-1,0,"nyj",-8
"12","Sun","November 19","W","","7-4",FALSE,"Miami Dolphins",20,3,18,239,106,133,2,10,200,117,83,4,2000-11-19,2,1,"nyj",17
"13","Sun","November 26","W","","8-4",TRUE,"Chicago Bears",17,10,17,277,218,59,1,13,233,98,135,3,2000-11-26,2,1,"nyj",7
"14","Sun","December 3","W","","9-4",TRUE,"Indianapolis Colts",27,17,26,491,280,211,1,21,375,326,49,3,2000-12-03,2,1,"nyj",10
"15","Sun","December 10","L","","9-5",FALSE,"Oakland Raiders",7,31,14,300,290,10,4,17,330,150,180,1,2000-12-10,-3,0,"nyj",-24
"16","Sun","December 17","L","","9-6",TRUE,"Detroit Lions",7,10,12,240,189,51,2,16,288,78,210,1,2000-12-17,-1,0,"nyj",-3
"17","Sun","December 24","L","","9-7",FALSE,"Baltimore Ravens",20,34,22,524,473,51,6,5,142,78,64,2,2000-12-24,-4,0,"nyj",-14
"1","Sun","September 9","L","","0-1",TRUE,"Indianapolis Colts",24,45,17,330,192,138,2,22,376,222,154,3,2001-09-09,1,0,"nyj",-21
"2","Sun","September 23","W","","1-1",FALSE,"New England Patriots",10,3,14,238,127,111,0,15,308,201,107,4,2001-09-23,4,1,"nyj",7
"3","Mon","October 1","L","","1-2",TRUE,"San Francisco 49ers",17,19,16,268,186,82,0,21,359,126,233,1,2001-10-01,1,0,"nyj",-2
"4","Sun","October 7","W","","2-2",FALSE,"Buffalo Bills",42,36,21,335,173,162,0,26,473,311,162,5,2001-10-07,5,1,"nyj",6
"5","Sun","October 14","W","","3-2",TRUE,"Miami Dolphins",21,17,19,268,140,128,0,19,348,233,115,4,2001-10-14,4,1,"nyj",4
"6","Sun","October 21","L","","3-3",TRUE,"St. Louis Rams",14,34,17,266,134,132,1,22,448,214,234,2,2001-10-21,1,0,"nyj",-20
"7","Sun","October 28","W","","4-3",FALSE,"Carolina Panthers",13,12,17,358,172,186,4,7,162,70,92,1,2001-10-28,-3,1,"nyj",1
"8","Sun","November 4","W","","5-3",FALSE,"New Orleans Saints",16,9,12,272,130,142,2,13,246,138,108,4,2001-11-04,2,1,"nyj",7
"9","Sun","November 11","W","","6-3",TRUE,"Kansas City Chiefs",27,7,22,353,179,174,2,16,224,124,100,4,2001-11-11,2,1,"nyj",20
"10","Sun","November 18","W","","7-3",FALSE,"Miami Dolphins",24,0,11,162,76,86,0,15,254,176,78,5,2001-11-18,5,1,"nyj",24
"12","Sun","December 2","L","","7-4",TRUE,"New England Patriots",16,17,18,288,157,131,2,14,264,191,73,0,2001-12-02,-2,0,"nyj",-1
"13","Sun","December 9","L","","7-5",FALSE,"Pittsburgh Steelers",7,18,14,220,159,61,0,23,345,211,134,0,2001-12-09,0,0,"nyj",-11
"14","Sun","December 16","W","","8-5",TRUE,"Cincinnati Bengals",15,14,17,309,196,113,0,17,248,128,120,3,2001-12-16,3,1,"nyj",1
"15","Sun","December 23","W","","9-5",FALSE,"Indianapolis Colts",29,28,26,451,285,166,2,18,393,260,133,2,2001-12-23,0,1,"nyj",1
"16","Sun","December 30","L","","9-6",TRUE,"Buffalo Bills",9,14,19,375,227,148,3,19,368,176,192,1,2001-12-30,-2,0,"nyj",-5
"17","Sun","January 6","W","","10-6",FALSE,"Oakland Raiders",24,22,14,302,208,94,3,17,337,218,119,0,2002-01-06,-3,1,"nyj",2
"WildCard","Sat","January 12","L","","10-7",FALSE,"Oakland Raiders",24,38,23,410,265,145,2,23,502,287,215,0,2002-01-12,-2,0,"nyj",-14
"1","Sun","September 8","W","OT","1-0",FALSE,"Buffalo Bills",37,31,18,266,193,73,1,26,384,242,142,3,2002-09-08,2,1,"nyj",6
"2","Sun","September 15","L","","1-1",TRUE,"New England Patriots",7,44,9,200,168,32,2,24,432,269,163,2,2002-09-15,0,0,"nyj",-37
"3","Sun","September 22","L","","1-2",FALSE,"Miami Dolphins",3,30,13,189,131,58,4,21,394,183,211,0,2002-09-22,-4,0,"nyj",-27
"4","Sun","September 29","L","","1-3",FALSE,"Jacksonville Jaguars",3,28,18,345,267,78,4,20,383,160,223,0,2002-09-29,-4,0,"nyj",-25
"5","Sun","October 6","L","","1-4",TRUE,"Kansas City Chiefs",25,29,23,359,212,147,1,24,504,289,215,1,2002-10-06,0,0,"nyj",-4
"7","Sun","October 20","W","","2-4",TRUE,"Minnesota Vikings",20,7,21,407,316,91,0,21,389,288,101,4,2002-10-20,4,1,"nyj",13
"8","Sun","October 27","L","","2-5",TRUE,"Cleveland Browns",21,24,14,241,175,66,3,18,334,279,55,0,2002-10-27,-3,0,"nyj",-3
"9","Sun","November 3","W","","3-5",FALSE,"San Diego Chargers",44,13,21,413,248,165,0,15,243,170,73,3,2002-11-03,3,1,"nyj",31
"10","Sun","November 10","W","","4-5",TRUE,"Miami Dolphins",13,10,19,264,167,97,0,15,279,210,69,2,2002-11-10,2,1,"nyj",3
"11","Sun","November 17","W","","5-5",FALSE,"Detroit Lions",31,14,26,408,219,189,1,13,279,171,108,1,2002-11-17,0,1,"nyj",17
"12","Sun","November 24","W","","6-5",TRUE,"Buffalo Bills",31,13,22,325,170,155,0,17,258,170,88,3,2002-11-24,3,1,"nyj",18
"13","Mon","December 2","L","","6-6",FALSE,"Oakland Raiders",20,26,18,274,242,32,2,25,411,313,98,0,2002-12-02,-2,0,"nyj",-6
"14","Sun","December 8","W","","7-6",TRUE,"Denver Broncos",19,13,18,281,217,64,0,21,369,258,111,1,2002-12-08,1,1,"nyj",6
"15","Sun","December 15","L","","7-7",FALSE,"Chicago Bears",13,20,19,334,200,134,1,20,266,161,105,0,2002-12-15,-1,0,"nyj",-7
"16","Sun","December 22","W","","8-7",FALSE,"New England Patriots",30,17,19,393,285,108,0,14,216,119,97,2,2002-12-22,2,1,"nyj",13
"17","Sun","December 29","W","","9-7",TRUE,"Green Bay Packers",42,17,22,337,208,129,0,19,322,208,114,1,2002-12-29,1,1,"nyj",25
"WildCard","Sat","January 4","W","","10-7",TRUE,"Indianapolis Colts",41,0,26,396,216,180,0,10,176,124,52,3,2003-01-04,3,1,"nyj",41
"Division","Sun","January 12","L","","10-8",FALSE,"Oakland Raiders",10,30,20,287,167,120,4,20,399,272,127,1,2003-01-12,-3,0,"nyj",-20
"1","Thu","September 4","L","","0-1",FALSE,"Washington Redskins",13,16,11,158,101,57,0,17,327,167,160,2,2003-09-04,2,0,"nyj",-3
"2","Sun","September 14","L","","0-2",TRUE,"Miami Dolphins",10,21,17,387,366,21,1,23,376,189,187,1,2003-09-14,0,0,"nyj",-11
"3","Sun","September 21","L","","0-3",FALSE,"New England Patriots",16,23,16,329,264,65,1,19,294,147,147,1,2003-09-21,0,0,"nyj",-7
"4","Sun","September 28","L","","0-4",TRUE,"Dallas Cowboys",6,17,15,285,219,66,2,18,360,158,202,1,2003-09-28,-1,0,"nyj",-11
"6","Sun","October 12","W","","1-4",TRUE,"Buffalo Bills",30,3,13,233,115,118,0,15,193,140,53,4,2003-10-12,4,1,"nyj",27
"7","Sun","October 19","W","","2-4",FALSE,"Houston Texans",19,14,18,300,160,140,0,17,325,156,169,0,2003-10-19,0,1,"nyj",5
"8","Sun","October 26","L","","2-5",FALSE,"Philadelphia Eagles",17,24,22,377,252,125,2,23,306,112,194,2,2003-10-26,0,0,"nyj",-7
"9","Sun","November 2","L","OT","2-6",TRUE,"New York Giants",28,31,28,392,260,132,4,23,413,298,115,0,2003-11-02,-4,0,"nyj",-3
"10","Sun","November 9","W","OT","3-6",FALSE,"Oakland Raiders",27,24,16,424,269,155,0,24,355,186,169,1,2003-11-09,1,1,"nyj",3
"11","Sun","November 16","L","","3-7",FALSE,"Indianapolis Colts",31,38,12,324,192,132,0,30,538,393,145,0,2003-11-16,0,0,"nyj",-7
"12","Sun","November 23","W","","4-7",TRUE,"Jacksonville Jaguars",13,10,17,282,221,61,1,20,330,172,158,2,2003-11-23,1,1,"nyj",3
"13","Mon","December 1","W","","5-7",TRUE,"Tennessee Titans",24,17,19,320,223,97,2,19,347,263,84,2,2003-12-01,0,1,"nyj",7
"14","Sun","December 7","L","","5-8",FALSE,"Buffalo Bills",6,17,14,215,127,88,1,19,256,53,203,2,2003-12-07,1,0,"nyj",-11
"15","Sun","December 14","W","","6-8",TRUE,"Pittsburgh Steelers",6,0,15,319,144,175,1,16,231,137,94,0,2003-12-14,-1,1,"nyj",6
"16","Sat","December 20","L","","6-9",TRUE,"New England Patriots",16,21,22,321,212,109,5,13,271,138,133,1,2003-12-20,-4,0,"nyj",-5
"17","Sun","December 28","L","","6-10",FALSE,"Miami Dolphins",21,23,19,285,191,94,0,20,397,316,81,1,2003-12-28,1,0,"nyj",-2
"1","Sun","September 12","W","","1-0",TRUE,"Cincinnati Bengals",31,24,24,438,219,219,1,19,351,238,113,2,2004-09-12,1,1,"nyj",7
"2","Sun","September 19","W","","2-0",FALSE,"San Diego Chargers",34,28,22,380,258,122,0,21,327,216,111,4,2004-09-19,4,1,"nyj",6
"4","Sun","October 3","W","","3-0",FALSE,"Miami Dolphins",17,9,16,235,125,110,1,13,293,196,97,4,2004-10-03,3,1,"nyj",8
"5","Sun","October 10","W","","4-0",TRUE,"Buffalo Bills",16,14,24,383,298,85,2,17,252,172,80,1,2004-10-10,-1,1,"nyj",2
"6","Sun","October 17","W","","5-0",TRUE,"San Francisco 49ers",22,14,22,374,222,152,0,19,371,272,99,2,2004-10-17,2,1,"nyj",8
"7","Sun","October 24","L","","5-1",FALSE,"New England Patriots",7,13,15,268,162,106,1,21,343,210,133,1,2004-10-24,0,0,"nyj",-6
"8","Mon","November 1","W","","6-1",TRUE,"Miami Dolphins",41,14,22,472,197,275,0,16,259,181,78,3,2004-11-01,3,1,"nyj",27
"9","Sun","November 7","L","","6-2",FALSE,"Buffalo Bills",17,22,12,282,194,88,2,19,341,184,157,0,2004-11-07,-2,0,"nyj",-5
"10","Sun","November 14","L","OT","6-3",TRUE,"Baltimore Ravens",17,20,16,305,149,156,1,18,262,186,76,1,2004-11-14,0,0,"nyj",-3
"11","Sun","November 21","W","","7-3",FALSE,"Cleveland Browns",10,7,17,235,78,157,1,13,216,117,99,1,2004-11-21,0,1,"nyj",3
"12","Sun","November 28","W","","8-3",FALSE,"Arizona Cardinals",13,3,16,325,179,146,0,17,245,174,71,4,2004-11-28,4,1,"nyj",10
"13","Sun","December 5","W","","9-3",TRUE,"Houston Texans",29,7,26,360,150,210,1,13,230,147,83,2,2004-12-05,1,1,"nyj",22
"14","Sun","December 12","L","","9-4",FALSE,"Pittsburgh Steelers",6,17,15,296,189,107,3,15,262,142,120,2,2004-12-12,-1,0,"nyj",-11
"15","Sun","December 19","W","","10-4",TRUE,"Seattle Seahawks",37,14,27,482,253,229,0,19,275,187,88,3,2004-12-19,3,1,"nyj",23
"16","Sun","December 26","L","","10-5",TRUE,"New England Patriots",7,23,17,279,233,46,3,21,372,258,114,0,2004-12-26,-3,0,"nyj",-16
"17","Sun","January 2","L","OT","10-6",FALSE,"St. Louis Rams",29,32,22,324,144,180,0,21,479,432,47,3,2005-01-02,3,0,"nyj",-3
"WildCard","Sat","January 8","W","OT","11-6",FALSE,"San Diego Chargers",20,17,20,396,270,126,0,24,408,308,100,1,2005-01-08,1,1,"nyj",3
"Division","Sat","January 15","L","OT","11-7",FALSE,"Pittsburgh Steelers",17,20,17,275,165,110,1,23,364,171,193,3,2005-01-15,2,0,"nyj",-3
"1","Sun","September 11","L","","0-1",FALSE,"Kansas City Chiefs",7,27,19,390,333,57,3,23,389,191,198,1,2005-09-11,-2,0,"nyj",-20
"2","Sun","September 18","W","","1-1",TRUE,"Miami Dolphins",17,7,20,271,173,98,0,15,235,169,66,1,2005-09-18,1,1,"nyj",10
"3","Sun","September 25","L","OT","1-2",TRUE,"Jacksonville Jaguars",20,26,12,168,79,89,3,16,308,169,139,3,2005-09-25,0,0,"nyj",-6
"4","Sun","October 2","L","","1-3",FALSE,"Baltimore Ravens",3,13,8,152,124,28,0,17,259,144,115,2,2005-10-02,2,0,"nyj",-10
"5","Sun","October 9","W","","2-3",TRUE,"Tampa Bay Buccaneers",14,12,15,212,150,62,3,20,285,201,84,1,2005-10-09,-2,1,"nyj",2
"6","Sun","October 16","L","","2-4",FALSE,"Buffalo Bills",17,27,17,275,126,149,3,24,341,164,177,2,2005-10-16,-1,0,"nyj",-10
"7","Mon","October 24","L","","2-5",FALSE,"Atlanta Falcons",14,27,16,231,194,37,4,19,310,105,205,3,2005-10-24,-1,0,"nyj",-13
"9","Sun","November 6","L","","2-6",TRUE,"San Diego Chargers",26,31,19,269,180,89,0,27,395,262,133,2,2005-11-06,2,0,"nyj",-5
"10","Sun","November 13","L","","2-7",FALSE,"Carolina Panthers",3,30,15,214,77,137,6,15,220,119,101,2,2005-11-13,-4,0,"nyj",-27
"11","Sun","November 20","L","","2-8",FALSE,"Denver Broncos",0,27,10,195,176,19,5,28,404,213,191,1,2005-11-20,-4,0,"nyj",-27
"12","Sun","November 27","L","","2-9",TRUE,"New Orleans Saints",19,21,19,360,242,118,0,18,269,172,97,0,2005-11-27,0,0,"nyj",-2
"13","Sun","December 4","L","","2-10",FALSE,"New England Patriots",3,16,12,164,123,41,1,24,397,251,146,0,2005-12-04,-1,0,"nyj",-13
"14","Sun","December 11","W","","3-10",TRUE,"Oakland Raiders",26,10,23,294,110,184,0,14,179,84,95,4,2005-12-11,4,1,"nyj",16
"15","Sun","December 18","L","","3-11",FALSE,"Miami Dolphins",20,24,24,397,298,99,3,14,297,169,128,1,2005-12-18,-2,0,"nyj",-4
"16","Mon","December 26","L","","3-12",TRUE,"New England Patriots",21,31,10,171,131,40,3,26,321,170,151,1,2005-12-26,-2,0,"nyj",-10
"17","Sun","January 1","W","","4-12",TRUE,"Buffalo Bills",30,26,12,207,126,81,0,21,331,172,159,4,2006-01-01,4,1,"nyj",4
"1","Sun","September 10","W","","1-0",FALSE,"Tennessee Titans",23,16,24,393,302,91,2,22,328,242,86,3,2006-09-10,1,1,"nyj",7
"2","Sun","September 17","L","","1-1",TRUE,"New England Patriots",17,24,16,338,286,52,1,24,358,211,147,2,2006-09-17,1,0,"nyj",-7
"3","Sun","September 24","W","","2-1",FALSE,"Buffalo Bills",28,20,15,256,182,74,0,26,475,306,169,3,2006-09-24,3,1,"nyj",8
"4","Sun","October 1","L","","2-2",TRUE,"Indianapolis Colts",28,31,23,321,186,135,3,26,352,192,160,0,2006-10-01,-3,0,"nyj",-3
"5","Sun","October 8","L","","2-3",FALSE,"Jacksonville Jaguars",0,41,11,177,45,132,4,19,312,131,181,0,2006-10-08,-4,0,"nyj",-41
"6","Sun","October 15","W","","3-3",TRUE,"Miami Dolphins",20,17,15,272,169,103,0,24,395,266,129,3,2006-10-15,3,1,"nyj",3
"7","Sun","October 22","W","","4-3",TRUE,"Detroit Lions",31,24,27,398,177,221,1,22,386,261,125,2,2006-10-22,1,1,"nyj",7
"8","Sun","October 29","L","","4-4",FALSE,"Cleveland Browns",13,20,12,193,105,88,3,16,267,120,147,1,2006-10-29,-2,0,"nyj",-7
"10","Sun","November 12","W","","5-4",FALSE,"New England Patriots",17,14,19,278,161,117,1,22,377,232,145,2,2006-11-12,1,1,"nyj",3
"11","Sun","November 19","L","","5-5",TRUE,"Chicago Bears",0,10,15,264,156,108,2,12,284,111,173,0,2006-11-19,-2,0,"nyj",-10
"12","Sun","November 26","W","","6-5",TRUE,"Houston Texans",26,11,17,304,277,27,0,21,334,309,25,1,2006-11-26,1,1,"nyj",15
"13","Sun","December 3","W","","7-5",FALSE,"Green Bay Packers",38,10,27,441,263,178,2,23,351,202,149,3,2006-12-03,1,1,"nyj",28
"14","Sun","December 10","L","","7-6",TRUE,"Buffalo Bills",13,31,16,275,143,132,3,14,318,144,174,1,2006-12-10,-2,0,"nyj",-18
"15","Sun","December 17","W","","8-6",FALSE,"Minnesota Vikings",26,13,21,391,323,68,2,15,307,245,62,1,2006-12-17,-1,1,"nyj",13
"16","Mon","December 25","W","","9-6",FALSE,"Miami Dolphins",13,10,12,324,229,95,1,14,253,129,124,0,2006-12-25,-1,1,"nyj",3
"17","Sun","December 31","W","","10-6",TRUE,"Oakland Raiders",23,3,19,266,149,117,0,12,209,121,88,3,2006-12-31,3,1,"nyj",20
"WildCard","Sun","January 7","L","","10-7",FALSE,"New England Patriots",16,37,18,347,277,70,2,26,358,200,158,1,2007-01-07,-1,0,"nyj",-21
"1","Sun","September 9","L","","0-1",TRUE,"New England Patriots",14,38,17,227,167,60,0,28,431,297,134,0,2007-09-09,0,0,"nyj",-24
"2","Sun","September 16","L","","0-2",FALSE,"Baltimore Ravens",13,20,18,304,235,69,2,17,303,185,118,0,2007-09-16,-2,0,"nyj",-7
"3","Sun","September 23","W","","1-2",TRUE,"Miami Dolphins",31,28,22,256,115,141,0,28,424,312,112,1,2007-09-23,1,1,"nyj",3
"4","Sun","September 30","L","","1-3",FALSE,"Buffalo Bills",14,17,20,347,287,60,2,19,304,218,86,2,2007-09-30,0,0,"nyj",-3
"5","Sun","October 7","L","","1-4",FALSE,"New York Giants",24,35,16,277,222,55,3,21,374,186,188,2,2007-10-07,-1,0,"nyj",-11
"6","Sun","October 14","L","","1-5",TRUE,"Philadelphia Eagles",9,16,15,267,109,158,1,20,413,262,151,1,2007-10-14,0,0,"nyj",-7
"7","Sun","October 21","L","","1-6",FALSE,"Cincinnati Bengals",31,38,19,342,258,84,2,26,395,218,177,1,2007-10-21,-1,0,"nyj",-7
"8","Sun","October 28","L","","1-7",TRUE,"Buffalo Bills",3,13,14,254,154,100,3,19,347,239,108,1,2007-10-28,-2,0,"nyj",-10
"9","Sun","November 4","L","OT","1-8",TRUE,"Washington Redskins",20,23,23,338,214,124,1,23,431,135,296,1,2007-11-04,0,0,"nyj",-3
"11","Sun","November 18","W","OT","2-8",TRUE,"Pittsburgh Steelers",19,16,20,297,146,151,1,16,263,151,112,2,2007-11-18,1,1,"nyj",3
"12","Thu","November 22","L","","2-9",FALSE,"Dallas Cowboys",3,34,9,180,120,60,2,21,344,170,174,1,2007-11-22,-1,0,"nyj",-31
"13","Sun","December 2","W","","3-9",FALSE,"Miami Dolphins",40,13,20,372,209,163,2,12,187,150,37,5,2007-12-02,3,1,"nyj",27
"14","Sun","December 9","L","","3-10",TRUE,"Cleveland Browns",18,24,26,387,268,119,2,18,337,185,152,1,2007-12-09,-1,0,"nyj",-6
"15","Sun","December 16","L","","3-11",FALSE,"New England Patriots",10,20,13,234,144,90,2,16,265,134,131,1,2007-12-16,-1,0,"nyj",-10
"16","Sun","December 23","L","","3-12",FALSE,"Tennessee Titans",6,10,14,296,228,68,2,17,273,146,127,2,2007-12-23,0,0,"nyj",-4
"17","Sun","December 30","W","OT","4-12",TRUE,"Kansas City Chiefs",13,10,20,337,138,199,0,14,219,166,53,0,2007-12-30,0,1,"nyj",3
"1","Sun","September 7","W","","1-0",FALSE,"Miami Dolphins",20,14,15,293,181,112,1,18,277,228,49,1,2008-09-07,0,1,"nyj",6
"2","Sun","September 14","L","","1-1",TRUE,"New England Patriots",10,19,12,256,152,104,1,18,260,156,104,0,2008-09-14,-1,0,"nyj",-9
"3","Mon","September 22","L","","1-2",FALSE,"San Diego Chargers",29,48,21,308,267,41,4,20,357,250,107,1,2008-09-22,-3,0,"nyj",-19
"4","Sun","September 28","W","","2-2",TRUE,"Arizona Cardinals",56,35,23,373,284,89,1,33,468,426,42,7,2008-09-28,6,1,"nyj",21
"6","Sun","October 12","W","","3-2",TRUE,"Cincinnati Bengals",26,14,19,252,166,86,3,13,171,128,43,1,2008-10-12,-2,1,"nyj",12
"7","Sun","October 19","L","OT","3-3",FALSE,"Oakland Raiders",13,16,23,418,176,242,3,19,344,191,153,0,2008-10-19,-3,0,"nyj",-3
"8","Sun","October 26","W","","4-3",TRUE,"Kansas City Chiefs",28,24,22,420,285,135,3,17,330,250,80,0,2008-10-26,-3,1,"nyj",4
"9","Sun","November 2","W","","5-3",FALSE,"Buffalo Bills",26,17,16,297,201,96,1,18,292,262,30,3,2008-11-02,2,1,"nyj",9
"10","Sun","November 9","W","","6-3",TRUE,"St. Louis Rams",47,3,24,373,167,206,0,11,200,120,80,5,2008-11-09,5,1,"nyj",44
"11","Thu","November 13","W","OT","7-3",FALSE,"New England Patriots",34,31,23,375,235,140,1,26,511,386,125,1,2008-11-13,0,1,"nyj",3
"12","Sun","November 23","W","","8-3",FALSE,"Tennessee Titans",34,13,28,409,217,192,2,16,281,236,45,1,2008-11-23,-1,1,"nyj",21
"13","Sun","November 30","L","","8-4",TRUE,"Denver Broncos",17,34,22,383,241,142,2,23,484,357,127,1,2008-11-30,-1,0,"nyj",-17
"14","Sun","December 7","L","","8-5",FALSE,"San Francisco 49ers",14,24,10,182,123,59,1,25,375,275,100,2,2008-12-07,1,0,"nyj",-10
"15","Sun","December 14","W","","9-5",TRUE,"Buffalo Bills",31,27,18,372,207,165,2,23,306,119,187,4,2008-12-14,2,1,"nyj",4
"16","Sun","December 21","L","","9-6",FALSE,"Seattle Seahawks",3,13,16,265,150,115,2,17,295,175,120,2,2008-12-21,0,0,"nyj",-10
"17","Sun","December 28","L","","9-7",TRUE,"Miami Dolphins",17,24,16,331,251,80,4,18,319,193,126,1,2008-12-28,-3,0,"nyj",-7
"1","Sun","September 13","W","","1-0",FALSE,"Houston Texans",24,7,22,462,272,190,1,11,183,145,38,2,2009-09-13,1,1,"nyj",17
"2","Sun","September 20","W","","2-0",TRUE,"New England Patriots",16,9,14,254,137,117,1,18,299,216,83,1,2009-09-20,0,1,"nyj",7
"3","Sun","September 27","W","","3-0",TRUE,"Tennessee Titans",24,17,13,229,146,83,2,17,286,159,127,4,2009-09-27,2,1,"nyj",7
"4","Sun","October 4","L","","3-1",FALSE,"New Orleans Saints",10,24,14,244,112,132,4,18,343,190,153,1,2009-10-04,-3,0,"nyj",-14
"5","Mon","October 12","L","","3-2",FALSE,"Miami Dolphins",27,31,20,309,171,138,0,23,413,262,151,0,2009-10-12,0,0,"nyj",-4
"6","Sun","October 18","L","OT","3-3",TRUE,"Buffalo Bills",13,16,15,414,96,318,6,20,296,154,142,2,2009-10-18,-4,0,"nyj",-3
"7","Sun","October 25","W","","4-3",FALSE,"Oakland Raiders",38,0,26,447,131,316,0,13,263,144,119,4,2009-10-25,4,1,"nyj",38
"8","Sun","November 1","L","","4-4",TRUE,"Miami Dolphins",25,30,23,378,251,127,1,10,104,52,52,1,2009-11-01,0,0,"nyj",-5
"10","Sun","November 15","L","","4-5",TRUE,"Jacksonville Jaguars",22,24,19,322,212,110,3,18,347,208,139,1,2009-11-15,-2,0,"nyj",-2
"11","Sun","November 22","L","","4-6",FALSE,"New England Patriots",14,31,12,226,122,104,5,27,410,299,111,1,2009-11-22,-4,0,"nyj",-17
"12","Sun","November 29","W","","5-6",TRUE,"Carolina Panthers",17,6,16,283,144,139,3,11,179,104,75,4,2009-11-29,1,1,"nyj",11
"13","Thu","December 3","W","","6-6",FALSE,"Buffalo Bills",19,13,17,331,82,249,0,10,194,71,123,2,2009-12-03,2,1,"nyj",6
"14","Sun","December 13","W","","7-6",FALSE,"Tampa Bay Buccaneers",26,3,14,310,135,175,1,6,124,81,43,3,2009-12-13,2,1,"nyj",23
"15","Sun","December 20","L","","7-7",TRUE,"Atlanta Falcons",7,10,17,314,215,99,3,12,238,152,86,0,2009-12-20,-3,0,"nyj",-3
"16","Sun","December 27","W","","8-7",FALSE,"Indianapolis Colts",29,15,17,293,91,202,0,18,286,222,64,2,2009-12-27,2,1,"nyj",14
"17","Sun","January 3","W","","9-7",TRUE,"Cincinnati Bengals",37,0,21,320,63,257,0,5,72,0,72,3,2010-01-03,3,1,"nyj",37
"WildCard","Sat","January 9","W","","10-7",FALSE,"Cincinnati Bengals",24,14,15,353,182,171,0,18,281,110,171,2,2010-01-09,2,1,"nyj",10
"Division","Sun","January 17","W","","11-7",FALSE,"San Diego Chargers",17,14,14,262,93,169,1,18,344,283,61,2,2010-01-17,1,1,"nyj",3
"ConfChamp","Sun","January 24","L","","11-8",FALSE,"Indianapolis Colts",17,30,17,388,302,86,1,27,461,360,101,1,2010-01-24,0,0,"nyj",-13
"1","Mon","September 13","L","","0-1",TRUE,"Baltimore Ravens",9,10,6,176,60,116,1,20,282,233,49,3,2010-09-13,2,0,"nyj",-1
"2","Sun","September 19","W","","1-1",TRUE,"New England Patriots",28,14,23,336,200,136,0,20,291,239,52,3,2010-09-19,3,1,"nyj",14
"3","Sun","September 26","W","","2-1",FALSE,"Miami Dolphins",31,23,20,402,256,146,0,24,436,352,84,1,2010-09-26,1,1,"nyj",8
"4","Sun","October 3","W","","3-1",FALSE,"Buffalo Bills",38,14,25,444,171,273,0,12,223,109,114,2,2010-10-03,2,1,"nyj",24
"5","Mon","October 11","W","","4-1",TRUE,"Minnesota Vikings",29,20,20,328,173,155,0,16,336,240,96,3,2010-10-11,3,1,"nyj",9
"6","Sun","October 17","W","","5-1",FALSE,"Denver Broncos",24,20,17,319,190,129,3,21,346,201,145,2,2010-10-17,-1,1,"nyj",4
"8","Sun","October 31","L","","5-2",TRUE,"Green Bay Packers",0,9,15,360,241,119,3,13,237,156,81,0,2010-10-31,-3,0,"nyj",-9
"9","Sun","November 7","W","OT","6-2",FALSE,"Detroit Lions",23,20,23,437,327,110,2,21,306,228,78,0,2010-11-07,-2,1,"nyj",3
"10","Sun","November 14","W","OT","7-2",FALSE,"Cleveland Browns",26,20,28,456,284,172,1,19,303,196,107,2,2010-11-14,1,1,"nyj",6
"11","Sun","November 21","W","","8-2",TRUE,"Houston Texans",30,27,22,401,298,103,2,17,343,246,97,1,2010-11-21,-1,1,"nyj",3
"12","Thu","November 25","W","","9-2",TRUE,"Cincinnati Bengals",26,10,18,319,149,170,1,13,163,117,46,3,2010-11-25,2,1,"nyj",16
"13","Mon","December 6","L","","9-3",FALSE,"New England Patriots",3,45,18,301,149,152,3,23,405,304,101,0,2010-12-06,-3,0,"nyj",-42
"14","Sun","December 12","L","","9-4",TRUE,"Miami Dolphins",6,10,14,280,193,87,2,6,131,30,101,3,2010-12-12,1,0,"nyj",-4
"15","Sun","December 19","W","","10-4",FALSE,"Pittsburgh Steelers",22,17,17,276,170,106,0,25,377,231,146,0,2010-12-19,0,1,"nyj",5
"16","Sun","December 26","L","","10-5",FALSE,"Chicago Bears",34,38,24,393,269,124,2,16,322,202,120,1,2010-12-26,-1,0,"nyj",-4
"17","Sun","January 2","W","","11-5",TRUE,"Buffalo Bills",38,7,17,388,112,276,1,6,162,125,37,6,2011-01-02,5,1,"nyj",31
"WildCard","Sat","January 8","W","","12-5",FALSE,"Indianapolis Colts",17,16,23,353,184,169,1,16,312,219,93,0,2011-01-08,-1,1,"nyj",1
"Division","Sun","January 16","W","","13-5",FALSE,"New England Patriots",28,21,14,314,194,120,0,26,372,259,113,1,2011-01-16,1,1,"nyj",7
"ConfChamp","Sun","January 23","L","","13-6",FALSE,"Pittsburgh Steelers",19,24,17,289,219,70,1,23,287,121,166,2,2011-01-23,1,0,"nyj",-5
"1","Sun","September 11","W","","1-0",TRUE,"Dallas Cowboys",27,24,19,360,315,45,2,21,390,326,64,3,2011-09-11,1,1,"nyj",3
"2","Sun","September 18","W","","2-0",TRUE,"Jacksonville Jaguars",32,3,15,283,182,101,2,11,203,91,112,4,2011-09-18,2,1,"nyj",29
"3","Sun","September 25","L","","2-1",FALSE,"Oakland Raiders",24,34,25,439,339,100,2,23,383,149,234,0,2011-09-25,-2,0,"nyj",-10
"4","Sun","October 2","L","","2-2",FALSE,"Baltimore Ravens",17,34,7,150,112,38,4,16,267,155,112,3,2011-10-02,-1,0,"nyj",-17
"5","Sun","October 9","L","","2-3",FALSE,"New England Patriots",21,30,14,255,158,97,0,26,446,294,152,1,2011-10-09,1,0,"nyj",-9
"6","Mon","October 17","W","","3-3",TRUE,"Miami Dolphins",24,6,13,296,192,104,1,17,308,190,118,3,2011-10-17,2,1,"nyj",18
"7","Sun","October 23","W","","4-3",TRUE,"San Diego Chargers",27,21,25,318,156,162,2,16,268,172,96,2,2011-10-23,0,1,"nyj",6
"9","Sun","November 6","W","","5-3",FALSE,"Buffalo Bills",27,11,24,348,222,126,2,14,287,191,96,3,2011-11-06,1,1,"nyj",16
"10","Sun","November 13","L","","5-4",TRUE,"New England Patriots",16,37,22,378,268,110,3,21,389,329,60,0,2011-11-13,-3,0,"nyj",-21
"11","Thu","November 17","L","","5-5",FALSE,"Denver Broncos",13,17,22,318,235,83,2,11,229,104,125,1,2011-11-17,-1,0,"nyj",-4
"12","Sun","November 27","W","","6-5",TRUE,"Buffalo Bills",28,24,20,318,180,138,2,21,336,250,86,0,2011-11-27,-2,1,"nyj",4
"13","Sun","December 4","W","","7-5",FALSE,"Washington Redskins",34,19,16,266,165,101,1,17,304,204,100,3,2011-12-04,2,1,"nyj",15
"14","Sun","December 11","W","","8-5",TRUE,"Kansas City Chiefs",37,10,24,314,155,159,1,13,221,156,65,1,2011-12-11,0,1,"nyj",27
"15","Sun","December 18","L","","8-6",FALSE,"Philadelphia Eagles",19,45,13,241,147,94,4,20,420,260,160,4,2011-12-18,0,0,"nyj",-26
"16","Sat","December 24","L","","8-7",TRUE,"New York Giants",14,29,22,331,226,105,3,11,332,217,115,1,2011-12-24,-2,0,"nyj",-15
"17","Sun","January 1","L","","8-8",FALSE,"Miami Dolphins",17,19,20,374,245,129,3,14,210,128,82,2,2012-01-01,-1,0,"nyj",-2
"1","Sun","September 8","L","","0-1",FALSE,"Houston Oilers",23,26,17,360,291,69,3,21,394,229,165,4,1985-09-08,1,0,"mia",-3
"2","Sun","September 15","W","","1-1",TRUE,"Indianapolis Colts",30,13,33,486,329,157,1,17,298,202,96,1,1985-09-15,0,1,"mia",17
"3","Sun","September 22","W","","2-1",TRUE,"Kansas City Chiefs",31,0,27,391,258,133,2,15,284,187,97,2,1985-09-22,0,1,"mia",31
"4","Sun","September 29","W","","3-1",FALSE,"Denver Broncos",30,26,19,418,365,53,1,23,395,226,169,2,1985-09-29,1,1,"mia",4
"5","Sun","October 6","W","","4-1",TRUE,"Pittsburgh Steelers",24,20,24,399,277,122,4,15,282,145,137,1,1985-10-06,-3,1,"mia",4
"6","Mon","October 14","L","","4-2",FALSE,"New York Jets",7,23,13,200,126,74,1,27,476,231,245,0,1985-10-14,-1,0,"mia",-16
"7","Sun","October 20","W","","5-2",TRUE,"Tampa Bay Buccaneers",41,38,30,446,302,144,2,24,476,365,111,1,1985-10-20,-1,1,"mia",3
"8","Sun","October 27","L","","5-3",FALSE,"Detroit Lions",21,31,20,341,239,102,3,21,355,203,152,1,1985-10-27,-2,0,"mia",-10
"9","Sun","November 3","L","","5-4",FALSE,"New England Patriots",13,17,19,236,145,91,4,22,380,177,203,4,1985-11-03,0,0,"mia",-4
"10","Sun","November 10","W","","6-4",TRUE,"New York Jets",21,17,19,400,347,53,5,27,491,371,120,2,1985-11-10,-3,1,"mia",4
"11","Sun","November 17","W","","7-4",FALSE,"Indianapolis Colts",34,20,25,458,323,135,2,17,352,210,142,4,1985-11-17,2,1,"mia",14
"12","Sun","November 24","W","","8-4",FALSE,"Buffalo Bills",23,14,28,388,216,172,2,12,255,161,94,1,1985-11-24,-1,1,"mia",9
"13","Mon","December 2","W","","9-4",TRUE,"Chicago Bears",38,24,17,335,245,90,2,23,343,176,167,4,1985-12-02,2,1,"mia",14
"14","Sun","December 8","W","","10-4",FALSE,"Green Bay Packers",34,24,24,408,345,63,3,20,366,241,125,4,1985-12-08,1,1,"mia",10
"15","Mon","December 16","W","","11-4",TRUE,"New England Patriots",30,27,22,269,177,92,4,19,321,199,122,4,1985-12-16,0,1,"mia",3
"16","Sun","December 22","W","","12-4",TRUE,"Buffalo Bills",28,0,24,308,129,179,2,11,299,188,111,6,1985-12-22,4,1,"mia",28
"Division","Sat","January 4","W","","13-4",TRUE,"Cleveland Browns",24,21,20,330,238,92,1,17,313,62,251,1,1986-01-04,0,1,"mia",3
"ConfChamp","Sun","January 12","L","","13-5",TRUE,"New England Patriots",14,31,18,302,234,68,6,21,326,71,255,2,1986-01-12,-4,0,"mia",-17
"1","Sun","September 7","L","","0-1",FALSE,"San Diego Chargers",28,50,20,339,294,45,4,31,500,276,224,0,1986-09-07,-4,0,"mia",-22
"2","Sun","September 14","W","","1-1",TRUE,"Indianapolis Colts",30,10,21,388,254,134,1,15,253,178,75,2,1986-09-14,1,1,"mia",20
"3","Sun","September 21","L","OT","1-2",FALSE,"New York Jets",45,51,27,485,435,50,3,32,581,449,132,4,1986-09-21,1,0,"mia",-6
"4","Sun","September 28","L","","1-3",TRUE,"San Francisco 49ers",16,31,24,437,365,72,4,16,314,168,146,1,1986-09-28,-3,0,"mia",-15
"5","Sun","October 5","L","","1-4",FALSE,"New England Patriots",7,34,13,251,152,99,3,25,429,262,167,0,1986-10-05,-3,0,"mia",-27
"6","Sun","October 12","W","","2-4",TRUE,"Buffalo Bills",27,14,27,447,328,119,3,18,305,197,108,4,1986-10-12,1,1,"mia",13
"7","Sun","October 19","L","","2-5",TRUE,"Los Angeles Raiders",28,30,17,330,273,57,4,19,315,101,214,0,1986-10-19,-4,0,"mia",-2
"8","Sun","October 26","W","","3-5",FALSE,"Indianapolis Colts",17,13,21,340,243,97,0,17,303,121,182,1,1986-10-26,1,1,"mia",4
"9","Sun","November 2","W","","4-5",TRUE,"Houston Oilers",28,7,17,345,217,128,3,18,301,137,164,2,1986-11-02,-1,1,"mia",21
"10","Mon","November 10","L","","4-6",FALSE,"Cleveland Browns",16,26,20,353,295,58,2,29,558,390,168,2,1986-11-10,0,0,"mia",-10
"11","Sun","November 16","W","","5-6",FALSE,"Buffalo Bills",34,24,29,474,389,85,0,14,261,181,80,1,1986-11-16,1,1,"mia",10
"12","Mon","November 24","W","","6-6",TRUE,"New York Jets",45,3,31,514,325,189,0,17,280,191,89,4,1986-11-24,4,1,"mia",42
"13","Sun","November 30","L","","6-7",TRUE,"Atlanta Falcons",14,20,16,375,303,72,4,13,362,143,219,1,1986-11-30,-3,0,"mia",-6
"14","Sun","December 7","W","","7-7",FALSE,"New Orleans Saints",31,27,25,352,241,111,0,26,526,269,257,2,1986-12-07,2,1,"mia",4
"15","Sun","December 14","W","OT","8-7",FALSE,"Los Angeles Rams",37,31,23,506,399,107,2,25,372,230,142,1,1986-12-14,-1,1,"mia",6
"16","Mon","December 22","L","","8-8",TRUE,"New England Patriots",27,34,20,388,266,122,4,22,390,264,126,2,1986-12-22,-2,0,"mia",-7
"1","Sun","September 13","L","","0-1",FALSE,"New England Patriots",21,28,20,285,221,64,2,18,309,150,159,4,1987-09-13,2,0,"mia",-7
"2","Sun","September 20","W","","1-1",FALSE,"Indianapolis Colts",23,10,20,375,245,130,2,20,342,258,84,4,1987-09-20,2,1,"mia",13
"3","Sun","October 4","L","","1-2",FALSE,"Seattle Seahawks",20,24,19,324,160,164,2,20,402,326,76,3,1987-10-04,1,0,"mia",-4
"4","Sun","October 11","W","","2-2",TRUE,"Kansas City Chiefs",42,0,25,344,142,202,1,8,132,42,90,4,1987-10-11,3,1,"mia",42
"5","Sun","October 18","L","OT","2-3",FALSE,"New York Jets",31,37,30,414,286,128,6,24,477,294,183,5,1987-10-18,-1,0,"mia",-6
"6","Sun","October 25","L","OT","2-4",TRUE,"Buffalo Bills",31,34,21,366,296,70,2,29,474,330,144,0,1987-10-25,-2,0,"mia",-3
"7","Sun","November 1","W","","3-4",TRUE,"Pittsburgh Steelers",35,24,26,478,332,146,3,22,315,199,116,1,1987-11-01,-2,1,"mia",11
"8","Sun","November 8","W","","4-4",FALSE,"Cincinnati Bengals",20,14,22,333,235,98,0,23,358,202,156,2,1987-11-08,2,1,"mia",6
"9","Sun","November 15","L","","4-5",TRUE,"Indianapolis Colts",21,40,22,286,209,77,5,32,457,218,239,0,1987-11-15,-5,0,"mia",-19
"10","Sun","November 22","W","","5-5",FALSE,"Dallas Cowboys",20,14,21,440,258,182,1,16,319,134,185,3,1987-11-22,2,1,"mia",6
"11","Sun","November 29","L","","5-6",FALSE,"Buffalo Bills",0,27,13,229,206,23,3,21,446,217,229,0,1987-11-29,-3,0,"mia",-27
"12","Mon","December 7","W","","6-6",TRUE,"New York Jets",37,28,30,432,293,139,1,13,256,216,40,2,1987-12-07,1,1,"mia",9
"13","Sun","December 13","W","","7-6",FALSE,"Philadelphia Eagles",28,10,23,476,357,119,4,15,310,155,155,1,1987-12-13,-3,1,"mia",18
"14","Sun","December 20","W","","8-6",TRUE,"Washington Redskins",23,21,22,459,393,66,1,28,472,268,204,2,1987-12-20,1,1,"mia",2
"15","Mon","December 28","L","","8-7",TRUE,"New England Patriots",10,24,17,297,243,54,4,25,376,238,138,1,1987-12-28,-3,0,"mia",-14
"1","Sun","September 4","L","","0-1",FALSE,"Chicago Bears",7,34,10,163,118,45,2,28,427,165,262,0,1988-09-04,-2,0,"mia",-27
"2","Sun","September 11","L","","0-2",FALSE,"Buffalo Bills",6,9,16,334,219,115,2,15,319,215,104,4,1988-09-11,2,0,"mia",-3
"3","Sun","September 18","W","","1-2",TRUE,"Green Bay Packers",24,17,17,354,256,98,3,22,338,260,78,0,1988-09-18,-3,1,"mia",7
"4","Sun","September 25","L","","1-3",FALSE,"Indianapolis Colts",13,15,18,323,252,71,2,18,304,91,213,1,1988-09-25,-1,0,"mia",-2
"5","Sun","October 2","W","","2-3",TRUE,"Minnesota Vikings",24,7,20,342,264,78,3,17,353,295,58,4,1988-10-02,1,1,"mia",17
"6","Sun","October 9","W","","3-3",FALSE,"Los Angeles Raiders",24,14,19,266,175,91,1,19,344,266,78,5,1988-10-09,4,1,"mia",10
"7","Sun","October 16","W","","4-3",TRUE,"San Diego Chargers",31,28,25,375,329,46,1,23,396,283,113,4,1988-10-16,3,1,"mia",3
"8","Sun","October 23","L","","4-4",TRUE,"New York Jets",30,44,29,584,521,63,6,24,333,174,159,1,1988-10-23,-5,0,"mia",-14
"9","Sun","October 30","W","","5-4",FALSE,"Tampa Bay Buccaneers",17,14,20,309,266,43,0,21,362,283,79,5,1988-10-30,5,1,"mia",3
"10","Sun","November 6","L","","5-5",FALSE,"New England Patriots",10,21,23,437,359,78,2,18,277,74,203,1,1988-11-06,-1,0,"mia",-11
"11","Mon","November 14","L","","5-6",TRUE,"Buffalo Bills",6,31,15,257,224,33,3,29,416,211,205,0,1988-11-14,-3,0,"mia",-25
"12","Sun","November 20","L","","5-7",TRUE,"New England Patriots",3,6,15,293,169,124,0,17,236,66,170,0,1988-11-20,0,0,"mia",-3
"13","Sun","November 27","L","","5-8",FALSE,"New York Jets",34,38,20,440,353,87,1,39,597,426,171,2,1988-11-27,1,0,"mia",-4
"14","Sun","December 4","L","","5-9",TRUE,"Indianapolis Colts",28,31,21,362,304,58,2,23,322,101,221,0,1988-12-04,-2,0,"mia",-3
"15","Mon","December 12","W","","6-9",TRUE,"Cleveland Browns",38,31,35,497,404,93,4,22,353,266,87,3,1988-12-12,-1,1,"mia",7
"16","Sun","December 18","L","","6-10",FALSE,"Pittsburgh Steelers",24,40,18,385,303,82,3,24,404,99,305,1,1988-12-18,-2,0,"mia",-16
"1","Sun","September 10","L","","0-1",TRUE,"Buffalo Bills",24,27,20,323,255,68,4,27,367,226,141,2,1989-09-10,-2,0,"mia",-3
"2","Sun","September 17","W","","1-1",FALSE,"New England Patriots",24,10,18,329,226,103,4,19,325,282,43,1,1989-09-17,-3,1,"mia",14
"3","Sun","September 24","L","","1-2",TRUE,"New York Jets",33,40,30,524,446,78,2,25,411,309,102,2,1989-09-24,0,0,"mia",-7
"4","Sun","October 1","L","","1-3",FALSE,"Houston Oilers",7,39,9,160,117,43,3,23,448,251,197,1,1989-10-01,-2,0,"mia",-32
"5","Sun","October 8","W","OT","2-3",TRUE,"Cleveland Browns",13,10,18,304,234,70,1,19,330,189,141,2,1989-10-08,1,1,"mia",3
"6","Sun","October 15","W","","3-3",FALSE,"Cincinnati Bengals",20,13,19,373,266,107,1,14,314,168,146,0,1989-10-15,-1,1,"mia",7
"7","Sun","October 22","W","","4-3",TRUE,"Green Bay Packers",23,20,24,438,333,105,3,21,296,215,81,0,1989-10-22,-3,1,"mia",3
"8","Sun","October 29","L","","4-4",FALSE,"Buffalo Bills",17,31,19,413,348,65,3,18,394,114,280,1,1989-10-29,-2,0,"mia",-14
"9","Sun","November 5","W","","5-4",TRUE,"Indianapolis Colts",19,13,19,308,149,159,3,17,299,214,85,2,1989-11-05,-1,1,"mia",6
"10","Sun","November 12","W","","6-4",FALSE,"New York Jets",31,23,19,447,344,103,3,23,410,274,136,3,1989-11-12,0,1,"mia",8
"11","Sun","November 19","W","","7-4",FALSE,"Dallas Cowboys",17,14,18,303,238,65,1,28,428,261,167,2,1989-11-19,1,1,"mia",3
"12","Sun","November 26","L","","7-5",TRUE,"Pittsburgh Steelers",14,34,15,302,222,80,5,13,292,161,131,0,1989-11-26,-5,0,"mia",-20
"13","Sun","December 3","L","","7-6",FALSE,"Kansas City Chiefs",21,26,15,291,218,73,3,25,438,239,199,3,1989-12-03,0,0,"mia",-5
"14","Sun","December 10","W","","8-6",TRUE,"New England Patriots",31,10,24,408,300,108,1,17,297,231,66,2,1989-12-10,1,1,"mia",21
"15","Sun","December 17","L","","8-7",FALSE,"Indianapolis Colts",13,42,16,242,201,41,3,25,305,184,121,1,1989-12-17,-2,0,"mia",-29
"16","Sun","December 24","L","","8-8",TRUE,"Kansas City Chiefs",24,27,27,381,319,62,1,23,342,225,117,1,1989-12-24,0,0,"mia",-3
"1","Sun","September 9","W","","1-0",FALSE,"New England Patriots",27,24,23,432,255,177,4,13,265,183,82,0,1990-09-09,-4,1,"mia",3
"2","Sun","September 16","W","","2-0",TRUE,"Buffalo Bills",30,7,19,305,177,128,1,12,205,161,44,3,1990-09-16,2,1,"mia",23
"3","Sun","September 23","L","","2-1",FALSE,"New York Giants",3,20,7,158,119,39,3,17,310,179,131,0,1990-09-23,-3,0,"mia",-17
"4","Sun","September 30","W","","3-1",FALSE,"Pittsburgh Steelers",28,6,20,324,202,122,1,8,160,119,41,3,1990-09-30,2,1,"mia",22
"5","Sun","October 7","W","","4-1",TRUE,"New York Jets",20,16,21,334,262,72,0,22,342,228,114,0,1990-10-07,0,1,"mia",4
"7","Thu","October 18","W","","5-1",TRUE,"New England Patriots",17,10,15,279,229,50,5,13,197,148,49,0,1990-10-18,-5,1,"mia",7
"8","Sun","October 28","W","","6-1",FALSE,"Indianapolis Colts",27,7,23,356,150,206,1,7,132,101,31,4,1990-10-28,3,1,"mia",20
"9","Sun","November 4","W","","7-1",TRUE,"Phoenix Cardinals",23,3,20,350,205,145,1,11,205,131,74,2,1990-11-04,1,1,"mia",20
"10","Sun","November 11","W","","8-1",FALSE,"New York Jets",17,3,24,320,192,128,3,11,154,66,88,3,1990-11-11,0,1,"mia",14
"11","Mon","November 19","L","","8-2",TRUE,"Los Angeles Raiders",10,13,16,213,199,14,0,18,293,116,177,0,1990-11-19,0,0,"mia",-3
"12","Sun","November 25","W","","9-2",FALSE,"Cleveland Browns",30,13,20,356,245,111,0,20,294,185,109,2,1990-11-25,2,1,"mia",17
"13","Sun","December 2","L","","9-3",FALSE,"Washington Redskins",20,42,13,252,218,34,2,29,467,245,222,1,1990-12-02,-1,0,"mia",-22
"14","Sun","December 9","W","OT","10-3",TRUE,"Philadelphia Eagles",23,20,26,405,351,54,1,21,434,177,257,1,1990-12-09,0,1,"mia",3
"15","Sun","December 16","W","","11-3",TRUE,"Seattle Seahawks",24,17,20,347,242,105,3,21,344,261,83,4,1990-12-16,1,1,"mia",7
"16","Sun","December 23","L","","11-4",FALSE,"Buffalo Bills",14,24,20,309,274,35,2,25,429,223,206,1,1990-12-23,-1,0,"mia",-10
"17","Sun","December 30","W","","12-4",TRUE,"Indianapolis Colts",23,17,16,307,192,115,0,20,316,193,123,3,1990-12-30,3,1,"mia",6
"WildCard","Sat","January 5","W","","13-4",TRUE,"Kansas City Chiefs",17,16,23,311,213,98,2,16,367,264,103,1,1991-01-05,-1,1,"mia",1
"Division","Sat","January 12","L","","13-5",FALSE,"Buffalo Bills",34,44,24,430,323,107,3,24,493,339,154,2,1991-01-12,-1,0,"mia",-10
"1","Sun","September 1","L","","0-1",FALSE,"Buffalo Bills",31,35,23,396,250,146,1,33,582,397,185,2,1991-09-01,1,0,"mia",-4
"2","Sun","September 8","W","","1-1",TRUE,"Indianapolis Colts",17,6,20,277,129,148,2,11,150,81,69,0,1991-09-08,-2,1,"mia",11
"3","Sun","September 15","L","","1-2",FALSE,"Detroit Lions",13,17,17,226,154,72,0,24,353,164,189,1,1991-09-15,1,0,"mia",-4
"4","Sun","September 22","W","","2-2",TRUE,"Green Bay Packers",16,13,11,232,195,37,1,13,263,219,44,3,1991-09-22,2,1,"mia",3
"5","Sun","September 29","L","","2-3",FALSE,"New York Jets",23,41,19,324,278,46,2,20,427,221,206,0,1991-09-29,-2,0,"mia",-18
"6","Sun","October 6","W","","3-3",FALSE,"New England Patriots",20,10,19,370,314,56,2,14,195,140,55,2,1991-10-06,0,1,"mia",10
"7","Sun","October 13","L","","3-4",FALSE,"Kansas City Chiefs",7,42,19,345,253,92,2,25,452,231,221,0,1991-10-13,-2,0,"mia",-35
"8","Sun","October 20","L","","3-5",TRUE,"Houston Oilers",13,17,16,275,218,57,5,23,282,162,120,4,1991-10-20,-1,0,"mia",-4
"10","Sun","November 3","W","","4-5",FALSE,"Indianapolis Colts",10,6,15,298,231,67,0,15,278,183,95,2,1991-11-03,2,1,"mia",4
"11","Sun","November 10","W","","5-5",TRUE,"New England Patriots",30,20,20,324,255,69,1,18,323,239,84,1,1991-11-10,0,1,"mia",10
"12","Mon","November 18","L","","5-6",TRUE,"Buffalo Bills",27,41,25,392,317,75,5,27,433,171,262,0,1991-11-18,-5,0,"mia",-14
"13","Sun","November 24","W","OT","6-6",FALSE,"Chicago Bears",16,13,17,275,172,103,3,23,328,204,124,1,1991-11-24,-2,1,"mia",3
"14","Sun","December 1","W","","7-6",TRUE,"Tampa Bay Buccaneers",33,14,25,468,297,171,1,19,258,199,59,2,1991-12-01,1,1,"mia",19
"15","Mon","December 9","W","","8-6",TRUE,"Cincinnati Bengals",37,13,21,358,266,92,0,19,355,196,159,2,1991-12-09,2,1,"mia",24
"16","Sun","December 15","L","","8-7",FALSE,"San Diego Chargers",30,38,23,348,273,75,2,20,368,170,198,0,1991-12-15,-2,0,"mia",-8
"17","Sun","December 22","L","OT","8-8",TRUE,"New York Jets",20,23,22,333,287,46,1,23,359,128,231,1,1991-12-22,0,0,"mia",-3
"2","Mon","September 14","W","","1-0",FALSE,"Cleveland Browns",27,23,24,401,300,101,1,17,322,211,111,0,1992-09-14,-1,1,"mia",4
"3","Sun","September 20","W","","2-0",TRUE,"Los Angeles Rams",26,10,24,381,223,158,2,15,298,214,84,4,1992-09-20,2,1,"mia",16
"4","Sun","September 27","W","","3-0",FALSE,"Seattle Seahawks",19,17,18,314,255,59,4,14,221,135,86,2,1992-09-27,-2,1,"mia",2
"5","Sun","October 4","W","","4-0",FALSE,"Buffalo Bills",37,10,20,362,282,80,1,26,400,337,63,5,1992-10-04,4,1,"mia",27
"6","Sun","October 11","W","","5-0",TRUE,"Atlanta Falcons",21,17,22,346,248,98,1,19,323,254,69,2,1992-10-11,1,1,"mia",4
"7","Sun","October 18","W","","6-0",TRUE,"New England Patriots",38,17,20,387,289,98,3,15,273,255,18,1,1992-10-18,-2,1,"mia",21
"8","Sun","October 25","L","","6-1",TRUE,"Indianapolis Colts",20,31,24,413,348,65,5,20,262,153,109,2,1992-10-25,-3,0,"mia",-11
"9","Sun","November 1","L","","6-2",FALSE,"New York Jets",14,26,11,296,213,83,2,21,363,203,160,1,1992-11-01,-1,0,"mia",-12
"10","Sun","November 8","W","","7-2",FALSE,"Indianapolis Colts",28,0,28,453,241,212,1,11,193,125,68,4,1992-11-08,3,1,"mia",28
"11","Mon","November 16","L","","7-3",TRUE,"Buffalo Bills",20,26,20,350,286,64,2,26,323,212,111,0,1992-11-16,-2,0,"mia",-6
"12","Sun","November 22","W","","8-3",TRUE,"Houston Oilers",19,16,18,293,221,72,2,16,297,201,96,3,1992-11-22,1,1,"mia",3
"13","Sun","November 29","L","","8-4",FALSE,"New Orleans Saints",13,24,17,281,223,58,3,15,252,125,127,1,1992-11-29,-2,0,"mia",-11
"14","Sun","December 6","L","","8-5",FALSE,"San Francisco 49ers",3,27,15,239,199,40,1,20,356,220,136,1,1992-12-06,0,0,"mia",-24
"15","Mon","December 14","W","","9-5",TRUE,"Los Angeles Raiders",20,7,20,360,228,132,1,9,151,78,73,2,1992-12-14,1,1,"mia",13
"16","Sun","December 20","W","","10-5",TRUE,"New York Jets",19,17,14,294,203,91,3,12,270,158,112,2,1992-12-20,-1,1,"mia",2
"17","Sun","December 27","W","OT","11-5",FALSE,"New England Patriots",16,13,21,330,216,114,2,17,279,102,177,2,1992-12-27,0,1,"mia",3
"Division","Sun","January 10","W","","12-5",TRUE,"San Diego Chargers",31,0,18,324,167,157,1,10,202,132,70,5,1993-01-10,4,1,"mia",31
"ConfChamp","Sun","January 17","L","","12-6",TRUE,"Buffalo Bills",10,29,15,276,243,33,5,20,358,176,182,2,1993-01-17,-3,0,"mia",-19
"1","Sun","September 5","W","","1-0",FALSE,"Indianapolis Colts",24,20,19,355,236,119,2,16,274,232,42,3,1993-09-05,1,1,"mia",4
"2","Sun","September 12","L","","1-1",TRUE,"New York Jets",14,24,14,294,267,27,2,22,429,323,106,1,1993-09-12,-1,0,"mia",-10
"4","Sun","September 26","W","","2-1",FALSE,"Buffalo Bills",22,13,23,412,275,137,2,16,282,176,106,2,1993-09-26,0,1,"mia",9
"5","Mon","October 4","W","","3-1",TRUE,"Washington Redskins",17,10,17,354,248,106,1,20,232,148,84,1,1993-10-04,0,1,"mia",7
"6","Sun","October 10","W","","4-1",FALSE,"Cleveland Browns",24,14,20,338,268,70,1,16,202,112,90,2,1993-10-10,1,1,"mia",10
"8","Sun","October 24","W","","5-1",TRUE,"Indianapolis Colts",41,27,18,366,195,171,2,24,322,234,88,4,1993-10-24,2,1,"mia",14
"9","Sun","October 31","W","","6-1",TRUE,"Kansas City Chiefs",30,10,26,483,344,139,2,18,305,206,99,3,1993-10-31,1,1,"mia",20
"10","Sun","November 7","L","","6-2",FALSE,"New York Jets",10,27,15,337,289,48,2,24,356,256,100,1,1993-11-07,-1,0,"mia",-17
"11","Sun","November 14","W","","7-2",FALSE,"Philadelphia Eagles",19,14,13,298,178,120,2,19,260,157,103,3,1993-11-14,1,1,"mia",5
"12","Sun","November 21","W","","8-2",TRUE,"New England Patriots",17,13,15,344,233,111,0,23,349,261,88,1,1993-11-21,1,1,"mia",4
"13","Thu","November 25","W","","9-2",FALSE,"Dallas Cowboys",16,14,15,382,274,108,4,19,293,181,112,2,1993-11-25,-2,1,"mia",2
"14","Sun","December 5","L","","9-3",TRUE,"New York Giants",14,19,23,408,357,51,3,19,351,241,110,0,1993-12-05,-3,0,"mia",-5
"15","Mon","December 13","L","","9-4",TRUE,"Pittsburgh Steelers",20,21,21,348,299,49,3,19,265,145,120,0,1993-12-13,-3,0,"mia",-1
"16","Sun","December 19","L","","9-5",TRUE,"Buffalo Bills",34,47,24,423,400,23,5,28,374,245,129,2,1993-12-19,-3,0,"mia",-13
"17","Mon","December 27","L","","9-6",FALSE,"San Diego Chargers",20,45,23,321,260,61,3,25,459,239,220,0,1993-12-27,-3,0,"mia",-25
"18","Sun","January 2","L","OT","9-7",FALSE,"New England Patriots",27,33,23,349,230,119,0,25,397,329,68,2,1994-01-02,2,0,"mia",-6
"1","Sun","September 4","W","","1-0",TRUE,"New England Patriots",39,35,21,525,456,69,3,25,472,418,54,3,1994-09-04,0,1,"mia",4
"2","Sun","September 11","W","","2-0",FALSE,"Green Bay Packers",24,14,20,308,162,146,0,23,383,345,38,2,1994-09-11,2,1,"mia",10
"3","Sun","September 18","W","","3-0",TRUE,"New York Jets",28,14,26,444,289,155,2,18,343,284,59,4,1994-09-18,2,1,"mia",14
"4","Sun","September 25","L","","3-1",FALSE,"Minnesota Vikings",35,38,27,473,426,47,4,24,458,311,147,0,1994-09-25,-4,0,"mia",-3
"5","Sun","October 2","W","","4-1",FALSE,"Cincinnati Bengals",23,7,21,345,204,141,0,14,246,184,62,5,1994-10-02,5,1,"mia",16
"6","Sun","October 9","L","","4-2",FALSE,"Buffalo Bills",11,21,19,326,212,114,1,25,344,130,214,2,1994-10-09,1,0,"mia",-10
"7","Sun","October 16","W","OT","5-2",TRUE,"Los Angeles Raiders",20,17,19,344,175,169,3,12,210,86,124,1,1994-10-16,-2,1,"mia",3
"9","Sun","October 30","W","","6-2",FALSE,"New England Patriots",23,3,20,338,198,140,2,11,188,142,46,3,1994-10-30,1,1,"mia",20
"10","Sun","November 6","W","","7-2",TRUE,"Indianapolis Colts",22,21,25,372,254,118,2,17,213,108,105,1,1994-11-06,-1,1,"mia",1
"11","Sun","November 13","L","","7-3",TRUE,"Chicago Bears",14,17,18,344,275,69,2,18,273,211,62,2,1994-11-13,0,0,"mia",-3
"12","Sun","November 20","L","OT","7-4",FALSE,"Pittsburgh Steelers",13,16,20,323,283,40,2,21,423,335,88,0,1994-11-20,-2,0,"mia",-3
"13","Sun","November 27","W","","8-4",FALSE,"New York Jets",28,24,22,397,359,38,4,25,441,365,76,2,1994-11-27,-2,1,"mia",4
"14","Sun","December 4","L","","8-5",TRUE,"Buffalo Bills",31,42,25,460,387,73,4,19,398,322,76,2,1994-12-04,-2,0,"mia",-11
"15","Mon","December 12","W","","9-5",TRUE,"Kansas City Chiefs",45,28,23,385,241,144,0,26,398,314,84,3,1994-12-12,3,1,"mia",17
"16","Sun","December 18","L","","9-6",FALSE,"Indianapolis Colts",6,10,17,311,214,97,0,12,212,69,143,0,1994-12-18,0,0,"mia",-4
"17","Sun","December 25","W","","10-6",TRUE,"Detroit Lions",27,20,21,383,285,98,3,15,222,170,52,2,1994-12-25,-1,1,"mia",7
"WildCard","Sat","December 31","W","","11-6",TRUE,"Kansas City Chiefs",27,17,22,381,249,132,0,24,414,314,100,2,1994-12-31,2,1,"mia",10
"Division","Sun","January 8","L","","11-7",FALSE,"San Diego Chargers",21,22,17,282,256,26,0,28,466,264,202,3,1995-01-08,3,0,"mia",-1
"1","Sun","September 3","W","","1-0",TRUE,"New York Jets",52,14,22,362,251,111,4,16,259,195,64,6,1995-09-03,2,1,"mia",38
"2","Sun","September 10","W","","2-0",FALSE,"New England Patriots",20,3,21,406,224,182,3,19,292,253,39,3,1995-09-10,0,1,"mia",17
"3","Mon","September 18","W","","3-0",TRUE,"Pittsburgh Steelers",23,10,16,256,210,46,0,21,366,273,93,5,1995-09-18,5,1,"mia",13
"5","Sun","October 1","W","","4-0",FALSE,"Cincinnati Bengals",26,23,27,490,442,48,1,23,342,198,144,0,1995-10-01,-1,1,"mia",3
"6","Sun","October 8","L","OT","4-1",TRUE,"Indianapolis Colts",24,27,26,343,195,148,0,22,419,310,109,1,1995-10-08,1,0,"mia",-3
"7","Sun","October 15","L","","4-2",FALSE,"New Orleans Saints",30,33,23,381,353,28,5,18,335,255,80,2,1995-10-15,-3,0,"mia",-3
"8","Sun","October 22","L","","4-3",FALSE,"New York Jets",16,17,21,320,174,146,4,12,200,143,57,2,1995-10-22,-2,0,"mia",-1
"9","Sun","October 29","W","","5-3",TRUE,"Buffalo Bills",23,6,21,362,214,148,0,11,186,139,47,0,1995-10-29,0,1,"mia",17
"10","Sun","November 5","W","","6-3",FALSE,"San Diego Chargers",24,14,24,417,291,126,1,17,299,229,70,2,1995-11-05,1,1,"mia",10
"11","Sun","November 12","L","","6-4",TRUE,"New England Patriots",17,34,27,448,373,75,3,22,352,205,147,0,1995-11-12,-3,0,"mia",-17
"12","Mon","November 20","L","","6-5",TRUE,"San Francisco 49ers",20,44,20,308,256,52,2,27,497,376,121,0,1995-11-20,-2,0,"mia",-24
"13","Sun","November 26","L","","6-6",FALSE,"Indianapolis Colts",28,36,24,338,231,107,2,21,352,159,193,0,1995-11-26,-2,0,"mia",-8
"14","Sun","December 3","W","","7-6",TRUE,"Atlanta Falcons",21,20,29,428,343,85,2,18,296,204,92,0,1995-12-03,-2,1,"mia",1
"15","Mon","December 11","W","","8-6",TRUE,"Kansas City Chiefs",13,6,15,248,146,102,2,17,333,180,153,3,1995-12-11,1,1,"mia",7
"16","Sun","December 17","L","","8-7",FALSE,"Buffalo Bills",20,23,12,269,227,42,1,24,342,134,208,2,1995-12-17,1,0,"mia",-3
"17","Sun","December 24","W","","9-7",FALSE,"St. Louis Rams",41,22,17,340,280,60,2,21,374,316,58,4,1995-12-24,2,1,"mia",19
"WildCard","Sat","December 30","L","","9-8",FALSE,"Buffalo Bills",22,37,26,502,432,70,4,27,536,195,341,2,1995-12-30,-2,0,"mia",-15
"1","Sun","September 1","W","","1-0",TRUE,"New England Patriots",24,10,19,322,176,146,1,16,229,200,29,4,1996-09-01,3,1,"mia",14
"2","Sun","September 8","W","","2-0",FALSE,"Arizona Cardinals",38,10,26,331,203,128,1,13,203,176,27,4,1996-09-08,3,1,"mia",28
"3","Sun","September 15","W","","3-0",TRUE,"New York Jets",36,27,20,445,251,194,2,20,378,304,74,3,1996-09-15,1,1,"mia",9
"4","Mon","September 23","L","","3-1",FALSE,"Indianapolis Colts",6,10,12,190,162,28,0,20,277,106,171,1,1996-09-23,1,0,"mia",-4
"6","Sun","October 6","L","","3-2",TRUE,"Seattle Seahawks",15,22,17,299,214,85,3,12,358,299,59,3,1996-10-06,0,0,"mia",-7
"7","Sun","October 13","W","","4-2",FALSE,"Buffalo Bills",21,7,15,239,176,63,0,17,296,191,105,4,1996-10-13,4,1,"mia",14
"8","Sun","October 20","L","","4-3",FALSE,"Philadelphia Eagles",28,35,18,347,254,93,1,21,419,223,196,1,1996-10-20,0,0,"mia",-7
"9","Sun","October 27","L","","4-4",TRUE,"Dallas Cowboys",10,29,10,221,173,48,3,27,482,359,123,0,1996-10-27,-3,0,"mia",-19
"10","Sun","November 3","L","","4-5",FALSE,"New England Patriots",23,42,22,430,315,115,3,28,468,409,59,4,1996-11-03,1,0,"mia",-19
"11","Sun","November 10","W","","5-5",TRUE,"Indianapolis Colts",37,13,19,307,193,114,0,15,293,260,33,2,1996-11-10,2,1,"mia",24
"12","Sun","November 17","W","","6-5",FALSE,"Houston Oilers",23,20,17,303,209,94,2,17,261,164,97,1,1996-11-17,-1,1,"mia",3
"13","Mon","November 25","L","","6-6",TRUE,"Pittsburgh Steelers",17,24,15,312,237,75,1,23,381,239,142,3,1996-11-25,2,0,"mia",-7
"14","Sun","December 1","L","","6-7",FALSE,"Oakland Raiders",7,17,21,315,281,34,4,20,314,158,156,1,1996-12-01,-3,0,"mia",-10
"15","Sun","December 8","L","","6-8",TRUE,"New York Giants",7,17,15,294,191,103,2,21,280,149,131,1,1996-12-08,-1,0,"mia",-10
"16","Mon","December 16","W","","7-8",TRUE,"Buffalo Bills",16,14,22,394,249,145,0,15,274,223,51,2,1996-12-16,2,1,"mia",2
"17","Sun","December 22","W","","8-8",FALSE,"New York Jets",31,28,26,416,259,157,1,21,278,195,83,2,1996-12-22,1,1,"mia",3
"1","Sun","August 31","W","","1-0",TRUE,"Indianapolis Colts",16,10,11,202,105,97,1,18,298,168,130,3,1997-08-31,2,1,"mia",6
"2","Sun","September 7","W","OT","2-0",TRUE,"Tennessee Oilers",16,13,21,354,300,54,1,13,294,109,185,1,1997-09-07,0,1,"mia",3
"3","Sun","September 14","L","","2-1",FALSE,"Green Bay Packers",18,23,20,299,240,59,1,22,392,250,142,2,1997-09-14,1,0,"mia",-5
"4","Sun","September 21","L","","2-2",FALSE,"Tampa Bay Buccaneers",21,31,21,283,235,48,0,24,357,248,109,1,1997-09-21,1,0,"mia",-10
"6","Sun","October 5","W","","3-2",TRUE,"Kansas City Chiefs",17,14,19,337,254,83,0,14,259,163,96,0,1997-10-05,0,1,"mia",3
"7","Sun","October 12","W","","4-2",FALSE,"New York Jets",31,20,25,465,372,93,0,20,369,288,81,1,1997-10-12,1,1,"mia",11
"8","Sun","October 19","W","","5-2",FALSE,"Baltimore Ravens",24,13,24,337,189,148,1,20,385,331,54,2,1997-10-19,1,1,"mia",11
"9","Mon","October 27","L","OT","5-3",TRUE,"Chicago Bears",33,36,18,365,246,119,3,26,464,336,128,2,1997-10-27,-1,0,"mia",-3
"10","Sun","November 2","L","","5-4",FALSE,"Buffalo Bills",6,9,13,230,176,54,2,17,265,86,179,1,1997-11-02,-1,0,"mia",-3
"11","Sun","November 9","W","","6-4",TRUE,"New York Jets",24,17,21,296,176,120,0,20,382,303,79,2,1997-11-09,2,1,"mia",7
"12","Mon","November 17","W","","7-4",TRUE,"Buffalo Bills",30,13,16,314,218,96,2,15,223,131,92,2,1997-11-17,0,1,"mia",17
"13","Sun","November 23","L","","7-5",FALSE,"New England Patriots",24,27,33,406,370,36,3,15,318,234,84,0,1997-11-23,-3,0,"mia",-3
"14","Sun","November 30","W","","8-5",FALSE,"Oakland Raiders",34,16,23,378,241,137,2,18,326,212,114,2,1997-11-30,0,1,"mia",18
"15","Sun","December 7","W","","9-5",TRUE,"Detroit Lions",33,30,19,391,310,81,1,24,424,279,145,5,1997-12-07,4,1,"mia",3
"16","Sun","December 14","L","","9-6",FALSE,"Indianapolis Colts",0,41,10,183,107,76,2,23,401,253,148,1,1997-12-14,-1,0,"mia",-41
"17","Mon","December 22","L","","9-7",TRUE,"New England Patriots",12,14,17,295,253,42,1,10,207,160,47,2,1997-12-22,1,0,"mia",-2
"WildCard","Sun","December 28","L","","9-8",FALSE,"New England Patriots",3,17,10,162,120,42,3,15,228,120,108,0,1997-12-28,-3,0,"mia",-14
"1","Sun","September 6","W","","1-0",FALSE,"Indianapolis Colts",24,15,15,272,135,137,1,24,337,273,64,4,1998-09-06,3,1,"mia",9
"2","Sun","September 13","W","","2-0",TRUE,"Buffalo Bills",13,7,12,259,143,116,0,12,187,77,110,1,1998-09-13,1,1,"mia",6
"3","Sun","September 20","W","","3-0",TRUE,"Pittsburgh Steelers",21,0,11,219,109,110,1,13,200,78,122,3,1998-09-20,2,1,"mia",21
"5","Sun","October 4","L","","3-1",FALSE,"New York Jets",9,20,11,153,119,34,3,22,289,172,117,1,1998-10-04,-2,0,"mia",-11
"6","Mon","October 12","L","","3-2",FALSE,"Jacksonville Jaguars",21,28,25,374,307,67,2,12,385,199,186,1,1998-10-12,-1,0,"mia",-7
"7","Sun","October 18","W","","4-2",TRUE,"St. Louis Rams",14,0,16,245,104,141,1,15,204,128,76,2,1998-10-18,1,1,"mia",14
"8","Sun","October 25","W","OT","5-2",TRUE,"New England Patriots",12,9,18,333,263,70,3,13,251,225,26,1,1998-10-25,-2,1,"mia",3
"9","Sun","November 1","L","","5-3",FALSE,"Buffalo Bills",24,30,15,296,168,128,1,16,313,197,116,2,1998-11-01,1,0,"mia",-6
"10","Sun","November 8","W","","6-3",TRUE,"Indianapolis Colts",27,14,20,359,207,152,2,21,254,140,114,2,1998-11-08,0,1,"mia",13
"11","Sun","November 15","W","","7-3",FALSE,"Carolina Panthers",13,9,15,315,131,184,1,12,210,148,62,2,1998-11-15,1,1,"mia",4
"12","Mon","November 23","L","","7-4",FALSE,"New England Patriots",23,26,17,322,289,33,1,21,455,414,41,2,1998-11-23,1,0,"mia",-3
"13","Sun","November 29","W","","8-4",TRUE,"New Orleans Saints",30,10,24,375,255,120,1,11,157,70,87,4,1998-11-29,3,1,"mia",20
"14","Sun","December 6","W","","9-4",FALSE,"Oakland Raiders",27,17,9,260,170,90,1,20,314,207,107,7,1998-12-06,6,1,"mia",10
"15","Sun","December 13","L","","9-5",TRUE,"New York Jets",16,21,22,357,278,79,2,16,314,232,82,2,1998-12-13,0,0,"mia",-5
"16","Mon","December 21","W","","10-5",TRUE,"Denver Broncos",31,21,19,391,355,36,2,14,219,161,58,2,1998-12-21,0,1,"mia",10
"17","Sun","December 27","L","","10-6",FALSE,"Atlanta Falcons",16,38,20,400,362,38,6,15,346,203,143,0,1998-12-27,-6,0,"mia",-22
"WildCard","Sat","January 2","W","","11-6",TRUE,"Buffalo Bills",24,17,25,345,228,117,1,23,416,339,77,5,1999-01-02,4,1,"mia",7
"Division","Sat","January 9","L","","11-7",FALSE,"Denver Broncos",3,38,14,252,238,14,3,24,424,174,250,0,1999-01-09,-3,0,"mia",-35
"1","Mon","September 13","W","","1-0",FALSE,"Denver Broncos",38,21,22,326,215,111,0,25,353,240,113,1,1999-09-13,1,1,"mia",17
"2","Sun","September 19","W","","2-0",TRUE,"Arizona Cardinals",19,16,14,304,221,83,4,13,184,120,64,4,1999-09-19,0,1,"mia",3
"4","Mon","October 4","L","","2-1",TRUE,"Buffalo Bills",18,23,18,292,233,59,3,11,250,177,73,1,1999-10-04,-2,0,"mia",-5
"5","Sun","October 10","W","","3-1",FALSE,"Indianapolis Colts",34,31,19,469,393,76,0,18,332,264,68,2,1999-10-10,2,1,"mia",3
"6","Sun","October 17","W","","4-1",FALSE,"New England Patriots",31,30,22,317,195,122,2,14,259,213,46,2,1999-10-17,0,1,"mia",1
"7","Sun","October 24","W","","5-1",TRUE,"Philadelphia Eagles",16,13,15,283,134,149,2,11,182,89,93,2,1999-10-24,0,1,"mia",3
"8","Sun","October 31","W","","6-1",FALSE,"Oakland Raiders",16,9,19,325,184,141,0,13,187,107,80,2,1999-10-31,2,1,"mia",7
"9","Sun","November 7","W","","7-1",TRUE,"Tennessee Titans",17,0,14,237,185,52,1,14,293,190,103,3,1999-11-07,2,1,"mia",17
"10","Sun","November 14","L","","7-2",FALSE,"Buffalo Bills",3,23,6,101,41,60,1,18,334,157,177,0,1999-11-14,-1,0,"mia",-20
"11","Sun","November 21","W","","8-2",TRUE,"New England Patriots",27,17,19,227,110,117,2,14,270,168,102,5,1999-11-21,3,1,"mia",10
"12","Thu","November 25","L","","8-3",FALSE,"Dallas Cowboys",0,20,16,275,206,69,5,15,324,223,101,1,1999-11-25,-4,0,"mia",-20
"13","Sun","December 5","L","","8-4",TRUE,"Indianapolis Colts",34,37,22,368,299,69,3,21,370,241,129,2,1999-12-05,-1,0,"mia",-3
"14","Sun","December 12","L","","8-5",FALSE,"New York Jets",20,28,20,319,246,73,2,18,320,225,95,1,1999-12-12,-1,0,"mia",-8
"15","Sun","December 19","W","","9-5",TRUE,"San Diego Chargers",12,9,11,284,231,53,2,13,186,160,26,1,1999-12-19,-1,1,"mia",3
"16","Mon","December 27","L","","9-6",TRUE,"New York Jets",31,38,25,422,322,100,3,16,290,189,101,1,1999-12-27,-2,0,"mia",-7
"17","Sun","January 2","L","","9-7",FALSE,"Washington Redskins",10,21,25,389,270,119,4,18,270,165,105,0,2000-01-02,-4,0,"mia",-11
"WildCard","Sun","January 9","W","","10-7",FALSE,"Seattle Seahawks",20,17,18,299,191,108,0,12,171,130,41,2,2000-01-09,2,1,"mia",3
"Division","Sat","January 15","L","","10-8",FALSE,"Jacksonville Jaguars",7,62,10,131,110,21,7,21,520,263,257,2,2000-01-15,-5,0,"mia",-55
"1","Sun","September 3","W","","1-0",TRUE,"Seattle Seahawks",23,0,16,308,127,181,1,8,143,72,71,6,2000-09-03,5,1,"mia",23
"2","Sun","September 10","L","","1-1",FALSE,"Minnesota Vikings",7,13,10,209,160,49,1,24,468,343,125,4,2000-09-10,3,0,"mia",-6
"3","Sun","September 17","W","","2-1",TRUE,"Baltimore Ravens",19,6,15,258,152,106,1,18,262,144,118,1,2000-09-17,0,1,"mia",13
"4","Sun","September 24","W","","3-1",TRUE,"New England Patriots",10,3,12,242,143,99,3,12,210,154,56,2,2000-09-24,-1,1,"mia",7
"5","Sun","October 1","W","","4-1",FALSE,"Cincinnati Bengals",31,16,18,302,143,159,2,24,350,159,191,1,2000-10-01,-1,1,"mia",15
"6","Sun","October 8","W","","5-1",TRUE,"Buffalo Bills",22,13,15,254,134,120,1,15,254,178,76,2,2000-10-08,1,1,"mia",9
"8","Mon","October 23","L","OT","5-2",FALSE,"New York Jets",37,40,20,433,235,198,3,31,455,376,79,4,2000-10-23,1,0,"mia",-3
"9","Sun","October 29","W","","6-2",TRUE,"Green Bay Packers",28,20,17,296,156,140,1,21,319,186,133,2,2000-10-29,1,1,"mia",8
"10","Sun","November 5","W","","7-2",FALSE,"Detroit Lions",23,8,15,293,104,189,0,14,253,154,99,3,2000-11-05,3,1,"mia",15
"11","Sun","November 12","W","","8-2",FALSE,"San Diego Chargers",17,7,15,244,160,84,0,19,238,156,82,4,2000-11-12,4,1,"mia",10
"12","Sun","November 19","L","","8-3",TRUE,"New York Jets",3,20,10,200,117,83,4,18,239,106,133,2,2000-11-19,-2,0,"mia",-17
"13","Sun","November 26","W","","9-3",FALSE,"Indianapolis Colts",17,14,17,253,171,82,0,19,353,209,144,1,2000-11-26,1,1,"mia",3
"14","Sun","December 3","W","","10-3",FALSE,"Buffalo Bills",33,6,15,333,200,133,1,14,196,36,160,3,2000-12-03,2,1,"mia",27
"15","Sun","December 10","L","","10-4",TRUE,"Tampa Bay Buccaneers",13,16,17,254,170,84,5,14,221,121,100,1,2000-12-10,-4,0,"mia",-3
"16","Sun","December 17","L","","10-5",TRUE,"Indianapolis Colts",13,20,14,272,132,140,3,20,327,195,132,2,2000-12-17,-1,0,"mia",-7
"17","Sun","December 24","W","","11-5",FALSE,"New England Patriots",27,24,25,310,263,47,0,18,348,311,37,3,2000-12-24,3,1,"mia",3
"WildCard","Sat","December 30","W","OT","12-5",TRUE,"Indianapolis Colts",23,17,26,434,176,258,3,14,293,194,99,0,2000-12-30,-3,1,"mia",6
"Division","Sat","January 6","L","","12-6",FALSE,"Oakland Raiders",0,27,10,204,164,40,4,20,267,127,140,1,2001-01-06,-3,0,"mia",-27
"1","Sun","September 9","W","","1-0",FALSE,"Tennessee Titans",31,23,11,307,225,82,2,19,315,210,105,3,2001-09-09,1,1,"mia",8
"2","Sun","September 23","W","","2-0",TRUE,"Oakland Raiders",18,15,19,359,215,144,2,12,216,120,96,0,2001-09-23,-2,1,"mia",3
"3","Sun","September 30","L","","2-1",FALSE,"St. Louis Rams",10,42,15,253,189,64,4,27,441,318,123,0,2001-09-30,-4,0,"mia",-32
"4","Sun","October 7","W","","3-1",TRUE,"New England Patriots",30,10,19,296,87,209,1,12,149,69,80,3,2001-10-07,2,1,"mia",20
"5","Sun","October 14","L","","3-2",FALSE,"New York Jets",17,21,19,348,233,115,4,19,268,140,128,0,2001-10-14,-4,0,"mia",-4
"7","Sun","October 28","W","","4-2",FALSE,"Seattle Seahawks",24,20,15,289,213,76,4,18,302,206,96,2,2001-10-28,-2,1,"mia",4
"8","Sun","November 4","W","","5-2",TRUE,"Carolina Panthers",23,6,17,337,278,59,1,12,281,178,103,1,2001-11-04,0,1,"mia",17
"9","Sun","November 11","W","","6-2",FALSE,"Indianapolis Colts",27,24,14,375,241,134,3,19,289,224,65,3,2001-11-11,0,1,"mia",3
"10","Sun","November 18","L","","6-3",TRUE,"New York Jets",0,24,15,254,176,78,5,11,162,76,86,0,2001-11-18,-5,0,"mia",-24
"11","Sun","November 25","W","","7-3",FALSE,"Buffalo Bills",34,27,19,362,261,101,1,21,422,295,127,3,2001-11-25,2,1,"mia",7
"12","Sun","December 2","W","","8-3",TRUE,"Denver Broncos",21,10,12,218,176,42,1,19,273,126,147,2,2001-12-02,1,1,"mia",11
"13","Mon","December 10","W","","9-3",TRUE,"Indianapolis Colts",41,6,24,366,183,183,0,16,254,170,84,4,2001-12-10,4,1,"mia",35
"14","Sun","December 16","L","","9-4",FALSE,"San Francisco 49ers",0,21,12,174,107,67,4,21,285,133,152,0,2001-12-16,-4,0,"mia",-21
"15","Sat","December 22","L","","9-5",FALSE,"New England Patriots",13,20,19,368,310,58,3,20,313,117,196,0,2001-12-22,-3,0,"mia",-7
"16","Sun","December 30","W","","10-5",TRUE,"Atlanta Falcons",21,14,12,226,176,50,3,21,388,236,152,4,2001-12-30,1,1,"mia",7
"17","Sun","January 6","W","","11-5",TRUE,"Buffalo Bills",34,7,21,289,87,202,0,16,250,211,39,3,2002-01-06,3,1,"mia",27
"WildCard","Sun","January 13","L","","11-6",TRUE,"Baltimore Ravens",3,20,9,151,105,46,3,20,347,121,226,1,2002-01-13,-2,0,"mia",-17
"1","Sun","September 8","W","","1-0",TRUE,"Detroit Lions",49,21,27,389,207,182,0,15,257,206,51,2,2002-09-08,2,1,"mia",28
"2","Sun","September 15","W","","2-0",FALSE,"Indianapolis Colts",21,13,17,342,179,163,1,29,432,289,143,3,2002-09-15,2,1,"mia",8
"3","Sun","September 22","W","","3-0",TRUE,"New York Jets",30,3,21,394,183,211,0,13,189,131,58,4,2002-09-22,4,1,"mia",27
"4","Sun","September 29","L","","3-1",FALSE,"Kansas City Chiefs",30,48,28,399,294,105,5,25,450,328,122,0,2002-09-29,-5,0,"mia",-18
"5","Sun","October 6","W","","4-1",TRUE,"New England Patriots",26,13,21,319,182,137,1,16,245,208,37,3,2002-10-06,2,1,"mia",13
"6","Sun","October 13","W","","5-1",FALSE,"Denver Broncos",24,22,16,259,201,58,2,27,410,299,111,3,2002-10-13,1,1,"mia",2
"7","Sun","October 20","L","","5-2",TRUE,"Buffalo Bills",10,23,17,287,155,132,6,15,294,162,132,0,2002-10-20,-6,0,"mia",-13
"9","Mon","November 4","L","","5-3",FALSE,"Green Bay Packers",10,24,25,306,163,143,4,16,270,166,104,1,2002-11-04,-3,0,"mia",-14
"10","Sun","November 10","L","","5-4",FALSE,"New York Jets",10,13,15,279,210,69,2,19,264,167,97,0,2002-11-10,-2,0,"mia",-3
"11","Sun","November 17","W","","6-4",TRUE,"Baltimore Ravens",26,7,17,337,221,116,0,10,157,91,66,1,2002-11-17,1,1,"mia",19
"12","Sun","November 24","W","","7-4",TRUE,"San Diego Chargers",30,3,24,413,191,222,0,12,144,80,64,2,2002-11-24,2,1,"mia",27
"13","Sun","December 1","L","","7-5",FALSE,"Buffalo Bills",21,38,14,300,30,270,3,21,431,270,161,0,2002-12-01,-3,0,"mia",-17
"14","Mon","December 9","W","","8-5",TRUE,"Chicago Bears",27,9,22,436,188,248,3,12,195,88,107,4,2002-12-09,1,1,"mia",18
"15","Sun","December 15","W","","9-5",TRUE,"Oakland Raiders",23,17,21,334,213,121,1,14,218,162,56,2,2002-12-15,1,1,"mia",6
"16","Sat","December 21","L","","9-6",FALSE,"Minnesota Vikings",17,20,13,239,170,69,2,21,368,239,129,3,2002-12-21,1,0,"mia",-3
"17","Sun","December 29","L","OT","9-7",FALSE,"New England Patriots",24,27,20,359,103,256,0,20,332,216,116,2,2002-12-29,2,0,"mia",-3
"1","Sun","September 7","L","","0-1",TRUE,"Houston Texans",20,21,14,301,215,86,3,16,393,266,127,0,2003-09-07,-3,0,"mia",-1
"2","Sun","September 14","W","","1-1",FALSE,"New York Jets",21,10,23,376,189,187,1,17,387,366,21,1,2003-09-14,0,1,"mia",11
"3","Sun","September 21","W","","2-1",TRUE,"Buffalo Bills",17,7,23,313,147,166,3,8,118,77,41,3,2003-09-21,0,1,"mia",10
"5","Sun","October 5","W","","3-1",FALSE,"New York Giants",23,10,15,285,151,134,1,25,350,273,77,4,2003-10-05,3,1,"mia",13
"6","Sun","October 12","W","","4-1",FALSE,"Jacksonville Jaguars",24,10,16,234,143,91,2,22,332,244,88,5,2003-10-12,3,1,"mia",14
"7","Sun","October 19","L","OT","4-2",TRUE,"New England Patriots",13,19,20,326,229,97,3,16,332,273,59,2,2003-10-19,-1,0,"mia",-6
"8","Mon","October 27","W","","5-2",FALSE,"San Diego Chargers",26,10,14,264,183,81,1,18,250,146,104,3,2003-10-27,2,1,"mia",16
"9","Sun","November 2","L","","5-3",TRUE,"Indianapolis Colts",17,23,12,239,192,47,2,23,356,241,115,2,2003-11-02,0,0,"mia",-6
"10","Sun","November 9","L","","5-4",FALSE,"Tennessee Titans",7,31,12,224,165,59,5,17,324,223,101,0,2003-11-09,-5,0,"mia",-24
"11","Sun","November 16","W","OT","6-4",TRUE,"Baltimore Ravens",9,6,19,267,126,141,1,13,223,109,114,3,2003-11-16,2,1,"mia",3
"12","Sun","November 23","W","","7-4",TRUE,"Washington Redskins",24,23,16,317,173,144,3,21,277,148,129,2,2003-11-23,-1,1,"mia",1
"13","Thu","November 27","W","","8-4",FALSE,"Dallas Cowboys",40,21,22,365,239,126,1,21,354,263,91,5,2003-11-27,4,1,"mia",19
"14","Sun","December 7","L","","8-5",FALSE,"New England Patriots",0,12,7,134,66,68,3,13,228,150,78,1,2003-12-07,-2,0,"mia",-12
"15","Mon","December 15","L","","8-6",TRUE,"Philadelphia Eagles",27,34,22,398,221,177,2,23,401,261,140,1,2003-12-15,-1,0,"mia",-7
"16","Sun","December 21","W","","9-6",FALSE,"Buffalo Bills",20,3,11,169,37,132,2,11,177,104,73,4,2003-12-21,2,1,"mia",17
"17","Sun","December 28","W","","10-6",TRUE,"New York Jets",23,21,20,397,316,81,1,19,285,191,94,0,2003-12-28,-1,1,"mia",2
"1","Sat","September 11","L","","0-1",TRUE,"Tennessee Titans",7,17,14,263,198,65,3,15,243,61,182,1,2004-09-11,-2,0,"mia",-10
"2","Sun","September 19","L","","0-2",FALSE,"Cincinnati Bengals",13,16,11,226,201,25,3,12,210,116,94,1,2004-09-19,-2,0,"mia",-3
"3","Sun","September 26","L","","0-3",TRUE,"Pittsburgh Steelers",3,13,13,169,117,52,4,15,314,161,153,1,2004-09-26,-3,0,"mia",-10
"4","Sun","October 3","L","","0-4",TRUE,"New York Jets",9,17,13,293,196,97,4,16,235,125,110,1,2004-10-03,-3,0,"mia",-8
"5","Sun","October 10","L","","0-5",FALSE,"New England Patriots",10,24,18,295,228,67,2,14,204,69,135,1,2004-10-10,-1,0,"mia",-14
"6","Sun","October 17","L","","0-6",FALSE,"Buffalo Bills",13,20,14,212,101,111,1,18,341,204,137,0,2004-10-17,-1,0,"mia",-7
"7","Sun","October 24","W","","1-6",TRUE,"St. Louis Rams",31,14,19,323,206,117,0,20,372,269,103,1,2004-10-24,1,1,"mia",17
"8","Mon","November 1","L","","1-7",FALSE,"New York Jets",14,41,16,259,181,78,3,22,472,197,275,0,2004-11-01,-3,0,"mia",-27
"9","Sun","November 7","L","","1-8",TRUE,"Arizona Cardinals",23,24,22,403,235,168,2,17,270,149,121,1,2004-11-07,-1,0,"mia",-1
"11","Sun","November 21","L","","1-9",FALSE,"Seattle Seahawks",17,24,19,288,219,69,4,17,293,177,116,3,2004-11-21,-1,0,"mia",-7
"12","Sun","November 28","W","","2-9",FALSE,"San Francisco 49ers",24,17,15,200,151,49,2,16,224,147,77,3,2004-11-28,1,1,"mia",7
"13","Sun","December 5","L","","2-10",TRUE,"Buffalo Bills",32,42,25,403,297,106,7,16,362,257,105,1,2004-12-05,-6,0,"mia",-10
"14","Sun","December 12","L","","2-11",FALSE,"Denver Broncos",17,20,13,214,144,70,1,24,415,219,196,3,2004-12-12,2,0,"mia",-3
"15","Mon","December 20","W","","3-11",TRUE,"New England Patriots",29,28,18,231,179,52,1,24,322,156,166,4,2004-12-20,3,1,"mia",1
"16","Sun","December 26","W","","4-11",TRUE,"Cleveland Browns",10,7,19,280,164,116,2,14,285,143,142,4,2004-12-26,2,1,"mia",3
"17","Sun","January 2","L","","4-12",FALSE,"Baltimore Ravens",23,30,18,345,248,97,3,21,332,142,190,0,2005-01-02,-3,0,"mia",-7
"1","Sun","September 11","W","","1-0",TRUE,"Denver Broncos",34,10,21,426,275,151,3,19,312,242,70,3,2005-09-11,0,1,"mia",24
"2","Sun","September 18","L","","1-1",FALSE,"New York Jets",7,17,15,235,169,66,1,20,271,173,98,0,2005-09-18,-1,0,"mia",-10
"3","Sun","September 25","W","","2-1",TRUE,"Carolina Panthers",27,24,16,315,171,144,1,23,299,238,61,3,2005-09-25,2,1,"mia",3
"5","Sun","October 9","L","","2-2",FALSE,"Buffalo Bills",14,20,16,323,210,113,5,21,236,137,99,1,2005-10-09,-4,0,"mia",-6
"6","Sun","October 16","L","","2-3",FALSE,"Tampa Bay Buccaneers",13,27,13,307,243,64,2,15,342,162,180,1,2005-10-16,-1,0,"mia",-14
"7","Fri","October 21","L","","2-4",TRUE,"Kansas City Chiefs",20,30,9,286,192,94,1,24,462,277,185,0,2005-10-21,-1,0,"mia",-10
"8","Sun","October 30","W","","3-4",FALSE,"New Orleans Saints",21,6,20,342,154,188,2,14,203,113,90,2,2005-10-30,0,1,"mia",15
"9","Sun","November 6","L","","3-5",TRUE,"Atlanta Falcons",10,17,11,208,103,105,1,27,382,220,162,2,2005-11-06,1,0,"mia",-7
"10","Sun","November 13","L","","3-6",TRUE,"New England Patriots",16,23,22,437,360,77,2,19,365,274,91,2,2005-11-13,0,0,"mia",-7
"11","Sun","November 20","L","","3-7",FALSE,"Cleveland Browns",0,22,12,194,55,139,2,19,376,195,181,1,2005-11-20,-1,0,"mia",-22
"12","Sun","November 27","W","","4-7",FALSE,"Oakland Raiders",33,21,21,394,249,145,3,24,305,185,120,3,2005-11-27,0,1,"mia",12
"13","Sun","December 4","W","","5-7",TRUE,"Buffalo Bills",24,23,26,434,361,73,2,16,294,202,92,3,2005-12-04,1,1,"mia",1
"14","Sun","December 11","W","","6-7",FALSE,"San Diego Chargers",23,21,14,300,229,71,2,27,341,245,96,3,2005-12-11,1,1,"mia",2
"15","Sun","December 18","W","","7-7",TRUE,"New York Jets",24,20,14,297,169,128,1,24,397,298,99,3,2005-12-18,2,1,"mia",4
"16","Sat","December 24","W","","8-7",TRUE,"Tennessee Titans",24,10,19,322,130,192,2,11,234,142,92,3,2005-12-24,1,1,"mia",14
"17","Sun","January 1","W","","9-7",FALSE,"New England Patriots",28,26,25,378,230,148,0,16,259,204,55,1,2006-01-01,1,1,"mia",2
"1","Thu","September 7","L","","0-1",FALSE,"Pittsburgh Steelers",17,28,15,278,240,38,2,20,342,196,146,1,2006-09-07,-1,0,"mia",-11
"2","Sun","September 17","L","","0-2",TRUE,"Buffalo Bills",6,16,15,282,190,92,1,12,171,66,105,0,2006-09-17,-1,0,"mia",-10
"3","Sun","September 24","W","","1-2",TRUE,"Tennessee Titans",13,10,17,289,130,159,1,14,316,254,62,3,2006-09-24,2,1,"mia",3
"4","Sun","October 1","L","","1-3",FALSE,"Houston Texans",15,17,15,289,219,70,0,19,276,211,65,2,2006-10-01,2,0,"mia",-2
"5","Sun","October 8","L","","1-4",FALSE,"New England Patriots",10,20,19,283,221,62,3,17,213,134,79,1,2006-10-08,-2,0,"mia",-10
"6","Sun","October 15","L","","1-5",FALSE,"New York Jets",17,20,24,395,266,129,3,15,272,169,103,0,2006-10-15,-3,0,"mia",-3
"7","Sun","October 22","L","","1-6",TRUE,"Green Bay Packers",24,34,26,448,381,67,3,19,346,191,155,1,2006-10-22,-2,0,"mia",-10
"9","Sun","November 5","W","","2-6",FALSE,"Chicago Bears",31,13,17,298,137,161,2,20,292,189,103,6,2006-11-05,4,1,"mia",18
"10","Sun","November 12","W","","3-6",TRUE,"Kansas City Chiefs",13,10,16,306,189,117,1,14,265,185,80,0,2006-11-12,-1,1,"mia",3
"11","Sun","November 19","W","","4-6",TRUE,"Minnesota Vikings",24,20,15,254,247,7,2,25,361,247,114,3,2006-11-19,1,1,"mia",4
"12","Thu","November 23","W","","5-6",FALSE,"Detroit Lions",27,10,18,395,209,186,2,13,220,199,21,2,2006-11-23,0,1,"mia",17
"13","Sun","December 3","L","","5-7",TRUE,"Jacksonville Jaguars",10,24,20,309,241,68,2,18,353,203,150,1,2006-12-03,-1,0,"mia",-14
"14","Sun","December 10","W","","6-7",TRUE,"New England Patriots",21,0,19,315,184,131,0,12,189,66,123,3,2006-12-10,3,1,"mia",21
"15","Sun","December 17","L","","6-8",FALSE,"Buffalo Bills",0,21,12,212,100,112,2,13,286,186,100,2,2006-12-17,0,0,"mia",-21
"16","Mon","December 25","L","","6-9",TRUE,"New York Jets",10,13,14,253,129,124,0,12,324,229,95,1,2006-12-25,1,0,"mia",-3
"17","Sun","December 31","L","","6-10",FALSE,"Indianapolis Colts",22,27,19,354,204,150,1,24,399,282,117,1,2006-12-31,0,0,"mia",-5
"1","Sun","September 9","L","OT","0-1",FALSE,"Washington Redskins",13,16,17,273,207,66,1,19,400,209,191,2,2007-09-09,1,0,"mia",-3
"2","Sun","September 16","L","","0-2",TRUE,"Dallas Cowboys",20,37,21,334,273,61,5,19,352,186,166,0,2007-09-16,-5,0,"mia",-17
"3","Sun","September 23","L","","0-3",FALSE,"New York Jets",28,31,28,424,312,112,1,22,256,115,141,0,2007-09-23,-1,0,"mia",-3
"4","Sun","September 30","L","","0-4",TRUE,"Oakland Raiders",17,35,13,278,137,141,2,21,369,70,299,1,2007-09-30,-1,0,"mia",-18
"5","Sun","October 7","L","","0-5",FALSE,"Houston Texans",19,22,17,285,148,137,1,20,352,278,74,2,2007-10-07,1,0,"mia",-3
"6","Sun","October 14","L","","0-6",FALSE,"Cleveland Browns",31,41,24,356,246,110,2,24,384,244,140,1,2007-10-14,-1,0,"mia",-10
"7","Sun","October 21","L","","0-7",TRUE,"New England Patriots",28,49,25,382,203,179,2,23,443,359,84,1,2007-10-21,-1,0,"mia",-21
"8","Sun","October 28","L","","0-8",TRUE,"New York Giants",10,13,18,245,119,126,2,19,238,49,189,1,2007-10-28,-1,0,"mia",-3
"10","Sun","November 11","L","","0-9",TRUE,"Buffalo Bills",10,13,15,269,126,143,0,15,214,151,63,1,2007-11-11,1,0,"mia",-3
"11","Sun","November 18","L","","0-10",FALSE,"Philadelphia Eagles",7,17,9,186,109,77,0,20,352,150,202,3,2007-11-18,3,0,"mia",-10
"12","Mon","November 26","L","","0-11",FALSE,"Pittsburgh Steelers",0,3,9,159,110,49,2,13,216,132,84,1,2007-11-26,-1,0,"mia",-3
"13","Sun","December 2","L","","0-12",TRUE,"New York Jets",13,40,12,187,150,37,5,20,372,209,163,2,2007-12-02,-3,0,"mia",-27
"14","Sun","December 9","L","","0-13",FALSE,"Buffalo Bills",17,38,18,285,220,65,5,20,389,165,224,1,2007-12-09,-4,0,"mia",-21
"15","Sun","December 16","W","OT","1-13",TRUE,"Baltimore Ravens",22,16,21,360,288,72,0,21,345,182,163,1,2007-12-16,1,1,"mia",6
"16","Sun","December 23","L","","1-14",FALSE,"New England Patriots",7,28,15,241,133,108,0,19,400,204,196,4,2007-12-23,4,0,"mia",-21
"17","Sun","December 30","L","","1-15",TRUE,"Cincinnati Bengals",25,38,21,336,250,86,1,23,393,316,77,1,2007-12-30,0,0,"mia",-13
"1","Sun","September 7","L","","0-1",TRUE,"New York Jets",14,20,18,277,228,49,1,15,293,181,112,1,2008-09-07,0,0,"mia",-6
"2","Sun","September 14","L","","0-2",FALSE,"Arizona Cardinals",10,31,17,236,164,72,0,22,445,364,81,0,2008-09-14,0,0,"mia",-21
"3","Sun","September 21","W","","1-2",FALSE,"New England Patriots",38,13,23,461,245,216,0,14,215,137,78,2,2008-09-21,2,1,"mia",25
"5","Sun","October 5","W","","2-2",TRUE,"San Diego Chargers",17,10,23,390,223,167,1,10,202,142,60,0,2008-10-05,-1,1,"mia",7
"6","Sun","October 12","L","","2-3",FALSE,"Houston Texans",28,29,14,370,274,96,1,23,485,371,114,4,2008-10-12,3,0,"mia",-1
"7","Sun","October 19","L","","2-4",TRUE,"Baltimore Ravens",13,27,21,359,288,71,1,22,357,218,139,1,2008-10-19,0,0,"mia",-14
"8","Sun","October 26","W","","3-4",TRUE,"Buffalo Bills",25,16,19,358,306,52,1,19,339,220,119,4,2008-10-26,3,1,"mia",9
"9","Sun","November 2","W","","4-4",FALSE,"Denver Broncos",26,17,21,341,266,75,1,14,319,305,14,3,2008-11-02,2,1,"mia",9
"10","Sun","November 9","W","","5-4",TRUE,"Seattle Seahawks",21,19,20,361,206,155,1,21,298,172,126,0,2008-11-09,-1,1,"mia",2
"11","Sun","November 16","W","","6-4",TRUE,"Oakland Raiders",17,15,20,382,160,222,1,11,199,129,70,0,2008-11-16,-1,1,"mia",2
"12","Sun","November 23","L","","6-5",TRUE,"New England Patriots",28,48,23,392,326,66,1,30,530,408,122,2,2008-11-23,1,0,"mia",-20
"13","Sun","November 30","W","","7-5",FALSE,"St. Louis Rams",16,12,16,337,188,149,1,19,278,149,129,3,2008-11-30,2,1,"mia",4
"14","Sun","December 7","W","","8-5",FALSE,"Buffalo Bills",16,3,18,295,180,115,0,13,163,79,84,2,2008-12-07,2,1,"mia",13
"15","Sun","December 14","W","","9-5",TRUE,"San Francisco 49ers",14,9,11,248,150,98,0,24,318,206,112,0,2008-12-14,0,1,"mia",5
"16","Sun","December 21","W","","10-5",FALSE,"Kansas City Chiefs",38,31,26,403,235,168,2,23,492,312,180,4,2008-12-21,2,1,"mia",7
"17","Sun","December 28","W","","11-5",FALSE,"New York Jets",24,17,18,319,193,126,1,16,331,251,80,4,2008-12-28,3,1,"mia",7
"WildCard","Sun","January 4","L","","11-6",TRUE,"Baltimore Ravens",9,27,18,276,224,52,5,16,286,135,151,1,2009-01-04,-4,0,"mia",-18
"1","Sun","September 13","L","","0-1",FALSE,"Atlanta Falcons",7,19,16,259,163,96,4,19,281,213,68,0,2009-09-13,-4,0,"mia",-12
"2","Mon","September 21","L","","0-2",TRUE,"Indianapolis Colts",23,27,27,403,164,239,1,14,356,295,61,0,2009-09-21,-1,0,"mia",-4
"3","Sun","September 27","L","","0-3",FALSE,"San Diego Chargers",13,23,19,289,140,149,2,19,355,286,69,1,2009-09-27,-1,0,"mia",-10
"4","Sun","October 4","W","","1-3",TRUE,"Buffalo Bills",38,10,25,336,86,250,0,10,206,160,46,3,2009-10-04,3,1,"mia",28
"5","Mon","October 12","W","","2-3",TRUE,"New York Jets",31,27,23,413,262,151,0,20,309,171,138,0,2009-10-12,0,1,"mia",4
"7","Sun","October 25","L","","2-4",TRUE,"New Orleans Saints",34,46,17,334,197,137,3,22,414,276,138,4,2009-10-25,1,0,"mia",-12
"8","Sun","November 1","W","","3-4",FALSE,"New York Jets",30,25,10,104,52,52,1,23,378,251,127,1,2009-11-01,0,1,"mia",5
"9","Sun","November 8","L","","3-5",FALSE,"New England Patriots",17,27,21,334,201,133,0,22,432,323,109,1,2009-11-08,1,0,"mia",-10
"10","Sun","November 15","W","","4-5",TRUE,"Tampa Bay Buccaneers",25,23,23,374,175,199,2,16,301,180,121,2,2009-11-15,0,1,"mia",2
"11","Thu","November 19","W","","5-5",FALSE,"Carolina Panthers",24,17,17,326,172,154,0,22,383,201,182,1,2009-11-19,1,1,"mia",7
"12","Sun","November 29","L","","5-6",FALSE,"Buffalo Bills",14,31,23,325,168,157,4,20,336,207,129,1,2009-11-29,-3,0,"mia",-17
"13","Sun","December 6","W","","6-6",TRUE,"New England Patriots",22,21,24,416,328,88,1,18,448,352,96,2,2009-12-06,1,1,"mia",1
"14","Sun","December 13","W","","7-6",FALSE,"Jacksonville Jaguars",14,10,22,354,208,146,3,10,217,122,95,0,2009-12-13,-3,1,"mia",4
"15","Sun","December 20","L","OT","7-7",FALSE,"Tennessee Titans",24,27,23,468,347,121,4,19,364,236,128,2,2009-12-20,-2,0,"mia",-3
"16","Sun","December 27","L","","7-8",TRUE,"Houston Texans",20,27,23,363,303,60,1,21,406,280,126,1,2009-12-27,0,0,"mia",-7
"17","Sun","January 3","L","","7-9",TRUE,"Pittsburgh Steelers",24,30,20,303,204,99,3,22,403,201,202,2,2010-01-03,-1,0,"mia",-6
"1","Sun","September 12","W","","1-0",FALSE,"Buffalo Bills",15,10,19,296,164,132,0,9,166,116,50,0,2010-09-12,0,1,"mia",5
"2","Sun","September 19","W","","2-0",FALSE,"Minnesota Vikings",14,10,12,226,106,120,2,22,364,208,156,4,2010-09-19,2,1,"mia",4
"3","Sun","September 26","L","","2-1",TRUE,"New York Jets",23,31,24,436,352,84,1,20,402,256,146,0,2010-09-26,-1,0,"mia",-8
"4","Mon","October 4","L","","2-2",TRUE,"New England Patriots",14,41,23,400,308,92,4,19,265,146,119,0,2010-10-04,-4,0,"mia",-27
"6","Sun","October 17","W","OT","3-2",FALSE,"Green Bay Packers",23,20,26,381,231,150,1,16,359,283,76,1,2010-10-17,0,1,"mia",3
"7","Sun","October 24","L","","3-3",TRUE,"Pittsburgh Steelers",22,23,15,313,249,64,2,15,348,290,58,2,2010-10-24,0,0,"mia",-1
"8","Sun","October 31","W","","4-3",FALSE,"Cincinnati Bengals",22,14,20,354,217,137,2,16,262,156,106,1,2010-10-31,-1,1,"mia",8
"9","Sun","November 7","L","","4-4",FALSE,"Baltimore Ravens",10,26,17,289,216,73,3,23,402,256,146,0,2010-11-07,-3,0,"mia",-16
"10","Sun","November 14","W","","5-4",TRUE,"Tennessee Titans",29,17,21,404,316,88,1,15,259,124,135,3,2010-11-14,2,1,"mia",12
"11","Thu","November 18","L","","5-5",TRUE,"Chicago Bears",0,16,10,187,148,39,1,19,268,133,135,1,2010-11-18,0,0,"mia",-16
"12","Sun","November 28","W","","6-5",FALSE,"Oakland Raiders",33,17,24,471,285,186,1,11,263,247,16,3,2010-11-28,2,1,"mia",16
"13","Sun","December 5","L","","6-6",TRUE,"Cleveland Browns",10,13,17,281,167,114,3,12,252,200,52,0,2010-12-05,-3,0,"mia",-3
"14","Sun","December 12","W","","7-6",FALSE,"New York Jets",10,6,6,131,30,101,3,14,280,193,87,2,2010-12-12,-1,1,"mia",4
"15","Sun","December 19","L","","7-7",TRUE,"Buffalo Bills",14,17,22,326,261,65,2,15,282,211,71,1,2010-12-19,-1,0,"mia",-3
"16","Sun","December 26","L","","7-8",TRUE,"Detroit Lions",27,34,28,425,271,154,3,14,275,208,67,0,2010-12-26,-3,0,"mia",-7
"17","Sun","January 2","L","","7-9",FALSE,"New England Patriots",7,38,16,250,206,44,2,24,502,321,181,1,2011-01-02,-1,0,"mia",-31
"1","Mon","September 12","L","","0-1",TRUE,"New England Patriots",24,38,25,488,390,98,1,27,622,516,106,1,2011-09-12,0,0,"mia",-14
"2","Sun","September 18","L","","0-2",TRUE,"Houston Texans",13,23,18,306,153,153,2,19,345,207,138,0,2011-09-18,-2,0,"mia",-10
"3","Sun","September 25","L","","0-3",FALSE,"Cleveland Browns",16,17,22,369,231,138,2,19,280,210,70,1,2011-09-25,-1,0,"mia",-1
"4","Sun","October 2","L","","0-4",FALSE,"San Diego Chargers",16,26,16,248,176,72,2,21,411,295,116,0,2011-10-02,-2,0,"mia",-10
"6","Mon","October 17","L","","0-5",FALSE,"New York Jets",6,24,17,308,190,118,3,13,296,192,104,1,2011-10-17,-2,0,"mia",-18
"7","Sun","October 23","L","OT","0-6",TRUE,"Denver Broncos",15,18,15,267,173,94,1,18,308,131,177,1,2011-10-23,0,0,"mia",-3
"8","Sun","October 30","L","","0-7",FALSE,"New York Giants",17,20,18,246,101,145,1,21,402,344,58,0,2011-10-30,-1,0,"mia",-3
"9","Sun","November 6","W","","1-7",FALSE,"Kansas City Chiefs",31,3,17,351,244,107,0,20,343,227,116,0,2011-11-06,0,1,"mia",28
"10","Sun","November 13","W","","2-7",TRUE,"Washington Redskins",20,9,20,303,200,103,2,16,246,185,61,2,2011-11-13,0,1,"mia",11
"11","Sun","November 20","W","","3-7",TRUE,"Buffalo Bills",35,8,16,242,147,95,0,14,245,204,41,2,2011-11-20,2,1,"mia",27
"12","Thu","November 24","L","","3-8",FALSE,"Dallas Cowboys",19,20,18,352,263,89,1,19,303,218,85,2,2011-11-24,1,0,"mia",-1
"13","Sun","December 4","W","","4-8",TRUE,"Oakland Raiders",34,14,23,362,153,209,0,18,304,258,46,1,2011-12-04,1,1,"mia",20
"14","Sun","December 11","L","","4-9",TRUE,"Philadelphia Eagles",10,26,11,204,95,109,3,18,239,188,51,2,2011-12-11,-1,0,"mia",-16
"15","Sun","December 18","W","","5-9",FALSE,"Buffalo Bills",30,23,17,448,194,254,3,21,404,291,113,3,2011-12-18,0,1,"mia",7
"16","Sat","December 24","L","","5-10",FALSE,"New England Patriots",24,27,20,374,253,121,2,26,400,281,119,0,2011-12-24,-2,0,"mia",-3
"17","Sun","January 1","W","","6-10",TRUE,"New York Jets",19,17,14,210,128,82,2,20,374,245,129,3,2012-01-01,1,1,"mia",2
"1","Sun","September 8","W","","1-0",TRUE,"Green Bay Packers",26,20,26,410,202,208,5,16,205,146,59,2,1985-09-08,-3,1,"nwe",6
"2","Sun","September 15","L","","1-1",FALSE,"Chicago Bears",7,20,10,206,179,27,4,18,369,209,160,2,1985-09-15,-2,0,"nwe",-13
"3","Sun","September 22","W","","2-1",FALSE,"Buffalo Bills",17,14,14,227,105,122,2,16,306,251,55,1,1985-09-22,-1,1,"nwe",3
"4","Sun","September 29","L","","2-2",TRUE,"Los Angeles Raiders",20,35,13,287,190,97,4,15,296,152,144,2,1985-09-29,-2,0,"nwe",-15
"5","Sun","October 6","L","","2-3",FALSE,"Cleveland Browns",20,24,18,400,291,109,3,28,447,301,146,5,1985-10-06,2,0,"nwe",-4
"6","Sun","October 13","W","","3-3",TRUE,"Buffalo Bills",14,3,18,400,318,82,4,13,162,90,72,4,1985-10-13,0,1,"nwe",11
"7","Sun","October 20","W","","4-3",TRUE,"New York Jets",20,13,20,284,155,129,1,13,303,220,83,3,1985-10-20,2,1,"nwe",7
"8","Sun","October 27","W","","5-3",FALSE,"Tampa Bay Buccaneers",32,14,18,420,223,197,2,14,209,130,79,2,1985-10-27,0,1,"nwe",18
"9","Sun","November 3","W","","6-3",TRUE,"Miami Dolphins",17,13,22,380,177,203,4,19,236,145,91,4,1985-11-03,0,1,"nwe",4
"10","Sun","November 10","W","","7-3",TRUE,"Indianapolis Colts",34,15,17,297,156,141,1,16,282,179,103,5,1985-11-10,4,1,"nwe",19
"11","Sun","November 17","W","","8-3",FALSE,"Seattle Seahawks",20,13,14,285,198,87,2,19,324,189,135,4,1985-11-17,2,1,"nwe",7
"12","Sun","November 24","L","OT","8-4",FALSE,"New York Jets",13,16,21,399,225,174,2,20,401,291,110,2,1985-11-24,0,0,"nwe",-3
"13","Sun","December 1","W","","9-4",FALSE,"Indianapolis Colts",38,31,24,412,276,136,1,23,300,170,130,2,1985-12-01,1,1,"nwe",7
"14","Sun","December 8","W","","10-4",TRUE,"Detroit Lions",23,6,23,352,136,216,1,15,246,141,105,3,1985-12-08,2,1,"nwe",17
"15","Mon","December 16","L","","10-5",FALSE,"Miami Dolphins",27,30,19,321,199,122,4,22,269,177,92,4,1985-12-16,0,0,"nwe",-3
"16","Sun","December 22","W","","11-5",TRUE,"Cincinnati Bengals",34,23,17,419,138,281,2,17,359,268,91,2,1985-12-22,0,1,"nwe",11
"WildCard","Sat","December 28","W","","12-5",FALSE,"New York Jets",26,14,12,258,159,99,0,15,240,182,58,4,1985-12-28,4,1,"nwe",12
"Division","Sun","January 5","W","","13-5",FALSE,"Los Angeles Raiders",27,20,15,254,98,156,2,17,287,124,163,6,1986-01-05,4,1,"nwe",7
"ConfChamp","Sun","January 12","W","","14-5",FALSE,"Miami Dolphins",31,14,21,326,71,255,2,18,302,234,68,6,1986-01-12,4,1,"nwe",17
"SuperBowl","Sun","January 26","L","","14-6",TRUE,"Chicago Bears",10,46,12,123,116,7,6,23,408,241,167,2,1986-01-26,-4,0,"nwe",-36
"1","Sun","September 7","W","","1-0",TRUE,"Indianapolis Colts",33,3,20,373,251,122,0,15,284,193,91,3,1986-09-07,3,1,"nwe",30
"2","Thu","September 11","W","","2-0",FALSE,"New York Jets",20,6,21,265,138,127,1,14,221,151,70,3,1986-09-11,2,1,"nwe",14
"3","Sun","September 21","L","","2-1",TRUE,"Seattle Seahawks",31,38,24,506,386,120,1,12,303,183,120,0,1986-09-21,-1,0,"nwe",-7
"4","Sun","September 28","L","","2-2",FALSE,"Denver Broncos",20,27,16,224,184,40,1,22,338,182,156,2,1986-09-28,1,0,"nwe",-7
"5","Sun","October 5","W","","3-2",TRUE,"Miami Dolphins",34,7,25,429,262,167,0,13,251,152,99,3,1986-10-05,3,1,"nwe",27
"6","Sun","October 12","L","","3-3",TRUE,"New York Jets",24,31,19,400,383,17,2,24,322,145,177,0,1986-10-12,-2,0,"nwe",-7
"7","Sun","October 19","W","","4-3",FALSE,"Pittsburgh Steelers",34,0,16,317,243,74,1,11,168,54,114,4,1986-10-19,3,1,"nwe",34
"8","Sun","October 26","W","","5-3",FALSE,"Buffalo Bills",23,3,20,298,173,125,1,16,224,147,77,4,1986-10-26,3,1,"nwe",20
"9","Sun","November 2","W","","6-3",TRUE,"Atlanta Falcons",25,17,16,349,263,86,1,21,366,148,218,1,1986-11-02,0,1,"nwe",8
"10","Sun","November 9","W","","7-3",FALSE,"Indianapolis Colts",30,21,27,336,222,114,2,17,297,212,85,4,1986-11-09,2,1,"nwe",9
"11","Sun","November 16","W","","8-3",FALSE,"Los Angeles Rams",30,28,23,390,341,49,4,18,369,220,149,2,1986-11-16,-2,1,"nwe",2
"12","Sun","November 23","W","","9-3",TRUE,"Buffalo Bills",22,19,17,261,193,68,1,13,241,192,49,3,1986-11-23,2,1,"nwe",3
"13","Sun","November 30","W","","10-3",FALSE,"New Orleans Saints",21,20,14,231,229,2,2,25,425,247,178,5,1986-11-30,3,1,"nwe",1
"14","Sun","December 7","L","","10-4",TRUE,"Cincinnati Bengals",7,31,18,291,215,76,2,22,584,284,300,1,1986-12-07,-1,0,"nwe",-24
"15","Sun","December 14","L","","10-5",TRUE,"San Francisco 49ers",24,29,16,267,207,60,3,23,400,202,198,1,1986-12-14,-2,0,"nwe",-5
"16","Mon","December 22","W","","11-5",FALSE,"Miami Dolphins",34,27,22,390,264,126,2,20,388,266,122,4,1986-12-22,2,1,"nwe",7
"Division","Sun","January 4","L","","11-6",FALSE,"Denver Broncos",17,22,12,271,150,121,0,23,441,253,188,2,1987-01-04,2,0,"nwe",-5
"1","Sun","September 13","W","","1-0",TRUE,"Miami Dolphins",28,21,18,309,150,159,4,20,285,221,64,2,1987-09-13,-2,1,"nwe",7
"2","Mon","September 21","L","","1-1",FALSE,"New York Jets",24,43,17,193,145,48,2,21,408,281,127,2,1987-09-21,0,0,"nwe",-19
"3","Sun","October 4","L","","1-2",TRUE,"Cleveland Browns",10,20,10,141,110,31,1,22,348,131,217,3,1987-10-04,2,0,"nwe",-10
"4","Sun","October 11","W","","2-2",TRUE,"Buffalo Bills",14,7,15,256,43,213,1,14,168,61,107,5,1987-10-11,4,1,"nwe",7
"5","Sun","October 18","W","","3-2",FALSE,"Houston Oilers",21,7,17,310,196,114,0,17,334,221,113,3,1987-10-18,3,1,"nwe",14
"6","Sun","October 25","L","","3-3",FALSE,"Indianapolis Colts",16,30,18,304,225,79,3,17,300,213,87,1,1987-10-25,-2,0,"nwe",-14
"7","Sun","November 1","W","","4-3",TRUE,"Los Angeles Raiders",26,23,20,406,296,110,1,19,330,249,81,2,1987-11-01,1,1,"nwe",3
"8","Sun","November 8","L","","4-4",FALSE,"New York Giants",10,17,11,232,159,73,3,24,347,217,130,3,1987-11-08,0,0,"nwe",-7
"9","Sun","November 15","L","OT","4-5",TRUE,"Dallas Cowboys",17,23,15,265,177,88,2,24,438,257,181,3,1987-11-15,1,0,"nwe",-6
"10","Sun","November 22","W","","5-5",TRUE,"Indianapolis Colts",24,0,15,313,174,139,0,18,324,198,126,5,1987-11-22,5,1,"nwe",24
"11","Sun","November 29","L","OT","5-6",TRUE,"Philadelphia Eagles",31,34,31,445,356,89,4,23,471,287,184,1,1987-11-29,-3,0,"nwe",-3
"12","Sun","December 6","L","","5-7",FALSE,"Denver Broncos",20,31,20,369,158,211,6,21,371,259,112,3,1987-12-06,-3,0,"nwe",-11
"13","Sun","December 13","W","","6-7",TRUE,"New York Jets",42,20,19,300,171,129,0,24,308,197,111,3,1987-12-13,3,1,"nwe",22
"14","Sun","December 20","W","","7-7",FALSE,"Buffalo Bills",13,7,15,235,85,150,3,12,148,64,84,2,1987-12-20,-1,1,"nwe",6
"15","Mon","December 28","W","","8-7",FALSE,"Miami Dolphins",24,10,25,376,238,138,1,17,297,243,54,4,1987-12-28,3,1,"nwe",14
"1","Sun","September 4","W","","1-0",TRUE,"New York Jets",28,3,20,343,249,94,2,16,179,92,87,2,1988-09-04,0,1,"nwe",25
"2","Sun","September 11","L","","1-1",FALSE,"Minnesota Vikings",6,36,12,214,111,103,5,24,415,265,150,2,1988-09-11,-3,0,"nwe",-30
"3","Sun","September 18","L","","1-2",TRUE,"Buffalo Bills",14,16,14,264,159,105,3,18,254,149,105,2,1988-09-18,-1,0,"nwe",-2
"4","Sun","September 25","L","","1-3",FALSE,"Houston Oilers",6,31,13,184,133,51,6,17,328,156,172,3,1988-09-25,-3,0,"nwe",-25
"5","Sun","October 2","W","","2-3",TRUE,"Indianapolis Colts",21,17,19,298,193,105,2,15,267,164,103,1,1988-10-02,-1,1,"nwe",4
"6","Sun","October 9","L","","2-4",FALSE,"Green Bay Packers",3,45,14,267,191,76,5,23,399,192,207,0,1988-10-09,-5,0,"nwe",-42
"7","Sun","October 16","W","","3-4",TRUE,"Cincinnati Bengals",27,21,22,311,153,158,0,23,365,225,140,6,1988-10-16,6,1,"nwe",6
"8","Sun","October 23","L","","3-5",FALSE,"Buffalo Bills",20,23,20,223,47,176,0,18,339,149,190,4,1988-10-23,4,0,"nwe",-3
"9","Sun","October 30","W","","4-5",TRUE,"Chicago Bears",30,7,19,350,165,185,1,11,208,74,134,3,1988-10-30,2,1,"nwe",23
"10","Sun","November 6","W","","5-5",TRUE,"Miami Dolphins",21,10,18,277,74,203,1,23,437,359,78,2,1988-11-06,1,1,"nwe",11
"11","Sun","November 13","W","","6-5",FALSE,"New York Jets",14,13,13,255,78,177,3,17,298,109,189,3,1988-11-13,0,1,"nwe",1
"12","Sun","November 20","W","","7-5",FALSE,"Miami Dolphins",6,3,17,236,66,170,0,15,293,169,124,0,1988-11-20,0,1,"nwe",3
"13","Sun","November 27","L","","7-6",FALSE,"Indianapolis Colts",21,24,18,285,180,105,3,16,241,160,81,2,1988-11-27,-1,0,"nwe",-3
"14","Sun","December 4","W","","8-6",TRUE,"Seattle Seahawks",13,7,16,212,41,171,3,2,65,45,20,1,1988-12-04,-2,1,"nwe",6
"15","Sun","December 11","W","OT","9-6",TRUE,"Tampa Bay Buccaneers",10,7,11,223,147,76,2,14,262,131,131,2,1988-12-11,0,1,"nwe",3
"16","Sat","December 17","L","","9-7",FALSE,"Denver Broncos",10,21,18,351,186,165,2,20,331,143,188,2,1988-12-17,0,0,"nwe",-11
"1","Sun","September 10","W","","1-0",FALSE,"New York Jets",27,24,26,427,273,154,3,14,304,255,49,1,1989-09-10,-2,1,"nwe",3
"2","Sun","September 17","L","","1-1",TRUE,"Miami Dolphins",10,24,19,325,282,43,1,18,329,226,103,4,1989-09-17,3,0,"nwe",-14
"3","Sun","September 24","L","","1-2",TRUE,"Seattle Seahawks",3,24,13,219,128,91,3,20,316,159,157,0,1989-09-24,-3,0,"nwe",-21
"4","Sun","October 1","L","","1-3",FALSE,"Buffalo Bills",10,31,17,279,155,124,1,16,371,256,115,1,1989-10-01,0,0,"nwe",-21
"5","Sun","October 8","W","","2-3",TRUE,"Houston Oilers",23,13,19,282,138,144,1,14,307,202,105,4,1989-10-08,3,1,"nwe",10
"6","Sun","October 15","L","","2-4",FALSE,"Atlanta Falcons",15,16,13,241,148,93,4,14,312,240,72,2,1989-10-15,-2,0,"nwe",-1
"7","Sun","October 22","L","","2-5",FALSE,"San Francisco 49ers",20,37,19,325,231,94,2,28,494,353,141,0,1989-10-22,-2,0,"nwe",-17
"8","Sun","October 29","W","OT","3-5",FALSE,"Indianapolis Colts",23,20,30,448,328,120,2,19,357,227,130,2,1989-10-29,0,1,"nwe",3
"9","Sun","November 5","L","","3-6",TRUE,"New York Jets",26,27,27,453,318,135,1,19,486,374,112,0,1989-11-05,-1,0,"nwe",-1
"10","Sun","November 12","L","","3-7",TRUE,"New Orleans Saints",24,28,28,354,272,82,4,14,211,82,129,1,1989-11-12,-3,0,"nwe",-4
"11","Sun","November 19","W","","4-7",TRUE,"Buffalo Bills",33,24,19,359,167,192,4,24,424,340,84,6,1989-11-19,2,1,"nwe",9
"12","Sun","November 26","L","","4-8",FALSE,"Los Angeles Raiders",21,24,13,224,194,30,3,19,268,136,132,0,1989-11-26,-3,0,"nwe",-3
"13","Sun","December 3","W","","5-8",TRUE,"Indianapolis Colts",22,16,23,426,239,187,2,14,295,207,88,3,1989-12-03,1,1,"nwe",6
"14","Sun","December 10","L","","5-9",FALSE,"Miami Dolphins",10,31,17,297,231,66,2,24,408,300,108,1,1989-12-10,-1,0,"nwe",-21
"15","Sun","December 17","L","","5-10",FALSE,"Pittsburgh Steelers",10,28,26,403,282,121,3,18,347,128,219,1,1989-12-17,-2,0,"nwe",-18
"16","Sun","December 24","L","","5-11",TRUE,"Los Angeles Rams",20,24,26,394,321,73,3,22,415,181,234,2,1989-12-24,-1,0,"nwe",-4
"1","Sun","September 9","L","","0-1",TRUE,"Miami Dolphins",24,27,13,265,183,82,0,23,432,255,177,4,1990-09-09,4,0,"nwe",-3
"2","Sun","September 16","W","","1-1",FALSE,"Indianapolis Colts",16,14,16,310,187,123,1,14,207,143,64,5,1990-09-16,4,1,"nwe",2
"3","Sun","September 23","L","","1-2",FALSE,"Cincinnati Bengals",7,41,18,302,250,52,5,18,346,236,110,2,1990-09-23,-3,0,"nwe",-34
"4","Sun","September 30","L","","1-3",TRUE,"New York Jets",13,37,18,258,169,89,4,25,499,275,224,2,1990-09-30,-2,0,"nwe",-24
"5","Sun","October 7","L","","1-4",TRUE,"Seattle Seahawks",20,33,16,274,213,61,5,21,338,227,111,2,1990-10-07,-3,0,"nwe",-13
"7","Thu","October 18","L","","1-5",FALSE,"Miami Dolphins",10,17,13,197,148,49,0,15,279,229,50,5,1990-10-18,5,0,"nwe",-7
"8","Sun","October 28","L","","1-6",TRUE,"Buffalo Bills",10,27,17,262,154,108,3,19,353,192,161,0,1990-10-28,-3,0,"nwe",-17
"9","Sun","November 4","L","","1-7",FALSE,"Philadelphia Eagles",20,48,16,288,247,41,1,28,514,210,304,2,1990-11-04,1,0,"nwe",-28
"10","Sun","November 11","L","","1-8",TRUE,"Indianapolis Colts",10,13,14,247,72,175,1,5,155,101,54,0,1990-11-11,-1,0,"nwe",-3
"11","Sun","November 18","L","","1-9",FALSE,"Buffalo Bills",0,14,18,286,196,90,2,14,276,67,209,0,1990-11-18,-2,0,"nwe",-14
"12","Sun","November 25","L","","1-10",FALSE,"Phoenix Cardinals",14,34,16,256,142,114,2,25,363,162,201,1,1990-11-25,-1,0,"nwe",-20
"13","Sun","December 2","L","","1-11",TRUE,"Kansas City Chiefs",7,37,12,231,167,64,2,20,471,321,150,1,1990-12-02,-1,0,"nwe",-30
"14","Sun","December 9","L","","1-12",FALSE,"Pittsburgh Steelers",3,24,9,182,126,56,3,21,417,166,251,3,1990-12-09,0,0,"nwe",-21
"15","Sat","December 15","L","","1-13",TRUE,"Washington Redskins",10,25,13,246,183,63,4,13,258,100,158,2,1990-12-15,-2,0,"nwe",-15
"16","Sun","December 23","L","","1-14",FALSE,"New York Jets",7,42,18,301,210,91,1,29,465,226,239,2,1990-12-23,1,0,"nwe",-35
"17","Sun","December 30","L","","1-15",TRUE,"New York Giants",10,13,12,258,118,140,2,17,324,111,213,1,1990-12-30,-1,0,"nwe",-3
"1","Sun","September 1","W","","1-0",FALSE,"Indianapolis Colts",16,7,14,206,125,81,1,19,337,271,66,2,1991-09-01,1,1,"nwe",9
"2","Sun","September 8","L","","1-1",TRUE,"Cleveland Browns",0,20,8,143,71,72,4,16,279,166,113,0,1991-09-08,-4,0,"nwe",-20
"3","Sun","September 15","L","","1-2",FALSE,"Pittsburgh Steelers",6,20,12,174,92,82,2,16,290,247,43,2,1991-09-15,0,0,"nwe",-14
"4","Sun","September 22","W","","2-2",TRUE,"Houston Oilers",24,20,23,343,234,109,3,18,353,268,85,3,1991-09-22,0,1,"nwe",4
"5","Sun","September 29","L","","2-3",FALSE,"Phoenix Cardinals",10,24,12,214,99,115,3,24,435,300,135,3,1991-09-29,0,0,"nwe",-14
"6","Sun","October 6","L","","2-4",TRUE,"Miami Dolphins",10,20,14,195,140,55,2,19,370,314,56,2,1991-10-06,0,0,"nwe",-10
"8","Sun","October 20","W","OT","3-4",TRUE,"Minnesota Vikings",26,23,20,399,302,97,2,29,444,303,141,2,1991-10-20,0,1,"nwe",3
"9","Sun","October 27","L","","3-5",TRUE,"Denver Broncos",6,9,15,287,146,141,0,14,243,141,102,1,1991-10-27,1,0,"nwe",-3
"10","Sun","November 3","L","","3-6",FALSE,"Buffalo Bills",17,22,17,265,143,122,3,20,388,235,153,4,1991-11-03,1,0,"nwe",-5
"11","Sun","November 10","L","","3-7",FALSE,"Miami Dolphins",20,30,18,323,239,84,1,20,324,255,69,1,1991-11-10,0,0,"nwe",-10
"12","Sun","November 17","L","","3-8",TRUE,"New York Jets",21,28,24,426,351,75,4,25,422,309,113,2,1991-11-17,-2,0,"nwe",-7
"13","Sun","November 24","W","","4-8",TRUE,"Buffalo Bills",16,13,18,312,230,82,2,20,308,168,140,5,1991-11-24,3,1,"nwe",3
"14","Sun","December 1","L","","4-9",FALSE,"Denver Broncos",3,20,14,252,202,50,4,19,325,209,116,1,1991-12-01,-3,0,"nwe",-17
"15","Sun","December 8","W","OT","5-9",TRUE,"Indianapolis Colts",23,17,22,400,277,123,3,13,202,147,55,0,1991-12-08,-3,1,"nwe",6
"16","Sun","December 15","W","","6-9",FALSE,"New York Jets",6,3,14,226,100,126,3,18,268,159,109,1,1991-12-15,-2,1,"nwe",3
"17","Sun","December 22","L","","6-10",FALSE,"Cincinnati Bengals",7,29,14,308,255,53,5,22,443,360,83,2,1991-12-22,-3,0,"nwe",-22
"2","Sun","September 13","L","","0-1",FALSE,"Los Angeles Rams",0,14,14,227,109,118,5,13,240,119,121,0,1992-09-13,-5,0,"nwe",-14
"3","Sun","September 20","L","","0-2",TRUE,"Seattle Seahawks",6,10,16,245,146,99,3,14,250,110,140,0,1992-09-20,-3,0,"nwe",-4
"4","Sun","September 27","L","","0-3",TRUE,"Buffalo Bills",7,41,16,265,196,69,3,23,490,308,182,1,1992-09-27,-2,0,"nwe",-34
"5","Sun","October 4","L","","0-4",FALSE,"New York Jets",21,30,14,282,207,75,3,20,312,195,117,2,1992-10-04,-1,0,"nwe",-9
"6","Sun","October 11","L","","0-5",TRUE,"San Francisco 49ers",12,24,17,227,157,70,3,24,411,228,183,3,1992-10-11,0,0,"nwe",-12
"7","Sun","October 18","L","","0-6",FALSE,"Miami Dolphins",17,38,15,273,255,18,1,20,387,289,98,3,1992-10-18,2,0,"nwe",-21
"8","Sun","October 25","L","","0-7",TRUE,"Cleveland Browns",17,19,14,253,176,77,4,18,288,165,123,0,1992-10-25,-4,0,"nwe",-2
"9","Sun","November 1","L","","0-8",FALSE,"Buffalo Bills",7,16,14,196,127,69,3,20,288,199,89,3,1992-11-01,0,0,"nwe",-9
"10","Sun","November 8","L","","0-9",TRUE,"New Orleans Saints",14,31,6,122,38,84,4,17,316,198,118,2,1992-11-08,-2,0,"nwe",-17
"11","Sun","November 15","W","OT","1-9",FALSE,"Indianapolis Colts",37,34,18,370,226,144,2,26,417,330,87,4,1992-11-15,2,1,"nwe",3
"12","Sun","November 22","W","","2-9",TRUE,"New York Jets",24,3,17,260,96,164,1,11,166,89,77,3,1992-11-22,2,1,"nwe",21
"13","Sun","November 29","L","","2-10",FALSE,"Atlanta Falcons",0,34,8,105,15,90,4,17,253,112,141,0,1992-11-29,-4,0,"nwe",-34
"14","Sun","December 6","L","","2-11",TRUE,"Indianapolis Colts",0,6,9,94,23,71,0,13,265,200,65,2,1992-12-06,2,0,"nwe",-6
"15","Sun","December 13","L","","2-12",FALSE,"Kansas City Chiefs",20,27,10,210,101,109,4,14,270,185,85,4,1992-12-13,0,0,"nwe",-7
"16","Sun","December 20","L","","2-13",FALSE,"Cincinnati Bengals",10,20,10,176,60,116,3,21,365,154,211,0,1992-12-20,-3,0,"nwe",-10
"17","Sun","December 27","L","OT","2-14",TRUE,"Miami Dolphins",13,16,17,279,102,177,2,21,330,216,114,2,1992-12-27,0,0,"nwe",-3
"1","Sun","September 5","L","","0-1",FALSE,"Buffalo Bills",14,38,15,268,135,133,3,20,334,157,177,1,1993-09-05,-2,0,"nwe",-24
"2","Sun","September 12","L","OT","0-2",TRUE,"Detroit Lions",16,19,21,292,231,61,3,21,340,154,186,4,1993-09-12,1,0,"nwe",-3
"3","Sun","September 19","L","","0-3",TRUE,"Seattle Seahawks",14,17,19,274,223,51,3,23,334,125,209,3,1993-09-19,0,0,"nwe",-3
"4","Sun","September 26","L","","0-4",FALSE,"New York Jets",7,45,15,211,180,31,3,21,388,221,167,0,1993-09-26,-3,0,"nwe",-38
"6","Sun","October 10","W","","1-4",FALSE,"Phoenix Cardinals",23,21,25,432,281,151,1,13,311,187,124,3,1993-10-10,2,1,"nwe",2
"7","Sun","October 17","L","","1-5",TRUE,"Houston Oilers",14,28,19,315,261,54,3,15,246,142,104,0,1993-10-17,-3,0,"nwe",-14
"8","Sun","October 24","L","","1-6",FALSE,"Seattle Seahawks",9,10,16,295,129,166,2,15,261,194,67,2,1993-10-24,0,0,"nwe",-1
"9","Sun","October 31","L","","1-7",FALSE,"Indianapolis Colts",6,9,23,363,276,87,3,14,268,179,89,0,1993-10-31,-3,0,"nwe",-3
"10","Sun","November 7","L","OT","1-8",TRUE,"Buffalo Bills",10,13,17,284,97,187,1,25,432,298,134,3,1993-11-07,2,0,"nwe",-3
"12","Sun","November 21","L","","1-9",FALSE,"Miami Dolphins",13,17,23,349,261,88,1,15,344,233,111,0,1993-11-21,-1,0,"nwe",-4
"13","Sun","November 28","L","","1-10",TRUE,"New York Jets",0,6,14,289,134,155,2,14,294,174,120,1,1993-11-28,-1,0,"nwe",-6
"14","Sun","December 5","L","","1-11",FALSE,"Pittsburgh Steelers",14,17,20,349,296,53,6,14,217,92,125,0,1993-12-05,-6,0,"nwe",-3
"15","Sun","December 12","W","","2-11",TRUE,"Cincinnati Bengals",7,2,16,224,106,118,0,11,165,63,102,1,1993-12-12,1,1,"nwe",5
"16","Sun","December 19","W","","3-11",FALSE,"Cleveland Browns",20,17,23,323,203,120,1,18,377,297,80,3,1993-12-19,2,1,"nwe",3
"17","Sun","December 26","W","","4-11",TRUE,"Indianapolis Colts",38,0,24,400,143,257,0,7,136,99,37,1,1993-12-26,1,1,"nwe",38
"18","Sun","January 2","W","OT","5-11",TRUE,"Miami Dolphins",33,27,25,397,329,68,2,23,349,230,119,0,1994-01-02,-2,1,"nwe",6
"1","Sun","September 4","L","","0-1",FALSE,"Miami Dolphins",35,39,25,472,418,54,3,21,525,456,69,3,1994-09-04,0,0,"nwe",-4
"2","Sun","September 11","L","","0-2",TRUE,"Buffalo Bills",35,38,26,467,371,96,5,25,466,322,144,4,1994-09-11,-1,0,"nwe",-3
"3","Sun","September 18","W","","1-2",FALSE,"Cincinnati Bengals",31,28,28,447,365,82,2,21,318,219,99,2,1994-09-18,0,1,"nwe",3
"4","Sun","September 25","W","","2-2",FALSE,"Detroit Lions",23,17,21,353,245,108,0,15,342,183,159,2,1994-09-25,2,1,"nwe",6
"5","Sun","October 2","W","","3-2",TRUE,"Green Bay Packers",17,16,21,360,312,48,2,20,364,264,100,2,1994-10-02,0,1,"nwe",1
"6","Sun","October 9","L","","3-3",TRUE,"Los Angeles Raiders",17,21,25,359,305,54,4,14,328,242,86,4,1994-10-09,0,0,"nwe",-4
"7","Sun","October 16","L","","3-4",FALSE,"New York Jets",17,24,19,324,220,104,4,17,242,70,172,2,1994-10-16,-2,0,"nwe",-7
"9","Sun","October 30","L","","3-5",TRUE,"Miami Dolphins",3,23,11,188,142,46,3,20,338,198,140,2,1994-10-30,-1,0,"nwe",-20
"10","Sun","November 6","L","","3-6",FALSE,"Cleveland Browns",6,13,20,277,159,118,4,16,308,160,148,2,1994-11-06,-2,0,"nwe",-7
"11","Sun","November 13","W","OT","4-6",TRUE,"Minnesota Vikings",26,20,27,468,426,42,0,22,440,339,101,1,1994-11-13,1,1,"nwe",6
"12","Sun","November 20","W","","5-6",TRUE,"San Diego Chargers",23,17,21,318,217,101,2,18,241,169,72,3,1994-11-20,1,1,"nwe",6
"13","Sun","November 27","W","","6-6",FALSE,"Indianapolis Colts",12,10,19,336,257,79,1,15,290,158,132,2,1994-11-27,1,1,"nwe",2
"14","Sun","December 4","W","","7-6",TRUE,"New York Jets",24,13,20,326,191,135,2,13,219,155,64,1,1994-12-04,-1,1,"nwe",11
"15","Sun","December 11","W","","8-6",TRUE,"Indianapolis Colts",28,13,24,361,277,84,5,13,212,138,74,4,1994-12-11,-1,1,"nwe",15
"16","Sun","December 18","W","","9-6",FALSE,"Buffalo Bills",41,17,22,377,276,101,0,16,326,191,135,5,1994-12-18,5,1,"nwe",24
"17","Sat","December 24","W","","10-6",FALSE,"Chicago Bears",13,3,19,343,263,80,1,14,248,183,65,1,1994-12-24,0,1,"nwe",10
"WildCard","Sun","January 1","L","","10-7",FALSE,"Cleveland Browns",13,20,20,303,246,57,3,22,379,254,125,1,1995-01-01,-2,0,"nwe",-7
"1","Sun","September 3","W","","1-0",TRUE,"Cleveland Browns",17,14,27,427,302,125,0,13,301,241,60,1,1995-09-03,1,1,"nwe",3
"2","Sun","September 10","L","","1-1",TRUE,"Miami Dolphins",3,20,19,292,253,39,3,21,406,224,182,3,1995-09-10,0,0,"nwe",-17
"3","Sun","September 17","L","","1-2",FALSE,"San Francisco 49ers",3,28,18,302,226,76,4,21,363,273,90,1,1995-09-17,-3,0,"nwe",-25
"5","Sun","October 1","L","","1-3",FALSE,"Atlanta Falcons",17,30,17,332,224,108,3,19,375,288,87,2,1995-10-01,-1,0,"nwe",-13
"6","Sun","October 8","L","","1-4",TRUE,"Denver Broncos",3,37,22,329,248,81,2,23,403,282,121,1,1995-10-08,-1,0,"nwe",-34
"7","Sun","October 15","L","","1-5",FALSE,"Kansas City Chiefs",26,31,23,321,213,108,2,17,353,203,150,0,1995-10-15,-2,0,"nwe",-5
"8","Mon","October 23","W","","2-5",TRUE,"Buffalo Bills",27,14,24,423,262,161,1,14,301,186,115,3,1995-10-23,2,1,"nwe",13
"9","Sun","October 29","L","OT","2-6",TRUE,"Carolina Panthers",17,20,23,326,228,98,2,23,434,291,143,2,1995-10-29,0,0,"nwe",-3
"10","Sun","November 5","W","","3-6",FALSE,"New York Jets",20,7,18,345,173,172,2,20,255,123,132,2,1995-11-05,0,1,"nwe",13
"11","Sun","November 12","W","","4-6",FALSE,"Miami Dolphins",34,17,22,352,205,147,0,27,448,373,75,3,1995-11-12,3,1,"nwe",17
"12","Sun","November 19","L","","4-7",TRUE,"Indianapolis Colts",10,24,14,202,151,51,2,18,370,232,138,1,1995-11-19,-1,0,"nwe",-14
"13","Sun","November 26","W","","5-7",FALSE,"Buffalo Bills",35,25,26,430,257,173,3,19,334,202,132,3,1995-11-26,0,1,"nwe",10
"14","Sun","December 3","L","","5-8",TRUE,"New Orleans Saints",17,31,21,331,191,140,3,17,432,293,139,1,1995-12-03,-2,0,"nwe",-14
"15","Sun","December 10","W","","6-8",TRUE,"New York Jets",31,28,18,327,167,160,3,23,346,254,92,4,1995-12-10,1,1,"nwe",3
"16","Sat","December 16","L","","6-9",FALSE,"Pittsburgh Steelers",27,41,28,439,322,117,3,14,321,226,95,1,1995-12-16,-2,0,"nwe",-14
"17","Sat","December 23","L","","6-10",FALSE,"Indianapolis Colts",7,10,15,279,169,110,3,19,322,195,127,1,1995-12-23,-2,0,"nwe",-3
"1","Sun","September 1","L","","0-1",FALSE,"Miami Dolphins",10,24,16,229,200,29,4,19,322,176,146,1,1996-09-01,-3,0,"nwe",-14
"2","Sun","September 8","L","","0-2",FALSE,"Buffalo Bills",10,17,23,293,179,114,2,15,231,154,77,3,1996-09-08,1,0,"nwe",-7
"3","Sun","September 15","W","","1-2",TRUE,"Arizona Cardinals",31,0,26,384,221,163,0,9,170,124,46,4,1996-09-15,4,1,"nwe",31
"4","Sun","September 22","W","OT","2-2",TRUE,"Jacksonville Jaguars",28,25,26,353,230,123,2,12,442,413,29,2,1996-09-22,0,1,"nwe",3
"6","Sun","October 6","W","","3-2",FALSE,"Baltimore Ravens",46,38,26,364,310,54,0,28,463,330,133,1,1996-10-06,1,1,"nwe",8
"7","Sun","October 13","L","","3-3",TRUE,"Washington Redskins",22,27,23,382,205,177,1,22,384,276,108,0,1996-10-13,-1,0,"nwe",-5
"8","Sun","October 20","W","","4-3",FALSE,"Indianapolis Colts",27,9,15,222,142,80,2,27,364,319,45,4,1996-10-20,2,1,"nwe",18
"9","Sun","October 27","W","","5-3",TRUE,"Buffalo Bills",28,25,23,417,358,59,1,18,337,196,141,1,1996-10-27,0,1,"nwe",3
"10","Sun","November 3","W","","6-3",TRUE,"Miami Dolphins",42,23,28,468,409,59,4,22,430,315,115,3,1996-11-03,-1,1,"nwe",19
"11","Sun","November 10","W","","7-3",FALSE,"New York Jets",31,27,21,343,275,68,3,28,422,280,142,1,1996-11-10,-2,1,"nwe",4
"12","Sun","November 17","L","","7-4",TRUE,"Denver Broncos",8,34,12,218,201,17,1,26,422,224,198,1,1996-11-17,0,0,"nwe",-26
"13","Sun","November 24","W","","8-4",TRUE,"Indianapolis Colts",27,13,25,429,234,195,0,15,291,247,44,2,1996-11-24,2,1,"nwe",14
"14","Sun","December 1","W","","9-4",FALSE,"San Diego Chargers",45,7,15,313,229,84,0,15,236,204,32,6,1996-12-01,6,1,"nwe",38
"15","Sun","December 8","W","","10-4",TRUE,"New York Jets",34,10,27,367,248,119,1,16,244,202,42,2,1996-12-08,1,1,"nwe",24
"16","Sun","December 15","L","","10-5",FALSE,"Dallas Cowboys",6,12,16,279,178,101,4,16,251,144,107,2,1996-12-15,-2,0,"nwe",-6
"17","Sat","December 21","W","","11-5",FALSE,"New York Giants",23,22,17,308,282,26,2,17,296,199,97,1,1996-12-21,-1,1,"nwe",1
"Division","Sun","January 5","W","","12-5",TRUE,"Pittsburgh Steelers",28,3,17,346,152,194,2,12,213,90,123,2,1997-01-05,0,1,"nwe",25
"ConfChamp","Sun","January 12","W","","13-5",TRUE,"Jacksonville Jaguars",20,6,13,234,161,73,2,18,289,188,101,4,1997-01-12,2,1,"nwe",14
"SuperBowl","Sun","January 26","L","","13-6",TRUE,"Green Bay Packers",21,35,16,257,214,43,4,16,323,208,115,0,1997-01-26,-4,0,"nwe",-14
"1","Sun","August 31","W","","1-0",TRUE,"San Diego Chargers",41,7,22,424,340,84,0,14,227,142,85,3,1997-08-31,3,1,"nwe",34
"2","Sun","September 7","W","","2-0",FALSE,"Indianapolis Colts",31,6,15,382,260,122,0,19,255,214,41,1,1997-09-07,1,1,"nwe",25
"3","Sun","September 14","W","OT","3-0",TRUE,"New York Jets",27,24,23,375,162,213,3,22,355,225,130,3,1997-09-14,0,1,"nwe",3
"4","Sun","September 21","W","","4-0",TRUE,"Chicago Bears",31,3,23,402,315,87,3,9,199,120,79,3,1997-09-21,0,1,"nwe",28
"6","Mon","October 6","L","","4-1",FALSE,"Denver Broncos",13,34,13,262,211,51,2,25,380,188,192,2,1997-10-06,0,0,"nwe",-21
"7","Sun","October 12","W","","5-1",TRUE,"Buffalo Bills",33,6,19,310,171,139,1,13,242,148,94,4,1997-10-12,3,1,"nwe",27
"8","Sun","October 19","L","","5-2",FALSE,"New York Jets",19,24,19,372,267,105,1,22,330,254,76,0,1997-10-19,-1,0,"nwe",-5
"9","Mon","October 27","L","","5-3",TRUE,"Green Bay Packers",10,28,18,324,255,69,4,27,371,227,144,1,1997-10-27,-3,0,"nwe",-18
"10","Sun","November 2","L","","5-4",FALSE,"Minnesota Vikings",18,23,21,410,293,117,1,18,288,222,66,0,1997-11-02,-1,0,"nwe",-5
"11","Sun","November 9","W","","6-4",FALSE,"Buffalo Bills",31,10,11,267,164,103,0,14,241,119,122,4,1997-11-09,4,1,"nwe",21
"12","Sun","November 16","L","","6-5",FALSE,"Tampa Bay Buccaneers",7,27,10,168,93,75,3,21,348,202,146,2,1997-11-16,-1,0,"nwe",-20
"13","Sun","November 23","W","","7-5",TRUE,"Miami Dolphins",27,24,15,318,234,84,0,33,406,370,36,3,1997-11-23,3,1,"nwe",3
"14","Sun","November 30","W","","8-5",TRUE,"Indianapolis Colts",20,17,17,258,187,71,0,23,403,285,118,1,1997-11-30,1,1,"nwe",3
"15","Sun","December 7","W","","9-5",FALSE,"Jacksonville Jaguars",26,20,16,282,227,55,0,23,341,234,107,2,1997-12-07,2,1,"nwe",6
"16","Sat","December 13","L","OT","9-6",TRUE,"Pittsburgh Steelers",21,24,15,253,211,42,2,22,404,266,138,2,1997-12-13,0,0,"nwe",-3
"17","Mon","December 22","W","","10-6",FALSE,"Miami Dolphins",14,12,10,207,160,47,2,17,295,253,42,1,1997-12-22,-1,1,"nwe",2
"WildCard","Sun","December 28","W","","11-6",TRUE,"Miami Dolphins",17,3,15,228,120,108,0,10,162,120,42,3,1997-12-28,3,1,"nwe",14
"Division","Sat","January 3","L","","11-7",FALSE,"Pittsburgh Steelers",6,7,15,280,244,36,4,16,279,134,145,1,1998-01-03,-3,0,"nwe",-1
"1","Mon","September 7","L","","0-1",FALSE,"Denver Broncos",21,27,17,339,258,81,0,20,339,248,91,0,1998-09-07,0,0,"nwe",-6
"2","Sun","September 13","W","","1-1",TRUE,"Indianapolis Colts",29,6,15,321,218,103,0,20,309,173,136,4,1998-09-13,4,1,"nwe",23
"3","Sun","September 20","W","","2-1",TRUE,"Tennessee Oilers",27,16,13,322,228,94,0,18,306,194,112,2,1998-09-20,2,1,"nwe",11
"5","Sun","October 4","W","","3-1",FALSE,"New Orleans Saints",30,27,20,388,291,97,4,19,276,237,39,2,1998-10-04,-2,1,"nwe",3
"6","Sun","October 11","W","","4-1",TRUE,"Kansas City Chiefs",40,10,31,438,232,206,1,9,134,120,14,2,1998-10-11,1,1,"nwe",30
"7","Mon","October 19","L","","4-2",TRUE,"New York Jets",14,24,19,291,181,110,1,25,392,271,121,0,1998-10-19,-1,0,"nwe",-10
"8","Sun","October 25","L","OT","4-3",FALSE,"Miami Dolphins",9,12,13,251,225,26,1,18,333,263,70,3,1998-10-25,2,0,"nwe",-3
"9","Sun","November 1","W","","5-3",FALSE,"Indianapolis Colts",21,16,20,370,293,77,1,18,310,278,32,2,1998-11-01,1,1,"nwe",5
"10","Sun","November 8","L","","5-4",TRUE,"Atlanta Falcons",10,41,15,223,205,18,5,22,366,249,117,2,1998-11-08,-3,0,"nwe",-31
"11","Sun","November 15","L","","5-5",FALSE,"Buffalo Bills",10,13,11,206,158,48,0,23,391,178,213,3,1998-11-15,3,0,"nwe",-3
"12","Mon","November 23","W","","6-5",TRUE,"Miami Dolphins",26,23,21,455,414,41,2,17,322,289,33,1,1998-11-23,-1,1,"nwe",3
"13","Sun","November 29","W","","7-5",TRUE,"Buffalo Bills",25,21,24,259,215,44,1,23,428,329,99,0,1998-11-29,-1,1,"nwe",4
"14","Sun","December 6","W","","8-5",FALSE,"Pittsburgh Steelers",23,9,19,377,304,73,3,13,249,195,54,3,1998-12-06,0,1,"nwe",14
"15","Sun","December 13","L","","8-6",FALSE,"St. Louis Rams",18,32,14,319,119,200,2,18,278,162,116,3,1998-12-13,1,0,"nwe",-14
"16","Sun","December 20","W","","9-6",TRUE,"San Francisco 49ers",24,21,20,332,200,132,2,21,410,259,151,3,1998-12-20,1,1,"nwe",3
"17","Sun","December 27","L","","9-7",FALSE,"New York Jets",10,31,9,249,119,130,1,21,339,190,149,1,1998-12-27,0,0,"nwe",-21
"WildCard","Sun","January 3","L","","9-8",FALSE,"Jacksonville Jaguars",10,25,14,206,171,35,3,17,308,148,160,0,1999-01-03,-3,0,"nwe",-15
"1","Sun","September 12","W","","1-0",FALSE,"New York Jets",30,28,16,396,326,70,2,19,363,257,106,4,1999-09-12,2,1,"nwe",2
"2","Sun","September 19","W","","2-0",TRUE,"Indianapolis Colts",31,28,26,400,292,108,1,23,344,223,121,4,1999-09-19,3,1,"nwe",3
"3","Sun","September 26","W","","3-0",TRUE,"New York Giants",16,14,17,290,223,67,0,19,258,201,57,0,1999-09-26,0,1,"nwe",2
"4","Sun","October 3","W","","4-0",FALSE,"Cleveland Browns",19,7,23,451,361,90,2,12,250,180,70,1,1999-10-03,-1,1,"nwe",12
"5","Sun","October 10","L","","4-1",FALSE,"Kansas City Chiefs",14,16,18,378,316,62,4,20,329,189,140,2,1999-10-10,-2,0,"nwe",-2
"6","Sun","October 17","L","","4-2",TRUE,"Miami Dolphins",30,31,14,259,213,46,2,22,317,195,122,2,1999-10-17,0,0,"nwe",-1
"7","Sun","October 24","W","","5-2",TRUE,"Denver Broncos",24,23,15,325,192,133,0,23,442,309,133,0,1999-10-24,0,1,"nwe",1
"8","Sun","October 31","W","","6-2",FALSE,"Arizona Cardinals",27,3,17,386,244,142,0,8,166,90,76,2,1999-10-31,2,1,"nwe",24
"10","Mon","November 15","L","","6-3",TRUE,"New York Jets",17,24,16,229,150,79,3,19,341,153,188,2,1999-11-15,-1,0,"nwe",-7
"11","Sun","November 21","L","","6-4",FALSE,"Miami Dolphins",17,27,14,270,168,102,5,19,227,110,117,2,1999-11-21,-3,0,"nwe",-10
"12","Sun","November 28","L","","6-5",FALSE,"Buffalo Bills",7,17,17,267,174,93,2,13,299,207,92,1,1999-11-28,-1,0,"nwe",-10
"13","Sun","December 5","W","","7-5",TRUE,"Dallas Cowboys",13,6,18,284,176,108,2,12,203,140,63,0,1999-12-05,-2,1,"nwe",7
"14","Sun","December 12","L","","7-6",FALSE,"Indianapolis Colts",15,20,23,401,344,57,1,15,287,178,109,1,1999-12-12,0,0,"nwe",-5
"15","Sun","December 19","L","","7-7",FALSE,"Philadelphia Eagles",9,24,20,350,288,62,7,11,295,181,114,3,1999-12-19,-4,0,"nwe",-15
"16","Sun","December 26","L","OT","7-8",TRUE,"Buffalo Bills",10,13,14,225,67,158,1,23,374,206,168,3,1999-12-26,2,0,"nwe",-3
"17","Sun","January 2","W","","8-8",TRUE,"Baltimore Ravens",20,3,12,151,102,49,1,23,313,194,119,4,2000-01-02,3,1,"nwe",17
"1","Sun","September 3","L","","0-1",TRUE,"Tampa Bay Buccaneers",16,21,14,278,190,88,1,17,296,156,140,1,2000-09-03,0,0,"nwe",-5
"2","Mon","September 11","L","","0-2",FALSE,"New York Jets",19,20,21,293,193,100,0,18,330,271,59,1,2000-09-11,1,0,"nwe",-1
"3","Sun","September 17","L","","0-3",TRUE,"Minnesota Vikings",13,21,18,267,164,103,1,23,315,161,154,2,2000-09-17,1,0,"nwe",-8
"4","Sun","September 24","L","","0-4",FALSE,"Miami Dolphins",3,10,12,210,154,56,2,12,242,143,99,3,2000-09-24,1,0,"nwe",-7
"5","Sun","October 1","W","","1-4",FALSE,"Denver Broncos",28,19,19,314,260,54,1,26,405,326,79,2,2000-10-01,1,1,"nwe",9
"6","Sun","October 8","W","","2-4",TRUE,"Indianapolis Colts",24,16,19,301,183,118,0,27,408,324,84,3,2000-10-08,3,1,"nwe",8
"7","Sun","October 15","L","","2-5",TRUE,"New York Jets",17,34,16,249,198,51,6,20,294,130,164,1,2000-10-15,-5,0,"nwe",-17
"8","Sun","October 22","L","","2-6",FALSE,"Indianapolis Colts",23,30,24,386,231,155,1,20,398,268,130,1,2000-10-22,0,0,"nwe",-7
"10","Sun","November 5","L","OT","2-7",TRUE,"Buffalo Bills",13,16,14,189,100,89,2,20,315,174,141,1,2000-11-05,-1,0,"nwe",-3
"11","Sun","November 12","L","","2-8",FALSE,"Cleveland Browns",11,19,18,286,184,102,4,18,272,133,139,0,2000-11-12,-4,0,"nwe",-8
"12","Sun","November 19","W","","3-8",TRUE,"Cincinnati Bengals",16,13,17,291,252,39,1,25,365,228,137,2,2000-11-19,1,1,"nwe",3
"13","Thu","November 23","L","","3-9",FALSE,"Detroit Lions",9,34,15,215,149,66,2,17,299,189,110,1,2000-11-23,-1,0,"nwe",-25
"14","Mon","December 4","W","","4-9",TRUE,"Kansas City Chiefs",30,24,24,368,263,105,1,18,418,350,68,3,2000-12-04,2,1,"nwe",6
"15","Sun","December 10","L","","4-10",FALSE,"Chicago Bears",17,24,15,245,207,38,0,21,339,237,102,1,2000-12-10,1,0,"nwe",-7
"16","Sun","December 17","W","OT","5-10",FALSE,"Buffalo Bills",13,10,19,331,142,189,0,19,347,169,178,1,2000-12-17,1,1,"nwe",3
"17","Sun","December 24","L","","5-11",TRUE,"Miami Dolphins",24,27,18,348,311,37,3,25,310,263,47,0,2000-12-24,-3,0,"nwe",-3
"1","Sun","September 9","L","","0-1",FALSE,"Cincinnati Bengals",17,23,16,292,224,68,0,18,353,196,157,1,2001-09-09,1,0,"nwe",-6
"2","Sun","September 23","L","","0-2",TRUE,"New York Jets",3,10,15,308,201,107,4,14,238,127,111,0,2001-09-23,-4,0,"nwe",-7
"3","Sun","September 30","W","","1-2",TRUE,"Indianapolis Colts",44,13,19,336,159,177,0,20,322,240,82,4,2001-09-30,4,1,"nwe",31
"4","Sun","October 7","L","","1-3",FALSE,"Miami Dolphins",10,30,12,149,69,80,3,19,296,87,209,1,2001-10-07,-2,0,"nwe",-20
"5","Sun","October 14","W","OT","2-3",TRUE,"San Diego Chargers",29,26,30,374,345,29,1,20,343,258,85,1,2001-10-14,0,1,"nwe",3
"6","Sun","October 21","W","","3-3",FALSE,"Indianapolis Colts",38,17,19,385,262,123,0,28,484,305,179,2,2001-10-21,2,1,"nwe",21
"7","Sun","October 28","L","","3-4",FALSE,"Denver Broncos",20,31,21,300,183,117,5,18,355,269,86,2,2001-10-28,-3,0,"nwe",-11
"8","Sun","November 4","W","","4-4",FALSE,"Atlanta Falcons",24,10,21,371,236,135,2,11,244,104,140,1,2001-11-04,-1,1,"nwe",14
"9","Sun","November 11","W","","5-4",TRUE,"Buffalo Bills",21,11,15,205,71,134,3,15,242,173,69,2,2001-11-11,-1,1,"nwe",10
"10","Sun","November 18","L","","5-5",TRUE,"St. Louis Rams",17,24,13,230,179,51,3,26,482,396,86,3,2001-11-18,0,0,"nwe",-7
"11","Sun","November 25","W","","6-5",TRUE,"New Orleans Saints",34,17,26,432,241,191,0,23,428,307,121,2,2001-11-25,2,1,"nwe",17
"12","Sun","December 2","W","","7-5",FALSE,"New York Jets",17,16,14,264,191,73,0,18,288,157,131,2,2001-12-02,2,1,"nwe",1
"13","Sun","December 9","W","","8-5",TRUE,"Cleveland Browns",27,16,18,290,209,81,2,17,277,227,50,4,2001-12-09,2,1,"nwe",11
"14","Sun","December 16","W","OT","9-5",FALSE,"Buffalo Bills",12,9,17,335,206,129,2,19,310,212,98,1,2001-12-16,-1,1,"nwe",3
"15","Sat","December 22","W","","10-5",TRUE,"Miami Dolphins",20,13,20,313,117,196,0,19,368,310,58,3,2001-12-22,3,1,"nwe",7
"17","Sun","January 6","W","","11-5",FALSE,"Carolina Panthers",38,6,16,298,196,102,3,18,322,129,193,6,2002-01-06,3,1,"nwe",32
"Division","Sat","January 19","W","OT","12-5",TRUE,"Oakland Raiders",16,13,22,365,297,68,1,14,230,153,77,0,2002-01-19,-1,1,"nwe",3
"ConfChamp","Sun","January 27","W","","13-5",FALSE,"Pittsburgh Steelers",24,17,15,259,192,67,0,23,306,248,58,4,2002-01-27,4,1,"nwe",7
"SuperBowl","Sun","February 3","W","","14-5",TRUE,"St. Louis Rams",20,17,15,267,134,133,0,26,427,337,90,3,2002-02-03,3,1,"nwe",3
"1","Mon","September 9","W","","1-0",TRUE,"Pittsburgh Steelers",30,14,20,343,280,63,1,20,283,209,74,5,2002-09-09,4,1,"nwe",16
"2","Sun","September 15","W","","2-0",FALSE,"New York Jets",44,7,24,432,269,163,2,9,200,168,32,2,2002-09-15,0,1,"nwe",37
"3","Sun","September 22","W","OT","3-0",TRUE,"Kansas City Chiefs",41,38,27,496,399,97,1,21,349,128,221,3,2002-09-22,2,1,"nwe",3
"4","Sun","September 29","L","","3-1",FALSE,"San Diego Chargers",14,21,25,440,353,87,3,14,342,104,238,1,2002-09-29,-2,0,"nwe",-7
"5","Sun","October 6","L","","3-2",FALSE,"Miami Dolphins",13,26,16,245,208,37,3,21,319,182,137,1,2002-10-06,-2,0,"nwe",-13
"6","Sun","October 13","L","","3-3",TRUE,"Green Bay Packers",10,28,20,289,166,123,4,20,301,143,158,0,2002-10-13,-4,0,"nwe",-18
"8","Sun","October 27","L","","3-4",TRUE,"Denver Broncos",16,24,16,179,110,69,0,23,351,215,136,2,2002-10-27,2,0,"nwe",-8
"9","Sun","November 3","W","","4-4",FALSE,"Buffalo Bills",38,7,23,422,263,159,0,28,331,266,65,1,2002-11-03,1,1,"nwe",31
"10","Sun","November 10","W","","5-4",FALSE,"Chicago Bears",33,30,19,397,315,82,2,14,299,174,125,1,2002-11-10,-1,1,"nwe",3
"11","Sun","November 17","L","","5-5",FALSE,"Oakland Raiders",20,27,12,195,147,48,1,22,386,289,97,1,2002-11-17,0,0,"nwe",-7
"12","Sun","November 24","W","","6-5",TRUE,"Minnesota Vikings",24,17,20,299,219,80,0,26,417,264,153,3,2002-11-24,3,1,"nwe",7
"13","Thu","November 28","W","","7-5",FALSE,"Detroit Lions",20,12,23,349,210,139,1,14,292,210,82,3,2002-11-28,2,1,"nwe",8
"14","Sun","December 8","W","","8-5",TRUE,"Buffalo Bills",27,17,14,275,183,92,0,24,390,312,78,5,2002-12-08,5,1,"nwe",10
"15","Mon","December 16","L","","8-6",FALSE,"Tennessee Titans",7,24,11,176,120,56,2,20,365,127,238,1,2002-12-16,-1,0,"nwe",-17
"16","Sun","December 22","L","","8-7",TRUE,"New York Jets",17,30,14,216,119,97,2,19,393,285,108,0,2002-12-22,-2,0,"nwe",-13
"17","Sun","December 29","W","OT","9-7",TRUE,"Miami Dolphins",27,24,20,332,216,116,2,20,359,103,256,0,2002-12-29,-2,1,"nwe",3
"1","Sun","September 7","L","","0-1",FALSE,"Buffalo Bills",0,31,16,239,134,105,4,23,322,215,107,2,2003-09-07,-2,0,"nwe",-31
"2","Sun","September 14","W","","1-1",FALSE,"Philadelphia Eagles",31,10,17,309,247,62,0,23,268,168,100,6,2003-09-14,6,1,"nwe",21
"3","Sun","September 21","W","","2-1",TRUE,"New York Jets",23,16,19,294,147,147,1,16,329,264,65,1,2003-09-21,0,1,"nwe",7
"4","Sun","September 28","L","","2-2",FALSE,"Washington Redskins",17,20,23,387,281,106,4,15,253,134,119,0,2003-09-28,-4,0,"nwe",-3
"5","Sun","October 5","W","","3-2",TRUE,"Tennessee Titans",38,30,21,354,193,161,0,23,411,341,70,1,2003-10-05,1,1,"nwe",8
"6","Sun","October 12","W","","4-2",TRUE,"New York Giants",17,6,12,220,91,129,0,26,382,306,76,5,2003-10-12,5,1,"nwe",11
"7","Sun","October 19","W","OT","5-2",FALSE,"Miami Dolphins",19,13,16,332,273,59,2,20,326,229,97,3,2003-10-19,1,1,"nwe",6
"8","Sun","October 26","W","","6-2",TRUE,"Cleveland Browns",9,3,19,347,253,94,0,13,203,119,84,1,2003-10-26,1,1,"nwe",6
"9","Mon","November 3","W","","7-2",FALSE,"Denver Broncos",30,26,17,419,350,69,2,18,277,163,114,1,2003-11-03,-1,1,"nwe",4
"11","Sun","November 16","W","","8-2",TRUE,"Dallas Cowboys",12,0,14,268,203,65,1,17,291,207,84,3,2003-11-16,2,1,"nwe",12
"12","Sun","November 23","W","OT","9-2",FALSE,"Houston Texans",23,20,29,472,344,128,3,11,169,80,89,2,2003-11-23,-1,1,"nwe",3
"13","Sun","November 30","W","","10-2",FALSE,"Indianapolis Colts",38,34,21,282,226,56,3,26,370,272,98,2,2003-11-30,-1,1,"nwe",4
"14","Sun","December 7","W","","11-2",TRUE,"Miami Dolphins",12,0,13,228,150,78,1,7,134,66,68,3,2003-12-07,2,1,"nwe",12
"15","Sun","December 14","W","","12-2",TRUE,"Jacksonville Jaguars",27,13,18,296,212,84,1,17,354,282,72,2,2003-12-14,1,1,"nwe",14
"16","Sat","December 20","W","","13-2",FALSE,"New York Jets",21,16,13,271,138,133,1,22,321,212,109,5,2003-12-20,4,1,"nwe",5
"17","Sat","December 27","W","","14-2",TRUE,"Buffalo Bills",31,0,26,321,190,131,1,16,256,174,82,4,2003-12-27,3,1,"nwe",31
"Division","Sat","January 10","W","","15-2",TRUE,"Tennessee Titans",17,14,18,297,201,96,1,16,284,200,84,1,2004-01-10,0,1,"nwe",3
"ConfChamp","Sun","January 18","W","","16-2",TRUE,"Indianapolis Colts",24,14,20,349,237,112,2,21,306,208,98,5,2004-01-18,3,1,"nwe",10
"SuperBowl","Sun","February 1","W","","17-2",TRUE,"Carolina Panthers",32,29,29,481,354,127,1,17,387,295,92,1,2004-02-01,0,1,"nwe",3
"1","Thu","September 9","W","","1-0",TRUE,"Indianapolis Colts",27,24,22,402,320,82,2,28,446,244,202,3,2004-09-09,1,1,"nwe",3
"2","Sun","September 19","W","","2-0",FALSE,"Arizona Cardinals",23,12,24,379,207,172,3,14,167,117,50,2,2004-09-19,-1,1,"nwe",11
"4","Sun","October 3","W","","3-0",FALSE,"Buffalo Bills",31,17,21,397,298,99,1,18,337,214,123,2,2004-10-03,1,1,"nwe",14
"5","Sun","October 10","W","","4-0",TRUE,"Miami Dolphins",24,10,14,204,69,135,1,18,295,228,67,2,2004-10-10,1,1,"nwe",14
"6","Sun","October 17","W","","5-0",TRUE,"Seattle Seahawks",30,20,20,362,224,138,2,23,443,341,102,2,2004-10-17,0,1,"nwe",10
"7","Sun","October 24","W","","6-0",TRUE,"New York Jets",13,7,21,343,210,133,1,15,268,162,106,1,2004-10-24,0,1,"nwe",6
"8","Sun","October 31","L","","6-1",FALSE,"Pittsburgh Steelers",20,34,19,248,243,5,4,25,417,196,221,0,2004-10-31,-4,0,"nwe",-14
"9","Sun","November 7","W","","7-1",FALSE,"St. Louis Rams",40,22,22,376,229,147,1,21,340,259,81,3,2004-11-07,2,1,"nwe",18
"10","Sun","November 14","W","","8-1",TRUE,"Buffalo Bills",29,6,25,428,220,208,1,8,125,75,50,5,2004-11-14,4,1,"nwe",23
"11","Mon","November 22","W","","9-1",FALSE,"Kansas City Chiefs",27,19,21,407,309,98,1,20,417,353,64,1,2004-11-22,0,1,"nwe",8
"12","Sun","November 28","W","","10-1",TRUE,"Baltimore Ravens",24,3,18,314,170,144,0,8,124,47,77,2,2004-11-28,2,1,"nwe",21
"13","Sun","December 5","W","","11-1",FALSE,"Cleveland Browns",42,15,27,412,187,225,3,16,287,241,46,4,2004-12-05,1,1,"nwe",27
"14","Sun","December 12","W","","12-1",TRUE,"Cincinnati Bengals",35,28,22,351,257,94,0,26,478,328,150,3,2004-12-12,3,1,"nwe",7
"15","Mon","December 20","L","","12-2",FALSE,"Miami Dolphins",28,29,24,322,156,166,4,18,231,179,52,1,2004-12-20,-3,0,"nwe",-1
"16","Sun","December 26","W","","13-2",FALSE,"New York Jets",23,7,21,372,258,114,0,17,279,233,46,3,2004-12-26,3,1,"nwe",16
"17","Sun","January 2","W","","14-2",TRUE,"San Francisco 49ers",21,7,23,405,231,174,3,15,318,183,135,2,2005-01-02,-1,1,"nwe",14
"Division","Sun","January 16","W","","15-2",TRUE,"Indianapolis Colts",20,3,21,325,115,210,0,18,276,230,46,3,2005-01-16,3,1,"nwe",17
"ConfChamp","Sun","January 23","W","","16-2",FALSE,"Pittsburgh Steelers",41,27,18,322,196,126,0,19,388,225,163,4,2005-01-23,4,1,"nwe",14
"SuperBowl","Sun","February 6","W","","17-2",TRUE,"Philadelphia Eagles",24,21,21,331,219,112,1,24,369,324,45,4,2005-02-06,3,1,"nwe",3
"1","Thu","September 8","W","","1-0",TRUE,"Oakland Raiders",30,20,22,379,306,73,0,19,338,246,92,1,2005-09-08,1,1,"nwe",10
"2","Sun","September 18","L","","1-1",FALSE,"Carolina Panthers",17,27,14,288,249,39,3,17,250,146,104,1,2005-09-18,-2,0,"nwe",-10
"3","Sun","September 25","W","","2-1",FALSE,"Pittsburgh Steelers",23,20,24,426,346,80,3,14,269,190,79,1,2005-09-25,-2,1,"nwe",3
"4","Sun","October 2","L","","2-2",TRUE,"San Diego Chargers",17,41,18,303,231,72,2,26,431,248,183,0,2005-10-02,-2,0,"nwe",-24
"5","Sun","October 9","W","","3-2",FALSE,"Atlanta Falcons",31,28,20,483,342,141,1,22,400,284,116,0,2005-10-09,-1,1,"nwe",3
"6","Sun","October 16","L","","3-3",FALSE,"Denver Broncos",20,28,22,388,299,89,0,20,432,254,178,0,2005-10-16,0,0,"nwe",-8
"8","Sun","October 30","W","","4-3",TRUE,"Buffalo Bills",21,16,18,273,180,93,2,24,394,247,147,2,2005-10-30,0,1,"nwe",5
"9","Mon","November 7","L","","4-4",TRUE,"Indianapolis Colts",21,40,17,288,254,34,2,28,453,321,132,1,2005-11-07,-1,0,"nwe",-19
"10","Sun","November 13","W","","5-4",FALSE,"Miami Dolphins",23,16,19,365,274,91,2,22,437,360,77,2,2005-11-13,0,1,"nwe",7
"11","Sun","November 20","W","","6-4",TRUE,"New Orleans Saints",24,17,20,326,194,132,1,23,425,338,87,1,2005-11-20,0,1,"nwe",7
"12","Sun","November 27","L","","6-5",FALSE,"Kansas City Chiefs",16,26,20,306,232,74,4,24,420,308,112,1,2005-11-27,-3,0,"nwe",-10
"13","Sun","December 4","W","","7-5",TRUE,"New York Jets",16,3,24,397,251,146,0,12,164,123,41,1,2005-12-04,1,1,"nwe",13
"14","Sun","December 11","W","","8-5",FALSE,"Buffalo Bills",35,7,32,494,335,159,2,8,183,169,14,3,2005-12-11,1,1,"nwe",28
"15","Sat","December 17","W","","9-5",TRUE,"Tampa Bay Buccaneers",28,0,22,336,253,83,0,12,138,108,30,1,2005-12-17,1,1,"nwe",28
"16","Mon","December 26","W","","10-5",FALSE,"New York Jets",31,21,26,321,170,151,1,10,171,131,40,3,2005-12-26,2,1,"nwe",10
"17","Sun","January 1","L","","10-6",TRUE,"Miami Dolphins",26,28,16,259,204,55,1,25,378,230,148,0,2006-01-01,-1,0,"nwe",-2
"WildCard","Sat","January 7","W","","11-6",TRUE,"Jacksonville Jaguars",28,3,17,307,189,118,0,15,292,205,87,2,2006-01-07,2,1,"nwe",25
"Division","Sat","January 14","L","","11-7",FALSE,"Denver Broncos",13,27,15,420,341,79,5,16,286,190,96,1,2006-01-14,-4,0,"nwe",-14
"1","Sun","September 10","W","","1-0",TRUE,"Buffalo Bills",19,17,19,319,136,183,2,12,240,141,99,0,2006-09-10,-2,1,"nwe",2
"2","Sun","September 17","W","","2-0",FALSE,"New York Jets",24,17,24,358,211,147,2,16,338,286,52,1,2006-09-17,-1,1,"nwe",7
"3","Sun","September 24","L","","2-1",TRUE,"Denver Broncos",7,17,22,370,320,50,0,19,400,256,144,0,2006-09-24,0,0,"nwe",-10
"4","Sun","October 1","W","","3-1",FALSE,"Cincinnati Bengals",38,13,26,424,188,236,1,17,279,208,71,2,2006-10-01,1,1,"nwe",25
"5","Sun","October 8","W","","4-1",TRUE,"Miami Dolphins",20,10,17,213,134,79,1,19,283,221,62,3,2006-10-08,2,1,"nwe",10
"7","Sun","October 22","W","","5-1",FALSE,"Buffalo Bills",28,6,18,265,171,94,0,12,255,180,75,4,2006-10-22,4,1,"nwe",22
"8","Mon","October 30","W","","6-1",FALSE,"Minnesota Vikings",31,7,25,430,345,85,2,17,284,239,45,4,2006-10-30,2,1,"nwe",24
"9","Sun","November 5","L","","6-2",TRUE,"Indianapolis Colts",20,27,24,349,201,148,5,24,354,301,53,2,2006-11-05,-3,0,"nwe",-7
"10","Sun","November 12","L","","6-3",TRUE,"New York Jets",14,17,22,377,232,145,2,19,278,161,117,1,2006-11-12,-1,0,"nwe",-3
"11","Sun","November 19","W","","7-3",FALSE,"Green Bay Packers",35,0,22,357,235,122,1,5,120,76,44,1,2006-11-19,0,1,"nwe",35
"12","Sun","November 26","W","","8-3",TRUE,"Chicago Bears",17,13,20,352,267,85,5,21,324,171,153,4,2006-11-26,-1,1,"nwe",4
"13","Sun","December 3","W","","9-3",TRUE,"Detroit Lions",28,21,23,363,284,79,3,22,361,284,77,5,2006-12-03,2,1,"nwe",7
"14","Sun","December 10","L","","9-4",FALSE,"Miami Dolphins",0,21,12,189,66,123,3,19,315,184,131,0,2006-12-10,-3,0,"nwe",-21
"15","Sun","December 17","W","","10-4",TRUE,"Houston Texans",40,7,15,230,125,105,0,13,198,93,105,4,2006-12-17,4,1,"nwe",33
"16","Sun","December 24","W","","11-4",FALSE,"Jacksonville Jaguars",24,21,22,359,242,117,0,12,339,195,144,1,2006-12-24,1,1,"nwe",3
"17","Sun","December 31","W","","12-4",FALSE,"Tennessee Titans",40,23,19,414,243,171,0,17,342,207,135,3,2006-12-31,3,1,"nwe",17
"WildCard","Sun","January 7","W","","13-4",TRUE,"New York Jets",37,16,26,358,200,158,1,18,347,277,70,2,2007-01-07,1,1,"nwe",21
"Division","Sun","January 14","W","","14-4",FALSE,"San Diego Chargers",24,21,18,327,276,51,3,21,352,204,148,4,2007-01-14,1,1,"nwe",3
"ConfChamp","Sun","January 21","L","","14-5",FALSE,"Indianapolis Colts",34,38,17,319,226,93,1,32,455,330,125,1,2007-01-21,0,0,"nwe",-4
"1","Sun","September 9","W","","1-0",FALSE,"New York Jets",38,14,28,431,297,134,0,17,227,167,60,0,2007-09-09,0,1,"nwe",24
"2","Sun","September 16","W","","2-0",TRUE,"San Diego Chargers",38,14,25,407,263,144,2,14,201,149,52,3,2007-09-16,1,1,"nwe",24
"3","Sun","September 23","W","","3-0",TRUE,"Buffalo Bills",38,7,27,485,308,177,1,12,193,83,110,2,2007-09-23,1,1,"nwe",31
"4","Mon","October 1","W","","4-0",FALSE,"Cincinnati Bengals",34,13,25,404,231,173,1,17,283,226,57,2,2007-10-01,1,1,"nwe",21
"5","Sun","October 7","W","","5-0",TRUE,"Cleveland Browns",34,17,23,412,265,147,0,22,353,261,92,4,2007-10-07,4,1,"nwe",17
"6","Sun","October 14","W","","6-0",FALSE,"Dallas Cowboys",48,27,28,448,373,75,1,13,285,186,99,1,2007-10-14,0,1,"nwe",21
"7","Sun","October 21","W","","7-0",FALSE,"Miami Dolphins",49,28,23,443,359,84,1,25,382,203,179,2,2007-10-21,1,1,"nwe",21
"8","Sun","October 28","W","","8-0",TRUE,"Washington Redskins",52,7,34,486,334,152,1,13,224,177,47,4,2007-10-28,3,1,"nwe",45
"9","Sun","November 4","W","","9-0",FALSE,"Indianapolis Colts",24,20,21,342,237,105,2,23,329,210,119,2,2007-11-04,0,1,"nwe",4
"11","Sun","November 18","W","","10-0",FALSE,"Buffalo Bills",56,10,30,510,383,127,0,14,229,151,78,2,2007-11-18,2,1,"nwe",46
"12","Sun","November 25","W","","11-0",TRUE,"Philadelphia Eagles",31,28,25,410,362,48,0,22,391,336,55,3,2007-11-25,3,1,"nwe",3
"13","Mon","December 3","W","","12-0",FALSE,"Baltimore Ravens",27,24,21,326,236,90,1,20,376,210,166,2,2007-12-03,1,1,"nwe",3
"14","Sun","December 9","W","","13-0",TRUE,"Pittsburgh Steelers",34,13,21,421,399,22,0,19,349,168,181,1,2007-12-09,1,1,"nwe",21
"15","Sun","December 16","W","","14-0",TRUE,"New York Jets",20,10,16,265,134,131,1,13,234,144,90,2,2007-12-16,1,1,"nwe",10
"16","Sun","December 23","W","","15-0",TRUE,"Miami Dolphins",28,7,19,400,204,196,4,15,241,133,108,0,2007-12-23,-4,1,"nwe",21
"17","Sat","December 29","W","","16-0",FALSE,"New York Giants",38,35,27,390,346,44,0,19,316,237,79,1,2007-12-29,1,1,"nwe",3
"Division","Sat","January 12","W","","17-0",TRUE,"Jacksonville Jaguars",31,20,24,403,258,145,0,22,350,270,80,2,2008-01-12,2,1,"nwe",11
"ConfChamp","Sun","January 20","W","","18-0",TRUE,"San Diego Chargers",21,12,25,347,198,149,3,17,311,207,104,2,2008-01-20,-1,1,"nwe",9
"SuperBowl","Sun","February 3","L","","18-1",TRUE,"New York Giants",14,17,22,274,229,45,1,17,338,247,91,1,2008-02-03,0,0,"nwe",-3
"1","Sun","September 7","W","","1-0",TRUE,"Kansas City Chiefs",17,10,18,338,212,126,2,14,284,182,102,1,2008-09-07,-1,1,"nwe",7
"2","Sun","September 14","W","","2-0",FALSE,"New York Jets",19,10,18,260,156,104,0,12,256,152,104,1,2008-09-14,1,1,"nwe",9
"3","Sun","September 21","L","","2-1",TRUE,"Miami Dolphins",13,38,14,215,137,78,2,23,461,245,216,0,2008-09-21,-2,0,"nwe",-25
"5","Sun","October 5","W","","3-1",FALSE,"San Francisco 49ers",30,21,25,377,233,144,2,12,199,122,77,3,2008-10-05,1,1,"nwe",9
"6","Sun","October 12","L","","3-2",FALSE,"San Diego Chargers",10,30,18,299,193,106,1,19,404,306,98,1,2008-10-12,0,0,"nwe",-20
"7","Mon","October 20","W","","4-2",TRUE,"Denver Broncos",41,7,25,404,147,257,0,19,275,169,106,5,2008-10-20,5,1,"nwe",34
"8","Sun","October 26","W","","5-2",TRUE,"St. Louis Rams",23,16,23,348,250,98,2,15,358,268,90,1,2008-10-26,-1,1,"nwe",7
"9","Sun","November 2","L","","5-3",FALSE,"Indianapolis Colts",15,18,22,342,202,140,2,18,301,254,47,0,2008-11-02,-2,0,"nwe",-3
"10","Sun","November 9","W","","6-3",TRUE,"Buffalo Bills",20,10,24,370,226,144,1,10,168,108,60,2,2008-11-09,1,1,"nwe",10
"11","Thu","November 13","L","OT","6-4",TRUE,"New York Jets",31,34,26,511,386,125,1,23,375,235,140,1,2008-11-13,0,0,"nwe",-3
"12","Sun","November 23","W","","7-4",FALSE,"Miami Dolphins",48,28,30,530,408,122,2,23,392,326,66,1,2008-11-23,-1,1,"nwe",20
"13","Sun","November 30","L","","7-5",TRUE,"Pittsburgh Steelers",10,33,19,267,145,122,5,19,333,172,161,1,2008-11-30,-4,0,"nwe",-23
"14","Sun","December 7","W","","8-5",FALSE,"Seattle Seahawks",24,21,22,344,260,84,0,18,339,205,134,1,2008-12-07,1,1,"nwe",3
"15","Sun","December 14","W","","9-5",FALSE,"Oakland Raiders",49,26,29,487,210,277,1,19,334,218,116,1,2008-12-14,0,1,"nwe",23
"16","Sun","December 21","W","","10-5",TRUE,"Arizona Cardinals",47,7,27,514,331,183,0,8,186,142,44,2,2008-12-21,2,1,"nwe",40
"17","Sun","December 28","W","","11-5",FALSE,"Buffalo Bills",13,0,16,241,73,168,0,15,276,115,161,1,2008-12-28,1,1,"nwe",13
"1","Mon","September 14","W","","1-0",TRUE,"Buffalo Bills",25,24,28,441,368,73,1,17,276,186,90,1,2009-09-14,0,1,"nwe",1
"2","Sun","September 20","L","","1-1",FALSE,"New York Jets",9,16,18,299,216,83,1,14,254,137,117,1,2009-09-20,0,0,"nwe",-7
"3","Sun","September 27","W","","2-1",TRUE,"Atlanta Falcons",26,10,28,445,277,168,0,13,257,199,58,1,2009-09-27,1,1,"nwe",16
"4","Sun","October 4","W","","3-1",TRUE,"Baltimore Ravens",27,21,25,319,234,85,1,24,363,247,116,2,2009-10-04,1,1,"nwe",6
"5","Sun","October 11","L","OT","3-2",FALSE,"Denver Broncos",17,20,18,305,209,96,1,27,424,321,103,2,2009-10-11,1,0,"nwe",-3
"6","Sun","October 18","W","","4-2",TRUE,"Tennessee Titans",59,0,32,619,426,193,0,9,186,-7,193,5,2009-10-18,5,1,"nwe",59
"7","Sun","October 25","W","","5-2",FALSE,"Tampa Bay Buccaneers",35,7,18,414,307,107,2,10,240,151,89,3,2009-10-25,1,1,"nwe",28
"9","Sun","November 8","W","","6-2",TRUE,"Miami Dolphins",27,17,22,432,323,109,1,21,334,201,133,0,2009-11-08,-1,1,"nwe",10
"10","Sun","November 15","L","","6-3",FALSE,"Indianapolis Colts",34,35,24,477,364,113,2,25,407,316,91,2,2009-11-15,0,0,"nwe",-1
"11","Sun","November 22","W","","7-3",TRUE,"New York Jets",31,14,27,410,299,111,1,12,226,122,104,5,2009-11-22,4,1,"nwe",17
"12","Mon","November 30","L","","7-4",FALSE,"New Orleans Saints",17,38,23,366,244,122,3,18,480,367,113,1,2009-11-30,-2,0,"nwe",-21
"13","Sun","December 6","L","","7-5",FALSE,"Miami Dolphins",21,22,18,448,352,96,2,24,416,328,88,1,2009-12-06,-1,0,"nwe",-1
"14","Sun","December 13","W","","8-5",TRUE,"Carolina Panthers",20,10,26,377,192,185,3,14,305,179,126,0,2009-12-13,-3,1,"nwe",10
"15","Sun","December 20","W","","9-5",FALSE,"Buffalo Bills",17,10,19,224,115,109,1,16,241,136,105,1,2009-12-20,0,1,"nwe",7
"16","Sun","December 27","W","","10-5",TRUE,"Jacksonville Jaguars",35,7,26,464,267,197,1,16,275,177,98,2,2009-12-27,1,1,"nwe",28
"17","Sun","January 3","L","","10-6",FALSE,"Houston Texans",27,34,21,317,243,74,2,29,439,295,144,1,2010-01-03,-1,0,"nwe",-7
"WildCard","Sun","January 10","L","","10-7",TRUE,"Baltimore Ravens",14,33,15,196,132,64,4,16,268,34,234,2,2010-01-10,-2,0,"nwe",-19
"1","Sun","September 12","W","","1-0",TRUE,"Cincinnati Bengals",38,24,20,376,258,118,0,26,428,341,87,2,2010-09-12,2,1,"nwe",14
"2","Sun","September 19","L","","1-1",FALSE,"New York Jets",14,28,20,291,239,52,3,23,336,200,136,0,2010-09-19,-3,0,"nwe",-14
"3","Sun","September 26","W","","2-1",TRUE,"Buffalo Bills",38,30,25,445,245,200,1,19,374,240,134,2,2010-09-26,1,1,"nwe",8
"4","Mon","October 4","W","","3-1",FALSE,"Miami Dolphins",41,14,19,265,146,119,0,23,400,308,92,4,2010-10-04,4,1,"nwe",27
"6","Sun","October 17","W","OT","4-1",TRUE,"Baltimore Ravens",23,20,23,394,267,127,2,21,377,278,99,0,2010-10-17,-2,1,"nwe",3
"7","Sun","October 24","W","","5-1",FALSE,"San Diego Chargers",23,20,15,179,128,51,0,23,363,325,38,4,2010-10-24,4,1,"nwe",3
"8","Sun","October 31","W","","6-1",TRUE,"Minnesota Vikings",28,18,18,362,240,122,0,23,410,285,125,1,2010-10-31,1,1,"nwe",10
"9","Sun","November 7","L","","6-2",FALSE,"Cleveland Browns",14,34,19,283,215,68,3,22,404,174,230,1,2010-11-07,-2,0,"nwe",-20
"10","Sun","November 14","W","","7-2",FALSE,"Pittsburgh Steelers",39,26,26,453,350,103,0,27,425,349,76,1,2010-11-14,1,1,"nwe",13
"11","Sun","November 21","W","","8-2",TRUE,"Indianapolis Colts",31,28,22,346,178,168,0,28,467,396,71,3,2010-11-21,3,1,"nwe",3
"12","Thu","November 25","W","","9-2",FALSE,"Detroit Lions",45,24,20,447,338,109,0,25,406,277,129,2,2010-11-25,2,1,"nwe",21
"13","Mon","December 6","W","","10-2",TRUE,"New York Jets",45,3,23,405,304,101,0,18,301,149,152,3,2010-12-06,3,1,"nwe",42
"14","Sun","December 12","W","","11-2",FALSE,"Chicago Bears",36,7,27,475,351,124,0,12,185,138,47,4,2010-12-12,4,1,"nwe",29
"15","Sun","December 19","W","","12-2",TRUE,"Green Bay Packers",31,27,14,249,136,113,0,26,369,226,143,2,2010-12-19,2,1,"nwe",4
"16","Sun","December 26","W","","13-2",FALSE,"Buffalo Bills",34,3,20,348,131,217,0,16,369,244,125,7,2010-12-26,7,1,"nwe",31
"17","Sun","January 2","W","","14-2",TRUE,"Miami Dolphins",38,7,24,502,321,181,1,16,250,206,44,2,2011-01-02,1,1,"nwe",31
"Division","Sun","January 16","L","","14-3",TRUE,"New York Jets",21,28,26,372,259,113,1,14,314,194,120,0,2011-01-16,-1,0,"nwe",-7
"1","Mon","September 12","W","","1-0",FALSE,"Miami Dolphins",38,24,27,622,516,106,1,25,488,390,98,1,2011-09-12,0,1,"nwe",14
"2","Sun","September 18","W","","2-0",TRUE,"San Diego Chargers",35,21,28,504,410,94,0,29,470,372,98,4,2011-09-18,4,1,"nwe",14
"3","Sun","September 25","L","","2-1",FALSE,"Buffalo Bills",31,34,30,495,387,108,4,24,448,369,79,2,2011-09-25,-2,0,"nwe",-3
"4","Sun","October 2","W","","3-1",FALSE,"Oakland Raiders",31,19,25,409,226,183,0,24,504,344,160,2,2011-10-02,2,1,"nwe",12
"5","Sun","October 9","W","","4-1",TRUE,"New York Jets",30,21,26,446,294,152,1,14,255,158,97,0,2011-10-09,-1,1,"nwe",9
"6","Sun","October 16","W","","5-1",TRUE,"Dallas Cowboys",20,16,25,371,270,101,4,21,377,300,77,2,2011-10-16,-2,1,"nwe",4
"8","Sun","October 30","L","","5-2",FALSE,"Pittsburgh Steelers",17,25,19,213,170,43,0,29,427,329,98,1,2011-10-30,1,0,"nwe",-8
"9","Sun","November 6","L","","5-3",TRUE,"New York Giants",20,24,23,438,332,106,4,23,361,250,111,2,2011-11-06,-2,0,"nwe",-4
"10","Sun","November 13","W","","6-3",FALSE,"New York Jets",37,16,21,389,329,60,0,22,378,268,110,3,2011-11-13,3,1,"nwe",21
"11","Mon","November 21","W","","7-3",TRUE,"Kansas City Chiefs",34,3,20,380,223,157,1,16,334,209,125,3,2011-11-21,2,1,"nwe",31
"12","Sun","November 27","W","","8-3",FALSE,"Philadelphia Eagles",38,20,29,457,353,104,0,23,466,393,73,1,2011-11-27,1,1,"nwe",18
"13","Sun","December 4","W","","9-3",TRUE,"Indianapolis Colts",31,24,24,362,289,73,0,26,437,338,99,2,2011-12-04,2,1,"nwe",7
"14","Sun","December 11","W","","10-3",FALSE,"Washington Redskins",34,27,22,431,352,79,1,25,463,293,170,2,2011-12-11,1,1,"nwe",7
"15","Sun","December 18","W","","11-3",FALSE,"Denver Broncos",41,23,26,451,310,141,0,25,393,141,252,3,2011-12-18,3,1,"nwe",18
"16","Sat","December 24","W","","12-3",TRUE,"Miami Dolphins",27,24,26,400,281,119,0,20,374,253,121,2,2011-12-24,2,1,"nwe",3
"17","Sun","January 1","W","","13-3",TRUE,"Buffalo Bills",49,21,28,480,342,138,1,26,402,296,106,4,2012-01-01,3,1,"nwe",28
"Division","Sat","January 14","W","","14-3",TRUE,"Denver Broncos",45,10,31,509,363,146,2,15,252,108,144,1,2012-01-14,-1,1,"nwe",35
"ConfChamp","Sun","January 22","W","","15-3",TRUE,"Baltimore Ravens",23,20,25,330,234,96,3,19,398,282,116,1,2012-01-22,-2,1,"nwe",3
"SuperBowl","Sun","February 5","L","","15-4",TRUE,"New York Giants",17,21,21,349,266,83,1,26,396,282,114,0,2012-02-05,-1,0,"nwe",-4
"1","Sun","September 8","L","","0-1",TRUE,"San Diego Chargers",9,14,19,455,371,84,3,17,308,208,100,2,1985-09-08,-1,0,"buf",-5
"2","Sun","September 15","L","","0-2",FALSE,"New York Jets",3,42,16,270,188,82,5,27,532,244,288,0,1985-09-15,-5,0,"buf",-39
"3","Sun","September 22","L","","0-3",TRUE,"New England Patriots",14,17,16,306,251,55,1,14,227,105,122,2,1985-09-22,1,0,"buf",-3
"4","Sun","September 29","L","","0-4",TRUE,"Minnesota Vikings",20,27,20,277,162,115,2,19,338,167,171,1,1985-09-29,-1,0,"buf",-7
"5","Sun","October 6","L","","0-5",FALSE,"Indianapolis Colts",17,49,15,252,184,68,3,28,464,183,281,1,1985-10-06,-2,0,"buf",-32
"6","Sun","October 13","L","","0-6",FALSE,"New England Patriots",3,14,13,162,90,72,4,18,400,318,82,4,1985-10-13,0,0,"buf",-11
"7","Sun","October 20","W","","1-6",TRUE,"Indianapolis Colts",21,9,13,182,61,121,3,14,191,65,126,3,1985-10-20,0,1,"buf",12
"8","Sun","October 27","L","","1-7",FALSE,"Philadelphia Eagles",17,21,17,339,211,128,2,16,275,237,38,1,1985-10-27,-1,0,"buf",-4
"9","Sun","November 3","L","","1-8",TRUE,"Cincinnati Bengals",17,23,16,268,173,95,3,21,389,182,207,2,1985-11-03,-1,0,"buf",-6
"10","Sun","November 10","W","","2-8",TRUE,"Houston Oilers",20,0,18,207,60,147,2,7,142,31,111,6,1985-11-10,4,1,"buf",20
"11","Sun","November 17","L","","2-9",FALSE,"Cleveland Browns",7,17,13,217,162,55,3,17,294,93,201,1,1985-11-17,-2,0,"buf",-10
"12","Sun","November 24","L","","2-10",TRUE,"Miami Dolphins",14,23,12,255,161,94,1,28,388,216,172,2,1985-11-24,1,0,"buf",-9
"13","Sun","December 1","L","","2-11",FALSE,"San Diego Chargers",7,40,21,347,238,109,5,21,365,269,96,3,1985-12-01,-2,0,"buf",-33
"14","Sun","December 8","L","","2-12",TRUE,"New York Jets",7,27,22,436,350,86,4,24,485,367,118,2,1985-12-08,-2,0,"buf",-20
"15","Sun","December 15","L","","2-13",FALSE,"Pittsburgh Steelers",24,30,14,323,134,189,5,25,434,264,170,3,1985-12-15,-2,0,"buf",-6
"16","Sun","December 22","L","","2-14",FALSE,"Miami Dolphins",0,28,11,299,188,111,6,24,308,129,179,2,1985-12-22,-4,0,"buf",-28
"1","Sun","September 7","L","","0-1",TRUE,"New York Jets",24,28,19,368,289,79,2,19,390,287,103,0,1986-09-07,-2,0,"buf",-4
"2","Sun","September 14","L","OT","0-2",FALSE,"Cincinnati Bengals",33,36,20,378,207,171,2,22,405,240,165,3,1986-09-14,1,0,"buf",-3
"3","Sun","September 21","W","","1-2",TRUE,"St. Louis Cardinals",17,10,10,176,82,94,1,25,381,259,122,1,1986-09-21,0,1,"buf",7
"4","Sun","September 28","L","","1-3",TRUE,"Kansas City Chiefs",17,20,24,366,269,97,4,20,327,201,126,1,1986-09-28,-3,0,"buf",-3
"5","Sun","October 5","L","","1-4",FALSE,"New York Jets",13,14,16,320,194,126,1,20,382,272,110,1,1986-10-05,0,0,"buf",-1
"6","Sun","October 12","L","","1-5",FALSE,"Miami Dolphins",14,27,18,305,197,108,4,27,447,328,119,3,1986-10-12,-1,0,"buf",-13
"7","Sun","October 19","W","","2-5",TRUE,"Indianapolis Colts",24,13,21,364,243,121,3,20,297,167,130,2,1986-10-19,-1,1,"buf",11
"8","Sun","October 26","L","","2-6",TRUE,"New England Patriots",3,23,16,224,147,77,4,20,298,173,125,1,1986-10-26,-3,0,"buf",-20
"9","Sun","November 2","L","","2-7",FALSE,"Tampa Bay Buccaneers",28,34,23,403,324,79,3,20,306,171,135,0,1986-11-02,-3,0,"buf",-6
"10","Sun","November 9","W","","3-7",TRUE,"Pittsburgh Steelers",16,12,18,248,76,172,1,11,185,132,53,1,1986-11-09,0,1,"buf",4
"11","Sun","November 16","L","","3-8",TRUE,"Miami Dolphins",24,34,14,261,181,80,1,29,474,389,85,0,1986-11-16,-1,0,"buf",-10
"12","Sun","November 23","L","","3-9",FALSE,"New England Patriots",19,22,13,241,192,49,3,17,261,193,68,1,1986-11-23,-2,0,"buf",-3
"13","Sun","November 30","W","","4-9",FALSE,"Kansas City Chiefs",17,14,25,336,172,164,2,26,346,273,73,3,1986-11-30,1,1,"buf",3
"14","Sun","December 7","L","","4-10",TRUE,"Cleveland Browns",17,21,17,391,308,83,3,21,371,230,141,1,1986-12-07,-2,0,"buf",-4
"15","Sun","December 14","L","","4-11",FALSE,"Indianapolis Colts",14,24,18,358,264,94,3,21,375,296,79,0,1986-12-14,-3,0,"buf",-10
"16","Sun","December 21","L","","4-12",FALSE,"Houston Oilers",7,16,19,278,218,60,2,16,278,191,87,0,1986-12-21,-2,0,"buf",-9
"1","Sun","September 13","L","","0-1",TRUE,"New York Jets",28,31,23,359,292,67,1,26,394,261,133,1,1987-09-13,0,0,"buf",-3
"2","Sun","September 20","W","","1-1",TRUE,"Houston Oilers",34,30,30,383,248,135,2,19,327,130,197,1,1987-09-20,-1,1,"buf",4
"3","Sun","October 4","L","","1-2",TRUE,"Indianapolis Colts",6,47,14,163,82,81,7,28,463,297,166,2,1987-10-04,-5,0,"buf",-41
"4","Sun","October 11","L","","1-3",FALSE,"New England Patriots",7,14,14,168,61,107,5,15,256,43,213,1,1987-10-11,-4,0,"buf",-7
"5","Sun","October 18","W","OT","2-3",TRUE,"New York Giants",6,3,22,331,164,167,7,19,308,180,128,2,1987-10-18,-5,1,"buf",3
"6","Sun","October 25","W","OT","3-3",FALSE,"Miami Dolphins",34,31,29,474,330,144,0,21,366,296,70,2,1987-10-25,2,1,"buf",3
"7","Sun","November 1","L","","3-4",TRUE,"Washington Redskins",7,27,14,280,259,21,4,24,406,107,299,1,1987-11-01,-3,0,"buf",-20
"8","Sun","November 8","W","","4-4",TRUE,"Denver Broncos",21,14,25,428,170,258,3,12,215,139,76,2,1987-11-08,-1,1,"buf",7
"9","Sun","November 15","L","","4-5",FALSE,"Cleveland Browns",21,27,17,267,206,61,2,24,421,337,84,3,1987-11-15,1,0,"buf",-6
"10","Sun","November 22","W","","5-5",FALSE,"New York Jets",17,14,15,331,204,127,1,21,318,192,126,1,1987-11-22,0,1,"buf",3
"11","Sun","November 29","W","","6-5",TRUE,"Miami Dolphins",27,0,21,446,217,229,0,13,229,206,23,3,1987-11-29,3,1,"buf",27
"12","Sun","December 6","L","","6-6",FALSE,"Los Angeles Raiders",21,34,19,387,303,84,1,29,494,350,144,0,1987-12-06,-1,0,"buf",-13
"13","Sun","December 13","W","","7-6",FALSE,"Indianapolis Colts",27,3,25,385,167,218,4,9,130,97,33,6,1987-12-13,2,1,"buf",24
"14","Sun","December 20","L","","7-7",TRUE,"New England Patriots",7,13,12,148,64,84,2,15,235,85,150,3,1987-12-20,1,0,"buf",-6
"15","Sun","December 27","L","","7-8",FALSE,"Philadelphia Eagles",7,17,14,191,134,57,4,22,344,134,210,3,1987-12-27,-1,0,"buf",-10
"1","Sun","September 4","W","","1-0",TRUE,"Minnesota Vikings",13,10,18,310,196,114,1,21,300,170,130,2,1988-09-04,1,1,"buf",3
"2","Sun","September 11","W","","2-0",TRUE,"Miami Dolphins",9,6,15,319,215,104,4,16,334,219,115,2,1988-09-11,-2,1,"buf",3
"3","Sun","September 18","W","","3-0",FALSE,"New England Patriots",16,14,18,254,149,105,2,14,264,159,105,3,1988-09-18,1,1,"buf",2
"4","Sun","September 25","W","","4-0",TRUE,"Pittsburgh Steelers",36,28,22,398,282,116,3,25,408,314,94,5,1988-09-25,2,1,"buf",8
"5","Sun","October 2","L","","4-1",FALSE,"Chicago Bears",3,24,13,217,217,0,1,22,423,260,163,2,1988-10-02,1,0,"buf",-21
"6","Sun","October 9","W","","5-1",TRUE,"Indianapolis Colts",34,23,25,456,315,141,3,25,308,241,67,3,1988-10-09,0,1,"buf",11
"7","Mon","October 17","W","","6-1",FALSE,"New York Jets",37,14,24,427,292,135,1,10,199,154,45,2,1988-10-17,1,1,"buf",23
"8","Sun","October 23","W","","7-1",TRUE,"New England Patriots",23,20,18,339,149,190,4,20,223,47,176,0,1988-10-23,-4,1,"buf",3
"9","Sun","October 30","W","","8-1",TRUE,"Green Bay Packers",28,0,18,261,66,195,3,10,131,54,77,4,1988-10-30,1,1,"buf",28
"10","Sun","November 6","W","","9-1",FALSE,"Seattle Seahawks",13,3,18,336,194,142,2,10,145,73,72,2,1988-11-06,0,1,"buf",10
"11","Mon","November 14","W","","10-1",FALSE,"Miami Dolphins",31,6,29,416,211,205,0,15,257,224,33,3,1988-11-14,3,1,"buf",25
"12","Sun","November 20","W","OT","11-1",TRUE,"New York Jets",9,6,20,341,112,229,2,16,259,119,140,1,1988-11-20,-1,1,"buf",3
"13","Sun","November 27","L","","11-2",FALSE,"Cincinnati Bengals",21,35,21,353,243,110,4,34,455,223,232,0,1988-11-27,-4,0,"buf",-14
"14","Sun","December 4","L","","11-3",FALSE,"Tampa Bay Buccaneers",5,10,16,273,234,39,2,19,253,143,110,0,1988-12-04,-2,0,"buf",-5
"15","Sun","December 11","W","","12-3",TRUE,"Los Angeles Raiders",37,21,24,367,112,255,0,17,318,207,111,3,1988-12-11,3,1,"buf",16
"16","Sun","December 18","L","","12-4",FALSE,"Indianapolis Colts",14,17,14,248,195,53,1,25,301,117,184,0,1988-12-18,-1,0,"buf",-3
"Division","Sun","January 1","W","","13-4",TRUE,"Houston Oilers",17,10,18,372,237,135,1,20,351,226,125,3,1989-01-01,2,1,"buf",7
"ConfChamp","Sun","January 8","L","","13-5",FALSE,"Cincinnati Bengals",10,21,10,181,136,45,3,23,249,74,175,2,1989-01-08,-1,0,"buf",-11
"1","Sun","September 10","W","","1-0",FALSE,"Miami Dolphins",27,24,27,367,226,141,2,20,323,255,68,4,1989-09-10,2,1,"buf",3
"2","Mon","September 18","L","","1-1",TRUE,"Denver Broncos",14,28,28,413,319,94,4,26,382,181,201,2,1989-09-18,-2,0,"buf",-14
"3","Sun","September 24","W","OT","2-1",FALSE,"Houston Oilers",47,41,22,449,337,112,1,33,439,311,128,2,1989-09-24,1,1,"buf",6
"4","Sun","October 1","W","","3-1",TRUE,"New England Patriots",31,10,16,371,256,115,1,17,279,155,124,1,1989-10-01,0,1,"buf",21
"5","Sun","October 8","L","","3-2",FALSE,"Indianapolis Colts",14,37,25,424,353,71,6,20,330,177,153,1,1989-10-08,-5,0,"buf",-23
"6","Mon","October 16","W","","4-2",TRUE,"Los Angeles Rams",23,20,17,348,214,134,4,15,266,207,59,2,1989-10-16,-2,1,"buf",3
"7","Sun","October 22","W","","5-2",TRUE,"New York Jets",34,3,22,343,139,204,0,9,154,115,39,3,1989-10-22,3,1,"buf",31
"8","Sun","October 29","W","","6-2",TRUE,"Miami Dolphins",31,17,18,394,114,280,1,19,413,348,65,3,1989-10-29,2,1,"buf",14
"9","Sun","November 5","L","","6-3",FALSE,"Atlanta Falcons",28,30,19,329,211,118,2,20,340,213,127,0,1989-11-05,-2,0,"buf",-2
"10","Sun","November 12","W","","7-3",TRUE,"Indianapolis Colts",30,7,26,393,161,232,0,13,189,103,86,3,1989-11-12,3,1,"buf",23
"11","Sun","November 19","L","","7-4",FALSE,"New England Patriots",24,33,24,424,340,84,6,19,359,167,192,4,1989-11-19,-2,0,"buf",-9
"12","Sun","November 26","W","","8-4",TRUE,"Cincinnati Bengals",24,7,18,345,117,228,2,16,298,133,165,3,1989-11-26,1,1,"buf",17
"13","Mon","December 4","L","","8-5",FALSE,"Seattle Seahawks",16,17,11,232,135,97,2,22,355,277,78,2,1989-12-04,0,0,"buf",-1
"14","Sun","December 10","L","","8-6",TRUE,"New Orleans Saints",19,22,16,279,204,75,4,21,436,286,150,2,1989-12-10,-2,0,"buf",-3
"15","Sun","December 17","L","","8-7",FALSE,"San Francisco 49ers",10,21,17,301,255,46,5,18,283,132,151,2,1989-12-17,-3,0,"buf",-11
"16","Sat","December 23","W","","9-7",FALSE,"New York Jets",37,0,28,441,208,233,1,11,200,146,54,2,1989-12-23,1,1,"buf",37
"Division","Sat","January 6","L","","9-8",FALSE,"Cleveland Browns",30,34,24,453,404,49,3,18,325,235,90,1,1990-01-06,-2,0,"buf",-4
"1","Sun","September 9","W","","1-0",TRUE,"Indianapolis Colts",26,10,24,383,283,100,1,15,229,173,56,2,1990-09-09,1,1,"buf",16
"2","Sun","September 16","L","","1-1",FALSE,"Miami Dolphins",7,30,12,205,161,44,3,19,305,177,128,1,1990-09-16,-2,0,"buf",-23
"3","Mon","September 24","W","","2-1",FALSE,"New York Jets",30,7,23,451,159,292,1,17,249,125,124,2,1990-09-24,1,1,"buf",23
"4","Sun","September 30","W","","3-1",TRUE,"Denver Broncos",29,28,15,197,133,64,3,28,410,202,208,5,1990-09-30,2,1,"buf",1
"5","Sun","October 7","W","","4-1",TRUE,"Los Angeles Raiders",38,24,14,280,182,98,2,22,347,225,122,4,1990-10-07,2,1,"buf",14
"7","Sun","October 21","W","","5-1",TRUE,"New York Jets",30,27,24,405,276,129,1,23,342,192,150,1,1990-10-21,0,1,"buf",3
"8","Sun","October 28","W","","6-1",FALSE,"New England Patriots",27,10,19,353,192,161,0,17,262,154,108,3,1990-10-28,3,1,"buf",17
"9","Sun","November 4","W","","7-1",FALSE,"Cleveland Browns",42,0,24,310,208,102,0,10,234,191,43,2,1990-11-04,2,1,"buf",42
"10","Sun","November 11","W","","8-1",TRUE,"Phoenix Cardinals",45,14,20,360,154,206,2,11,127,46,81,4,1990-11-11,2,1,"buf",31
"11","Sun","November 18","W","","9-1",TRUE,"New England Patriots",14,0,14,276,67,209,0,18,286,196,90,2,1990-11-18,2,1,"buf",14
"12","Mon","November 26","L","","9-2",FALSE,"Houston Oilers",24,27,24,289,210,79,1,21,411,283,128,1,1990-11-26,0,0,"buf",-3
"13","Sun","December 2","W","","10-2",TRUE,"Philadelphia Eagles",30,23,13,393,334,59,1,19,357,181,176,2,1990-12-02,1,1,"buf",7
"14","Sun","December 9","W","","11-2",FALSE,"Indianapolis Colts",31,7,23,408,247,161,1,12,127,52,75,3,1990-12-09,2,1,"buf",24
"15","Sat","December 15","W","","12-2",FALSE,"New York Giants",17,13,13,264,199,65,0,20,313,156,157,0,1990-12-15,0,1,"buf",4
"16","Sun","December 23","W","","13-2",TRUE,"Miami Dolphins",24,14,25,429,223,206,1,20,309,274,35,2,1990-12-23,1,1,"buf",10
"17","Sun","December 30","L","","13-3",FALSE,"Washington Redskins",14,29,15,273,168,105,4,16,299,172,127,1,1990-12-30,-3,0,"buf",-15
"Division","Sat","January 12","W","","14-3",TRUE,"Miami Dolphins",44,34,24,493,339,154,2,24,430,323,107,3,1991-01-12,1,1,"buf",10
"ConfChamp","Sun","January 20","W","","15-3",TRUE,"Los Angeles Raiders",51,3,30,502,300,202,1,21,320,169,151,7,1991-01-20,6,1,"buf",48
"SuperBowl","Sun","January 27","L","","15-4",TRUE,"New York Giants",19,20,18,371,205,166,0,24,386,214,172,0,1991-01-27,0,0,"buf",-1
"1","Sun","September 1","W","","1-0",TRUE,"Miami Dolphins",35,31,33,582,397,185,2,23,396,250,146,1,1991-09-01,-1,1,"buf",4
"2","Sun","September 8","W","","2-0",TRUE,"Pittsburgh Steelers",52,34,31,537,343,194,3,14,265,113,152,1,1991-09-08,-2,1,"buf",18
"3","Sun","September 15","W","","3-0",FALSE,"New York Jets",23,20,22,304,240,64,2,25,388,220,168,2,1991-09-15,0,1,"buf",3
"4","Sun","September 22","W","","4-0",FALSE,"Tampa Bay Buccaneers",17,10,19,421,301,120,2,22,303,165,138,1,1991-09-22,-1,1,"buf",7
"5","Sun","September 29","W","","5-0",TRUE,"Chicago Bears",35,20,22,422,280,142,1,20,353,269,84,1,1991-09-29,0,1,"buf",15
"6","Mon","October 7","L","","5-1",FALSE,"Kansas City Chiefs",6,33,11,211,146,65,5,26,389,150,239,2,1991-10-07,-3,0,"buf",-27
"7","Sun","October 13","W","","6-1",TRUE,"Indianapolis Colts",42,6,23,396,120,276,2,20,240,174,66,3,1991-10-13,1,1,"buf",36
"8","Mon","October 21","W","","7-1",TRUE,"Cincinnati Bengals",35,16,19,487,392,95,3,24,411,224,187,2,1991-10-21,-1,1,"buf",19
"10","Sun","November 3","W","","8-1",TRUE,"New England Patriots",22,17,20,388,235,153,4,17,265,143,122,3,1991-11-03,-1,1,"buf",5
"11","Sun","November 10","W","","9-1",FALSE,"Green Bay Packers",34,24,27,370,223,147,0,23,381,297,84,2,1991-11-10,2,1,"buf",10
"12","Mon","November 18","W","","10-1",FALSE,"Miami Dolphins",41,27,27,433,171,262,0,25,392,317,75,5,1991-11-18,5,1,"buf",14
"13","Sun","November 24","L","","10-2",FALSE,"New England Patriots",13,16,20,308,168,140,5,18,312,230,82,2,1991-11-24,-3,0,"buf",-3
"14","Sun","December 1","W","","11-2",TRUE,"New York Jets",24,13,24,394,242,152,4,20,293,172,121,3,1991-12-01,-1,1,"buf",11
"15","Sun","December 8","W","OT","12-2",FALSE,"Los Angeles Raiders",30,27,25,409,330,79,1,18,386,250,136,3,1991-12-08,2,1,"buf",3
"16","Sun","December 15","W","","13-2",FALSE,"Indianapolis Colts",35,7,22,315,159,156,0,18,328,195,133,3,1991-12-15,3,1,"buf",28
"17","Sun","December 22","L","OT","13-3",TRUE,"Detroit Lions",14,17,14,275,124,151,1,22,356,245,111,3,1991-12-22,2,0,"buf",-3
"Division","Sun","January 5","W","","14-3",TRUE,"Kansas City Chiefs",37,14,29,448,268,180,3,14,213,136,77,4,1992-01-05,1,1,"buf",23
"ConfChamp","Sun","January 12","W","","15-3",TRUE,"Denver Broncos",10,7,12,213,109,104,2,20,304,223,81,2,1992-01-12,0,1,"buf",3
"SuperBowl","Sun","January 26","L","","15-4",TRUE,"Washington Redskins",24,37,25,283,240,43,5,24,417,292,125,1,1992-01-26,-4,0,"buf",-13
"1","Sun","September 6","W","","1-0",TRUE,"Los Angeles Rams",40,7,23,363,156,207,1,15,215,149,66,4,1992-09-06,3,1,"buf",33
"2","Sun","September 13","W","","2-0",FALSE,"San Francisco 49ers",34,31,25,488,381,107,3,26,598,439,159,3,1992-09-13,0,1,"buf",3
"3","Sun","September 20","W","","3-0",TRUE,"Indianapolis Colts",38,0,24,380,211,169,2,9,140,103,37,3,1992-09-20,1,1,"buf",38
"4","Sun","September 27","W","","4-0",FALSE,"New England Patriots",41,7,23,490,308,182,1,16,265,196,69,3,1992-09-27,2,1,"buf",34
"5","Sun","October 4","L","","4-1",TRUE,"Miami Dolphins",10,37,26,400,337,63,5,20,362,282,80,1,1992-10-04,-4,0,"buf",-27
"6","Sun","October 11","L","","4-2",FALSE,"Los Angeles Raiders",3,20,22,350,258,92,2,16,248,156,92,2,1992-10-11,0,0,"buf",-17
"8","Mon","October 26","W","","5-2",FALSE,"New York Jets",24,20,21,373,208,165,2,22,326,184,142,2,1992-10-26,0,1,"buf",4
"9","Sun","November 1","W","","6-2",TRUE,"New England Patriots",16,7,20,288,199,89,3,14,196,127,69,3,1992-11-01,0,1,"buf",9
"10","Sun","November 8","W","","7-2",TRUE,"Pittsburgh Steelers",28,20,31,458,284,174,2,17,233,146,87,0,1992-11-08,-2,1,"buf",8
"11","Mon","November 16","W","","8-2",FALSE,"Miami Dolphins",26,20,26,323,212,111,0,20,350,286,64,2,1992-11-16,2,1,"buf",6
"12","Sun","November 22","W","","9-2",TRUE,"Atlanta Falcons",41,14,19,412,97,315,1,11,174,128,46,1,1992-11-22,0,1,"buf",27
"13","Sun","November 29","L","OT","9-3",FALSE,"Indianapolis Colts",13,16,16,312,176,136,2,22,412,305,107,1,1992-11-29,-1,0,"buf",-3
"14","Sun","December 6","L","","9-4",TRUE,"New York Jets",17,24,21,351,204,147,4,17,275,151,124,1,1992-12-06,-3,0,"buf",-7
"15","Sat","December 12","W","","10-4",TRUE,"Denver Broncos",27,17,17,361,210,151,4,24,320,222,98,5,1992-12-12,1,1,"buf",10
"16","Sun","December 20","W","","11-4",FALSE,"New Orleans Saints",20,16,19,307,126,181,2,12,205,157,48,3,1992-12-20,1,1,"buf",4
"17","Sun","December 27","L","","11-5",FALSE,"Houston Oilers",3,27,17,237,90,147,4,17,285,178,107,1,1992-12-27,-3,0,"buf",-24
"WildCard","Sun","January 3","W","OT","12-5",TRUE,"Houston Oilers",41,38,19,366,268,98,1,27,429,347,82,2,1993-01-03,1,1,"buf",3
"Division","Sat","January 9","W","","13-5",FALSE,"Pittsburgh Steelers",24,3,19,325,156,169,0,18,240,111,129,3,1993-01-09,3,1,"buf",21
"ConfChamp","Sun","January 17","W","","14-5",FALSE,"Miami Dolphins",29,10,20,358,176,182,2,15,276,243,33,5,1993-01-17,3,1,"buf",19
"SuperBowl","Sun","January 31","L","","14-6",TRUE,"Dallas Cowboys",17,52,22,362,254,108,9,20,408,271,137,1,1993-01-31,-8,0,"buf",-35
"1","Sun","September 5","W","","1-0",TRUE,"New England Patriots",38,14,20,334,157,177,1,15,268,135,133,3,1993-09-05,2,1,"buf",24
"2","Sun","September 12","W","","2-0",FALSE,"Dallas Cowboys",13,10,16,229,129,100,2,23,393,290,103,4,1993-09-12,2,1,"buf",3
"4","Sun","September 26","L","","2-1",TRUE,"Miami Dolphins",13,22,16,282,176,106,2,23,412,275,137,2,1993-09-26,0,0,"buf",-9
"5","Sun","October 3","W","","3-1",TRUE,"New York Giants",17,14,17,251,112,139,2,19,299,153,146,4,1993-10-03,2,1,"buf",3
"6","Mon","October 11","W","","4-1",TRUE,"Houston Oilers",35,7,23,382,241,141,1,18,329,245,84,7,1993-10-11,6,1,"buf",28
"8","Sun","October 24","W","","5-1",FALSE,"New York Jets",19,10,27,413,216,197,3,15,237,159,78,4,1993-10-24,1,1,"buf",9
"9","Mon","November 1","W","","6-1",TRUE,"Washington Redskins",24,10,22,402,238,164,2,21,309,169,140,4,1993-11-01,2,1,"buf",14
"10","Sun","November 7","W","OT","7-1",FALSE,"New England Patriots",13,10,25,432,298,134,3,17,284,97,187,1,1993-11-07,-2,1,"buf",3
"11","Mon","November 15","L","","7-2",FALSE,"Pittsburgh Steelers",0,23,9,157,110,47,1,26,400,173,227,0,1993-11-15,-1,0,"buf",-23
"12","Sun","November 21","W","","8-2",TRUE,"Indianapolis Colts",23,9,21,403,268,135,2,21,365,252,113,2,1993-11-21,0,1,"buf",14
"13","Sun","November 28","L","","8-3",FALSE,"Kansas City Chiefs",7,23,17,256,213,43,4,19,314,208,106,2,1993-11-28,-2,0,"buf",-16
"14","Sun","December 5","L","","8-4",TRUE,"Los Angeles Raiders",24,25,19,367,276,91,2,25,399,261,138,0,1993-12-05,-2,0,"buf",-1
"15","Sun","December 12","W","","9-4",FALSE,"Philadelphia Eagles",10,7,19,335,234,101,4,21,368,298,70,4,1993-12-12,0,1,"buf",3
"16","Sun","December 19","W","","10-4",FALSE,"Miami Dolphins",47,34,28,374,245,129,2,24,423,400,23,5,1993-12-19,3,1,"buf",13
"17","Sun","December 26","W","","11-4",TRUE,"New York Jets",16,14,19,346,256,90,3,19,352,232,120,1,1993-12-26,-2,1,"buf",2
"18","Sun","January 2","W","","12-4",FALSE,"Indianapolis Colts",30,10,19,297,148,149,1,25,402,286,116,4,1994-01-02,3,1,"buf",20
"Division","Sat","January 15","W","","13-4",TRUE,"Los Angeles Raiders",29,23,25,355,280,75,1,15,325,215,110,1,1994-01-15,0,1,"buf",6
"ConfChamp","Sun","January 23","W","","14-4",TRUE,"Kansas City Chiefs",30,13,30,389,160,229,1,22,338,286,52,2,1994-01-23,1,1,"buf",17
"SuperBowl","Sun","January 30","L","","14-5",TRUE,"Dallas Cowboys",13,30,22,314,227,87,3,20,341,204,137,1,1994-01-30,-2,0,"buf",-17
"1","Sun","September 4","L","","0-1",TRUE,"New York Jets",3,23,13,209,166,43,3,17,330,214,116,1,1994-09-04,-2,0,"buf",-20
"2","Sun","September 11","W","","1-1",FALSE,"New England Patriots",38,35,25,466,322,144,4,26,467,371,96,5,1994-09-11,1,1,"buf",3
"3","Sun","September 18","W","","2-1",FALSE,"Houston Oilers",15,7,17,298,183,115,1,13,256,159,97,3,1994-09-18,2,1,"buf",8
"4","Mon","September 26","W","","3-1",TRUE,"Denver Broncos",27,20,19,315,166,149,1,21,337,260,77,2,1994-09-26,1,1,"buf",7
"5","Sun","October 2","L","","3-2",FALSE,"Chicago Bears",13,20,13,204,99,105,3,17,261,150,111,1,1994-10-02,-2,0,"buf",-7
"6","Sun","October 9","W","","4-2",TRUE,"Miami Dolphins",21,11,25,344,130,214,2,19,326,212,114,1,1994-10-09,-1,1,"buf",10
"7","Sun","October 16","L","","4-3",TRUE,"Indianapolis Colts",17,27,22,329,250,79,2,20,325,231,94,0,1994-10-16,-2,0,"buf",-10
"9","Sun","October 30","W","","5-3",TRUE,"Kansas City Chiefs",44,10,17,357,180,177,0,16,266,179,87,5,1994-10-30,5,1,"buf",34
"10","Sun","November 6","L","","5-4",FALSE,"New York Jets",17,22,18,282,187,95,2,17,268,174,94,1,1994-11-06,-1,0,"buf",-5
"11","Mon","November 14","L","","5-5",FALSE,"Pittsburgh Steelers",10,23,24,326,198,128,3,10,226,140,86,1,1994-11-14,-2,0,"buf",-13
"12","Sun","November 20","W","","6-5",TRUE,"Green Bay Packers",29,20,27,455,347,108,1,18,266,205,61,1,1994-11-20,0,1,"buf",9
"13","Thu","November 24","L","","6-6",FALSE,"Detroit Lions",21,35,25,367,246,121,2,20,388,341,47,0,1994-11-24,-2,0,"buf",-14
"14","Sun","December 4","W","","7-6",FALSE,"Miami Dolphins",42,31,19,398,322,76,2,25,460,387,73,4,1994-12-04,2,1,"buf",11
"15","Sun","December 11","L","","7-7",TRUE,"Minnesota Vikings",17,21,19,268,183,85,1,20,377,261,116,1,1994-12-11,0,0,"buf",-4
"16","Sun","December 18","L","","7-8",TRUE,"New England Patriots",17,41,16,326,191,135,5,22,377,276,101,0,1994-12-18,-5,0,"buf",-24
"17","Sat","December 24","L","","7-9",FALSE,"Indianapolis Colts",9,10,20,300,243,57,2,13,245,100,145,2,1994-12-24,0,0,"buf",-1
"1","Sun","September 3","L","","0-1",FALSE,"Denver Broncos",7,22,14,234,174,60,0,24,439,299,140,1,1995-09-03,1,0,"buf",-15
"2","Sun","September 10","W","","1-1",TRUE,"Carolina Panthers",31,9,16,348,176,172,3,6,113,12,101,1,1995-09-10,-2,1,"buf",22
"3","Sun","September 17","W","","2-1",TRUE,"Indianapolis Colts",20,14,17,261,201,60,1,17,296,205,91,1,1995-09-17,0,1,"buf",6
"5","Mon","October 2","W","","3-1",FALSE,"Cleveland Browns",22,19,23,406,246,160,2,16,294,204,90,1,1995-10-02,-1,1,"buf",3
"6","Sun","October 8","W","","4-1",TRUE,"New York Jets",29,10,22,318,98,220,2,14,173,122,51,4,1995-10-08,2,1,"buf",19
"7","Sun","October 15","W","","5-1",TRUE,"Seattle Seahawks",27,21,23,374,259,115,0,16,268,190,78,4,1995-10-15,4,1,"buf",6
"8","Mon","October 23","L","","5-2",FALSE,"New England Patriots",14,27,14,301,186,115,3,24,423,262,161,1,1995-10-23,-2,0,"buf",-13
"9","Sun","October 29","L","","5-3",FALSE,"Miami Dolphins",6,23,11,186,139,47,0,21,362,214,148,0,1995-10-29,0,0,"buf",-17
"10","Sun","November 5","W","","6-3",FALSE,"Indianapolis Colts",16,10,12,324,244,80,0,16,319,219,100,3,1995-11-05,3,1,"buf",6
"11","Sun","November 12","W","","7-3",TRUE,"Atlanta Falcons",23,17,27,415,261,154,2,18,319,252,67,2,1995-11-12,0,1,"buf",6
"12","Sun","November 19","W","","8-3",FALSE,"New York Jets",28,26,20,373,285,88,1,17,351,277,74,3,1995-11-19,2,1,"buf",2
"13","Sun","November 26","L","","8-4",TRUE,"New England Patriots",25,35,19,334,202,132,3,26,430,257,173,3,1995-11-26,0,0,"buf",-10
"14","Sun","December 3","L","","8-5",FALSE,"San Francisco 49ers",17,27,15,275,191,84,5,18,323,221,102,1,1995-12-03,-4,0,"buf",-10
"15","Sun","December 10","W","","9-5",FALSE,"St. Louis Rams",45,27,28,454,232,222,1,27,450,377,73,1,1995-12-10,0,1,"buf",18
"16","Sun","December 17","W","","10-5",TRUE,"Miami Dolphins",23,20,24,342,134,208,2,12,269,227,42,1,1995-12-17,-1,1,"buf",3
"17","Sun","December 24","L","","10-6",TRUE,"Houston Oilers",17,28,15,172,96,76,1,15,299,164,135,1,1995-12-24,0,0,"buf",-11
"WildCard","Sat","December 30","W","","11-6",TRUE,"Miami Dolphins",37,22,27,536,195,341,2,26,502,432,70,4,1995-12-30,2,1,"buf",15
"Division","Sat","January 6","L","","11-7",FALSE,"Pittsburgh Steelers",21,40,18,250,156,94,4,23,409,262,147,2,1996-01-06,-2,0,"buf",-19
"1","Sun","September 1","W","OT","1-0",FALSE,"New York Giants",23,20,25,410,257,153,2,12,231,138,93,1,1996-09-01,-1,1,"buf",3
"2","Sun","September 8","W","","2-0",TRUE,"New England Patriots",17,10,15,231,154,77,3,23,293,179,114,2,1996-09-08,-1,1,"buf",7
"3","Mon","September 16","L","","2-1",FALSE,"Pittsburgh Steelers",6,24,11,185,99,86,4,22,382,160,222,1,1996-09-16,-3,0,"buf",-18
"4","Sun","September 22","W","","3-1",TRUE,"Dallas Cowboys",10,7,14,224,89,135,2,12,192,160,32,4,1996-09-22,2,1,"buf",3
"6","Sun","October 6","W","OT","4-1",TRUE,"Indianapolis Colts",16,13,20,412,299,113,1,16,249,163,86,0,1996-10-06,-1,1,"buf",3
"7","Sun","October 13","L","","4-2",TRUE,"Miami Dolphins",7,21,17,296,191,105,4,15,239,176,63,0,1996-10-13,-4,0,"buf",-14
"8","Sun","October 20","W","","5-2",FALSE,"New York Jets",25,22,23,333,195,138,1,19,317,253,64,4,1996-10-20,3,1,"buf",3
"9","Sun","October 27","L","","5-3",FALSE,"New England Patriots",25,28,18,337,196,141,1,23,417,358,59,1,1996-10-27,0,0,"buf",-3
"10","Sun","November 3","W","","6-3",TRUE,"Washington Redskins",38,13,31,476,210,266,0,16,234,159,75,2,1996-11-03,2,1,"buf",25
"11","Sun","November 10","W","","7-3",FALSE,"Philadelphia Eagles",24,17,18,252,112,140,2,25,385,274,111,1,1996-11-10,-1,1,"buf",7
"12","Sun","November 17","W","","8-3",TRUE,"Cincinnati Bengals",31,17,23,308,174,134,2,13,224,105,119,4,1996-11-17,2,1,"buf",14
"13","Sun","November 24","W","","9-3",TRUE,"New York Jets",35,10,17,348,267,81,2,22,341,229,112,5,1996-11-24,3,1,"buf",25
"14","Sun","December 1","L","OT","9-4",FALSE,"Indianapolis Colts",10,13,11,307,183,124,3,18,288,203,85,0,1996-12-01,-3,0,"buf",-3
"15","Sun","December 8","L","","9-5",FALSE,"Seattle Seahawks",18,26,21,391,312,79,5,10,302,132,170,0,1996-12-08,-5,0,"buf",-8
"16","Mon","December 16","L","","9-6",FALSE,"Miami Dolphins",14,16,15,274,223,51,2,22,394,249,145,0,1996-12-16,-2,0,"buf",-2
"17","Sun","December 22","W","","10-6",TRUE,"Kansas City Chiefs",20,9,15,335,257,78,3,15,249,130,119,3,1996-12-22,0,1,"buf",11
"WildCard","Sat","December 28","L","","10-7",TRUE,"Jacksonville Jaguars",27,30,19,308,216,92,3,18,409,225,184,2,1996-12-28,-1,0,"buf",-3
"1","Sun","August 31","L","","0-1",TRUE,"Minnesota Vikings",13,34,22,426,279,147,4,17,385,200,185,1,1997-08-31,-3,0,"buf",-21
"2","Sun","September 7","W","","1-1",FALSE,"New York Jets",28,22,15,269,193,76,3,12,202,163,39,2,1997-09-07,-1,1,"buf",6
"3","Sun","September 14","L","","1-2",FALSE,"Kansas City Chiefs",16,22,16,325,275,50,2,17,267,160,107,0,1997-09-14,-2,0,"buf",-6
"4","Sun","September 21","W","","2-2",TRUE,"Indianapolis Colts",37,35,25,393,230,163,5,17,322,198,124,1,1997-09-21,-4,1,"buf",2
"6","Sun","October 5","W","","3-2",TRUE,"Detroit Lions",22,13,10,266,102,164,0,17,309,189,120,1,1997-10-05,1,1,"buf",9
"7","Sun","October 12","L","","3-3",FALSE,"New England Patriots",6,33,13,242,148,94,4,19,310,171,139,1,1997-10-12,-3,0,"buf",-27
"8","Mon","October 20","W","","4-3",FALSE,"Indianapolis Colts",9,6,16,246,156,90,0,15,238,144,94,0,1997-10-20,0,1,"buf",3
"9","Sun","October 26","L","OT","4-4",TRUE,"Denver Broncos",20,23,19,315,160,155,6,17,341,116,225,3,1997-10-26,-3,0,"buf",-3
"10","Sun","November 2","W","","5-4",TRUE,"Miami Dolphins",9,6,17,265,86,179,1,13,230,176,54,2,1997-11-02,1,1,"buf",3
"11","Sun","November 9","L","","5-5",TRUE,"New England Patriots",10,31,14,241,119,122,4,11,267,164,103,0,1997-11-09,-4,0,"buf",-21
"12","Mon","November 17","L","","5-6",FALSE,"Miami Dolphins",13,30,15,223,131,92,2,16,314,218,96,2,1997-11-17,0,0,"buf",-17
"13","Sun","November 23","L","","5-7",FALSE,"Tennessee Oilers",14,31,12,290,286,4,2,21,322,159,163,1,1997-11-23,-1,0,"buf",-17
"14","Sun","November 30","W","","6-7",TRUE,"New York Jets",20,10,19,336,139,197,1,16,294,264,30,2,1997-11-30,1,1,"buf",10
"15","Sun","December 7","L","","6-8",FALSE,"Chicago Bears",3,20,10,160,105,55,1,23,392,272,120,2,1997-12-07,1,0,"buf",-17
"16","Sun","December 14","L","","6-9",TRUE,"Jacksonville Jaguars",14,20,24,335,192,143,3,20,388,297,91,1,1997-12-14,-2,0,"buf",-6
"17","Sat","December 20","L","","6-10",FALSE,"Green Bay Packers",21,31,21,325,274,51,4,14,272,170,102,3,1997-12-20,-1,0,"buf",-10
"1","Sun","September 6","L","","0-1",FALSE,"San Diego Chargers",14,16,20,297,207,90,2,14,254,187,67,2,1998-09-06,0,0,"buf",-2
"2","Sun","September 13","L","","0-2",FALSE,"Miami Dolphins",7,13,12,187,77,110,1,12,259,143,116,0,1998-09-13,-1,0,"buf",-6
"3","Sun","September 20","L","","0-3",TRUE,"St. Louis Rams",33,34,23,407,192,215,2,21,406,225,181,4,1998-09-20,2,0,"buf",-1
"5","Sun","October 4","W","","1-3",TRUE,"San Francisco 49ers",26,21,21,352,237,115,0,23,377,312,65,4,1998-10-04,4,1,"buf",5
"6","Sun","October 11","W","","2-3",FALSE,"Indianapolis Colts",31,24,24,381,205,176,0,21,341,235,106,2,1998-10-11,2,1,"buf",7
"7","Sun","October 18","W","","3-3",TRUE,"Jacksonville Jaguars",17,16,22,337,227,110,1,16,238,104,134,0,1998-10-18,-1,1,"buf",1
"8","Sun","October 25","W","","4-3",FALSE,"Carolina Panthers",30,14,18,426,282,144,1,21,360,279,81,3,1998-10-25,2,1,"buf",16
"9","Sun","November 1","W","","5-3",TRUE,"Miami Dolphins",30,24,16,313,197,116,2,15,296,168,128,1,1998-11-01,-1,1,"buf",6
"10","Sun","November 8","L","","5-4",FALSE,"New York Jets",12,34,11,182,134,48,2,23,398,277,121,3,1998-11-08,1,0,"buf",-22
"11","Sun","November 15","W","","6-4",TRUE,"New England Patriots",13,10,23,391,178,213,3,11,206,158,48,0,1998-11-15,-3,1,"buf",3
"12","Sun","November 22","W","","7-4",TRUE,"Indianapolis Colts",34,11,25,402,215,187,1,14,250,164,86,3,1998-11-22,2,1,"buf",23
"13","Sun","November 29","L","","7-5",FALSE,"New England Patriots",21,25,23,428,329,99,0,24,259,215,44,1,1998-11-29,1,0,"buf",-4
"14","Sun","December 6","W","","8-5",FALSE,"Cincinnati Bengals",33,20,21,448,309,139,3,15,234,176,58,1,1998-12-06,-2,1,"buf",13
"15","Sun","December 13","W","","9-5",TRUE,"Oakland Raiders",44,21,18,316,182,134,0,13,178,87,91,4,1998-12-13,4,1,"buf",23
"16","Sat","December 19","L","","9-6",TRUE,"New York Jets",10,17,21,366,217,149,2,14,269,177,92,0,1998-12-19,-2,0,"buf",-7
"17","Sun","December 27","W","","10-6",FALSE,"New Orleans Saints",45,33,21,308,192,116,0,26,366,291,75,3,1998-12-27,3,1,"buf",12
"WildCard","Sat","January 2","L","","10-7",FALSE,"Miami Dolphins",17,24,23,416,339,77,5,25,345,228,117,1,1999-01-02,-4,0,"buf",-7
"1","Sun","September 12","L","","0-1",FALSE,"Indianapolis Colts",14,31,19,321,274,47,3,20,393,284,109,3,1999-09-12,0,0,"buf",-17
"2","Sun","September 19","W","","1-1",TRUE,"New York Jets",17,3,23,384,160,224,1,11,190,116,74,0,1999-09-19,-1,1,"buf",14
"3","Sun","September 26","W","","2-1",TRUE,"Philadelphia Eagles",26,0,25,377,186,191,1,11,169,147,22,2,1999-09-26,1,1,"buf",26
"4","Mon","October 4","W","","3-1",FALSE,"Miami Dolphins",23,18,11,250,177,73,1,18,292,233,59,3,1999-10-04,2,1,"buf",5
"5","Sun","October 10","W","","4-1",TRUE,"Pittsburgh Steelers",24,21,24,365,254,111,1,17,255,207,48,1,1999-10-10,0,1,"buf",3
"6","Sun","October 17","L","","4-2",TRUE,"Oakland Raiders",14,20,14,310,201,109,3,23,343,148,195,0,1999-10-17,-3,0,"buf",-6
"7","Sun","October 24","L","","4-3",FALSE,"Seattle Seahawks",16,26,25,352,254,98,3,18,385,275,110,0,1999-10-24,-3,0,"buf",-10
"8","Sun","October 31","W","","5-3",FALSE,"Baltimore Ravens",13,10,19,249,138,111,3,12,200,118,82,2,1999-10-31,-1,1,"buf",3
"9","Sun","November 7","W","","6-3",FALSE,"Washington Redskins",34,17,24,413,209,204,0,16,279,222,57,2,1999-11-07,2,1,"buf",17
"10","Sun","November 14","W","","7-3",TRUE,"Miami Dolphins",23,3,18,334,157,177,0,6,101,41,60,1,1999-11-14,1,1,"buf",20
"11","Sun","November 21","L","","7-4",FALSE,"New York Jets",7,17,14,273,205,68,3,14,208,113,95,0,1999-11-21,-3,0,"buf",-10
"12","Sun","November 28","W","","8-4",TRUE,"New England Patriots",17,7,13,299,207,92,1,17,267,174,93,2,1999-11-28,1,1,"buf",10
"14","Sun","December 12","L","","8-5",TRUE,"New York Giants",17,19,13,237,161,76,2,20,334,240,94,2,1999-12-12,0,0,"buf",-2
"15","Sun","December 19","W","","9-5",FALSE,"Arizona Cardinals",31,21,25,376,217,159,2,14,178,108,70,1,1999-12-19,-1,1,"buf",10
"16","Sun","December 26","W","OT","10-5",FALSE,"New England Patriots",13,10,23,374,206,168,3,14,225,67,158,1,1999-12-26,-2,1,"buf",3
"17","Sun","January 2","W","","11-5",TRUE,"Indianapolis Colts",31,6,23,419,287,132,0,13,226,182,44,1,2000-01-02,1,1,"buf",25
"WildCard","Sat","January 8","L","","11-6",FALSE,"Tennessee Titans",16,22,13,219,96,123,2,16,194,55,139,2,2000-01-08,0,0,"buf",-6
"1","Sun","September 3","W","","1-0",TRUE,"Tennessee Titans",16,13,17,266,137,129,0,9,172,119,53,1,2000-09-03,1,1,"buf",3
"2","Sun","September 10","W","","2-0",TRUE,"Green Bay Packers",27,18,20,309,220,89,1,14,274,234,40,3,2000-09-10,2,1,"buf",9
"3","Sun","September 17","L","","2-1",FALSE,"New York Jets",14,27,16,354,274,80,4,15,279,188,91,1,2000-09-17,-3,0,"buf",-13
"5","Sun","October 1","L","","2-2",TRUE,"Indianapolis Colts",16,18,21,385,215,170,0,14,265,184,81,1,2000-10-01,1,0,"buf",-2
"6","Sun","October 8","L","","2-3",FALSE,"Miami Dolphins",13,22,15,254,178,76,2,15,254,134,120,1,2000-10-08,-1,0,"buf",-9
"7","Sun","October 15","W","OT","3-3",TRUE,"San Diego Chargers",27,24,25,424,329,95,2,15,303,251,52,4,2000-10-15,2,1,"buf",3
"8","Sun","October 22","L","","3-4",FALSE,"Minnesota Vikings",27,31,21,406,286,120,1,17,348,251,97,1,2000-10-22,0,0,"buf",-4
"9","Sun","October 29","W","","4-4",TRUE,"New York Jets",23,20,18,338,252,86,0,19,337,286,51,4,2000-10-29,4,1,"buf",3
"10","Sun","November 5","W","OT","5-4",FALSE,"New England Patriots",16,13,20,315,174,141,1,14,189,100,89,2,2000-11-05,1,1,"buf",3
"11","Sun","November 12","W","","6-4",TRUE,"Chicago Bears",20,3,14,299,194,105,1,12,234,135,99,4,2000-11-12,3,1,"buf",17
"12","Sun","November 19","W","","7-4",FALSE,"Kansas City Chiefs",21,17,21,299,224,75,0,24,378,275,103,2,2000-11-19,2,1,"buf",4
"13","Sun","November 26","L","","7-5",FALSE,"Tampa Bay Buccaneers",17,31,25,433,294,139,2,13,180,66,114,0,2000-11-26,-2,0,"buf",-14
"14","Sun","December 3","L","","7-6",TRUE,"Miami Dolphins",6,33,14,196,36,160,3,15,333,200,133,1,2000-12-03,-2,0,"buf",-27
"15","Mon","December 11","L","","7-7",FALSE,"Indianapolis Colts",20,44,16,294,228,66,3,20,237,116,121,0,2000-12-11,-3,0,"buf",-24
"16","Sun","December 17","L","OT","7-8",TRUE,"New England Patriots",10,13,19,347,169,178,1,19,331,142,189,0,2000-12-17,-1,0,"buf",-3
"17","Sat","December 23","W","","8-8",FALSE,"Seattle Seahawks",42,23,27,579,366,213,2,17,312,186,126,4,2000-12-23,2,1,"buf",19
"1","Sun","September 9","L","","0-1",TRUE,"New Orleans Saints",6,24,12,251,126,125,3,17,301,192,109,0,2001-09-09,-3,0,"buf",-18
"2","Sun","September 23","L","","0-2",FALSE,"Indianapolis Colts",26,42,21,374,229,145,1,28,555,418,137,3,2001-09-23,2,0,"buf",-16
"3","Sun","September 30","L","","0-3",TRUE,"Pittsburgh Steelers",3,20,14,172,120,52,2,16,270,100,170,0,2001-09-30,-2,0,"buf",-17
"4","Sun","October 7","L","","0-4",TRUE,"New York Jets",36,42,26,473,311,162,5,21,335,173,162,0,2001-10-07,-5,0,"buf",-6
"6","Thu","October 18","W","","1-4",FALSE,"Jacksonville Jaguars",13,10,19,317,219,98,0,14,247,132,115,2,2001-10-18,2,1,"buf",3
"7","Sun","October 28","L","","1-5",FALSE,"San Diego Chargers",24,27,22,396,291,105,2,17,338,243,95,0,2001-10-28,-2,0,"buf",-3
"8","Sun","November 4","L","","1-6",TRUE,"Indianapolis Colts",14,30,14,232,148,84,2,17,305,161,144,1,2001-11-04,-1,0,"buf",-16
"9","Sun","November 11","L","","1-7",FALSE,"New England Patriots",11,21,15,242,173,69,2,15,205,71,134,3,2001-11-11,1,0,"buf",-10
"10","Sun","November 18","L","","1-8",TRUE,"Seattle Seahawks",20,23,25,372,303,69,2,16,246,134,112,0,2001-11-18,-2,0,"buf",-3
"11","Sun","November 25","L","","1-9",TRUE,"Miami Dolphins",27,34,21,422,295,127,3,19,362,261,101,1,2001-11-25,-2,0,"buf",-7
"12","Sun","December 2","L","","1-10",FALSE,"San Francisco 49ers",0,35,11,191,162,29,5,26,409,179,230,0,2001-12-02,-5,0,"buf",-35
"13","Sun","December 9","W","","2-10",TRUE,"Carolina Panthers",25,24,18,369,267,102,1,17,231,153,78,2,2001-12-09,1,1,"buf",1
"14","Sun","December 16","L","OT","2-11",TRUE,"New England Patriots",9,12,19,310,212,98,1,17,335,206,129,2,2001-12-16,1,0,"buf",-3
"15","Sun","December 23","L","","2-12",FALSE,"Atlanta Falcons",30,33,15,398,208,190,0,22,489,422,67,2,2001-12-23,2,0,"buf",-3
"16","Sun","December 30","W","","3-12",FALSE,"New York Jets",14,9,19,368,176,192,1,19,375,227,148,3,2001-12-30,2,1,"buf",5
"17","Sun","January 6","L","","3-13",FALSE,"Miami Dolphins",7,34,16,250,211,39,3,21,289,87,202,0,2002-01-06,-3,0,"buf",-27
"1","Sun","September 8","L","OT","0-1",TRUE,"New York Jets",31,37,26,384,242,142,3,18,266,193,73,1,2002-09-08,-2,0,"buf",-6
"2","Sun","September 15","W","OT","1-1",FALSE,"Minnesota Vikings",45,39,26,468,437,31,0,31,449,236,213,3,2002-09-15,3,1,"buf",6
"3","Sun","September 22","L","","1-2",FALSE,"Denver Broncos",23,28,17,291,252,39,1,22,342,179,163,0,2002-09-22,-1,0,"buf",-5
"4","Sun","September 29","W","OT","2-2",TRUE,"Chicago Bears",33,27,26,410,307,103,1,15,240,188,52,0,2002-09-29,-1,1,"buf",6
"5","Sun","October 6","L","","2-3",TRUE,"Oakland Raiders",31,49,29,479,399,80,3,24,495,353,142,0,2002-10-06,-3,0,"buf",-18
"6","Sun","October 13","W","","3-3",FALSE,"Houston Texans",31,24,25,403,230,173,1,18,338,197,141,0,2002-10-13,-1,1,"buf",7
"7","Sun","October 20","W","","4-3",FALSE,"Miami Dolphins",23,10,15,294,162,132,0,17,287,155,132,6,2002-10-20,6,1,"buf",13
"8","Sun","October 27","W","","5-3",TRUE,"Detroit Lions",24,17,23,343,269,74,2,16,282,199,83,1,2002-10-27,-1,1,"buf",7
"9","Sun","November 3","L","","5-4",TRUE,"New England Patriots",7,38,28,331,266,65,1,23,422,263,159,0,2002-11-03,-1,0,"buf",-31
"11","Sun","November 17","L","","5-5",FALSE,"Kansas City Chiefs",16,17,21,344,211,133,1,22,320,192,128,0,2002-11-17,-1,0,"buf",-1
"12","Sun","November 24","L","","5-6",FALSE,"New York Jets",13,31,17,258,170,88,3,22,325,170,155,0,2002-11-24,-3,0,"buf",-18
"13","Sun","December 1","W","","6-6",TRUE,"Miami Dolphins",38,21,21,431,270,161,0,14,300,30,270,3,2002-12-01,3,1,"buf",17
"14","Sun","December 8","L","","6-7",FALSE,"New England Patriots",17,27,24,390,312,78,5,14,275,183,92,0,2002-12-08,-5,0,"buf",-10
"15","Sun","December 15","W","","7-7",TRUE,"San Diego Chargers",20,13,17,256,101,155,1,14,308,192,116,0,2002-12-15,-1,1,"buf",7
"16","Sun","December 22","L","","7-8",FALSE,"Green Bay Packers",0,10,17,185,142,43,6,14,223,104,119,2,2002-12-22,-4,0,"buf",-10
"17","Sun","December 29","W","","8-8",TRUE,"Cincinnati Bengals",27,9,23,324,225,99,3,19,317,233,84,3,2002-12-29,0,1,"buf",18
"1","Sun","September 7","W","","1-0",TRUE,"New England Patriots",31,0,23,322,215,107,2,16,239,134,105,4,2003-09-07,2,1,"buf",31
"2","Sun","September 14","W","","2-0",FALSE,"Jacksonville Jaguars",38,17,20,371,328,43,0,20,287,192,95,0,2003-09-14,0,1,"buf",21
"3","Sun","September 21","L","","2-1",FALSE,"Miami Dolphins",7,17,8,118,77,41,3,23,313,147,166,3,2003-09-21,0,0,"buf",-10
"4","Sun","September 28","L","","2-2",TRUE,"Philadelphia Eagles",13,23,15,308,287,21,1,19,335,159,176,0,2003-09-28,-1,0,"buf",-10
"5","Sun","October 5","W","OT","3-2",TRUE,"Cincinnati Bengals",22,16,17,257,177,80,0,18,279,212,67,2,2003-10-05,2,1,"buf",6
"6","Sun","October 12","L","","3-3",FALSE,"New York Jets",3,30,15,193,140,53,4,13,233,115,118,0,2003-10-12,-4,0,"buf",-27
"7","Sun","October 19","W","","4-3",TRUE,"Washington Redskins",24,7,25,432,236,196,2,8,169,110,59,1,2003-10-19,-1,1,"buf",17
"8","Sun","October 26","L","","4-4",FALSE,"Kansas City Chiefs",5,38,15,266,133,133,7,22,375,275,100,0,2003-10-26,-7,0,"buf",-33
"10","Sun","November 9","L","","4-5",FALSE,"Dallas Cowboys",6,10,15,185,85,100,2,14,236,114,122,0,2003-11-09,-2,0,"buf",-4
"11","Sun","November 16","L","","4-6",TRUE,"Houston Texans",10,12,17,335,153,182,1,12,245,211,34,1,2003-11-16,0,0,"buf",-2
"12","Sun","November 23","L","","4-7",TRUE,"Indianapolis Colts",14,17,16,228,118,110,1,21,326,223,103,1,2003-11-23,0,0,"buf",-3
"13","Sun","November 30","W","","5-7",FALSE,"New York Giants",24,7,23,403,252,151,0,10,222,198,24,1,2003-11-30,1,1,"buf",17
"14","Sun","December 7","W","","6-7",TRUE,"New York Jets",17,6,19,256,53,203,2,14,215,127,88,1,2003-12-07,-1,1,"buf",11
"15","Sun","December 14","L","","6-8",FALSE,"Tennessee Titans",26,28,13,241,152,89,1,23,349,263,86,1,2003-12-14,0,0,"buf",-2
"16","Sun","December 21","L","","6-9",TRUE,"Miami Dolphins",3,20,11,177,104,73,4,11,169,37,132,2,2003-12-21,-2,0,"buf",-17
"17","Sat","December 27","L","","6-10",FALSE,"New England Patriots",0,31,16,256,174,82,4,26,321,190,131,1,2003-12-27,-3,0,"buf",-31
"1","Sun","September 12","L","","0-1",TRUE,"Jacksonville Jaguars",10,13,16,242,147,95,2,14,225,142,83,2,2004-09-12,0,0,"buf",-3
"2","Sun","September 19","L","","0-2",FALSE,"Oakland Raiders",10,13,14,243,176,67,1,12,273,200,73,0,2004-09-19,-1,0,"buf",-3
"4","Sun","October 3","L","","0-3",TRUE,"New England Patriots",17,31,18,337,214,123,2,21,397,298,99,1,2004-10-03,-1,0,"buf",-14
"5","Sun","October 10","L","","0-4",FALSE,"New York Jets",14,16,17,252,172,80,1,24,383,298,85,2,2004-10-10,1,0,"buf",-2
"6","Sun","October 17","W","","1-4",TRUE,"Miami Dolphins",20,13,18,341,204,137,0,14,212,101,111,1,2004-10-17,1,1,"buf",7
"7","Sun","October 24","L","","1-5",FALSE,"Baltimore Ravens",6,20,15,270,185,85,5,12,160,60,100,1,2004-10-24,-4,0,"buf",-14
"8","Sun","October 31","W","","2-5",TRUE,"Arizona Cardinals",38,14,11,209,81,128,0,14,213,85,128,0,2004-10-31,0,1,"buf",24
"9","Sun","November 7","W","","3-5",TRUE,"New York Jets",22,17,19,341,184,157,0,12,282,194,88,2,2004-11-07,2,1,"buf",5
"10","Sun","November 14","L","","3-6",FALSE,"New England Patriots",6,29,8,125,75,50,5,25,428,220,208,1,2004-11-14,-4,0,"buf",-23
"11","Sun","November 21","W","","4-6",TRUE,"St. Louis Rams",37,17,16,294,175,119,1,19,270,235,35,4,2004-11-21,3,1,"buf",20
"12","Sun","November 28","W","","5-6",FALSE,"Seattle Seahawks",38,9,25,434,286,148,3,17,230,175,55,2,2004-11-28,-1,1,"buf",29
"13","Sun","December 5","W","","6-6",FALSE,"Miami Dolphins",42,32,16,362,257,105,1,25,403,297,106,7,2004-12-05,6,1,"buf",10
"14","Sun","December 12","W","","7-6",TRUE,"Cleveland Browns",37,7,22,321,106,215,3,6,26,-3,29,5,2004-12-12,2,1,"buf",30
"15","Sun","December 19","W","","8-6",FALSE,"Cincinnati Bengals",33,17,13,212,169,43,1,16,275,126,149,4,2004-12-19,3,1,"buf",16
"16","Sun","December 26","W","","9-6",FALSE,"San Francisco 49ers",41,7,27,441,215,226,1,12,189,91,98,4,2004-12-26,3,1,"buf",34
"17","Sun","January 2","L","","9-7",TRUE,"Pittsburgh Steelers",24,29,16,267,171,96,3,15,262,105,157,3,2005-01-02,0,0,"buf",-5
"1","Sun","September 11","W","","1-0",TRUE,"Houston Texans",22,7,20,316,164,152,0,12,120,25,95,5,2005-09-11,5,1,"buf",15
"2","Sun","September 18","L","","1-1",FALSE,"Tampa Bay Buccaneers",3,19,8,147,100,47,0,18,318,127,191,0,2005-09-18,0,0,"buf",-16
"3","Sun","September 25","L","","1-2",TRUE,"Atlanta Falcons",16,24,18,208,36,172,2,24,403,167,236,2,2005-09-25,0,0,"buf",-8
"4","Sun","October 2","L","","1-3",FALSE,"New Orleans Saints",7,19,13,208,67,141,2,23,333,166,167,0,2005-10-02,-2,0,"buf",-12
"5","Sun","October 9","W","","2-3",TRUE,"Miami Dolphins",20,14,21,236,137,99,1,16,323,210,113,5,2005-10-09,4,1,"buf",6
"6","Sun","October 16","W","","3-3",TRUE,"New York Jets",27,17,24,341,164,177,2,17,275,126,149,3,2005-10-16,1,1,"buf",10
"7","Sun","October 23","L","","3-4",FALSE,"Oakland Raiders",17,38,15,210,126,84,1,26,416,254,162,1,2005-10-23,0,0,"buf",-21
"8","Sun","October 30","L","","3-5",FALSE,"New England Patriots",16,21,24,394,247,147,2,18,273,180,93,2,2005-10-30,0,0,"buf",-5
"10","Sun","November 13","W","","4-5",TRUE,"Kansas City Chiefs",14,3,9,209,148,61,2,22,316,166,150,4,2005-11-13,2,1,"buf",11
"11","Sun","November 20","L","","4-6",FALSE,"San Diego Chargers",10,48,12,202,137,65,2,28,478,337,141,0,2005-11-20,-2,0,"buf",-38
"12","Sun","November 27","L","","4-7",TRUE,"Carolina Panthers",9,13,14,216,161,55,1,19,295,182,113,1,2005-11-27,0,0,"buf",-4
"13","Sun","December 4","L","","4-8",FALSE,"Miami Dolphins",23,24,16,294,202,92,3,26,434,361,73,2,2005-12-04,-1,0,"buf",-1
"14","Sun","December 11","L","","4-9",TRUE,"New England Patriots",7,35,8,183,169,14,3,32,494,335,159,2,2005-12-11,-1,0,"buf",-28
"15","Sat","December 17","L","","4-10",TRUE,"Denver Broncos",17,28,17,272,197,75,0,27,437,259,178,1,2005-12-17,1,0,"buf",-11
"16","Sat","December 24","W","","5-10",FALSE,"Cincinnati Bengals",37,27,19,355,288,67,1,23,374,270,104,2,2005-12-24,1,1,"buf",10
"17","Sun","January 1","L","","5-11",FALSE,"New York Jets",26,30,21,331,172,159,4,12,207,126,81,0,2006-01-01,-4,0,"buf",-4
"1","Sun","September 10","L","","0-1",FALSE,"New England Patriots",17,19,12,240,141,99,0,19,319,136,183,2,2006-09-10,2,0,"buf",-2
"2","Sun","September 17","W","","1-1",FALSE,"Miami Dolphins",16,6,12,171,66,105,0,15,282,190,92,1,2006-09-17,1,1,"buf",10
"3","Sun","September 24","L","","1-2",TRUE,"New York Jets",20,28,26,475,306,169,3,15,256,182,74,0,2006-09-24,-3,0,"buf",-8
"4","Sun","October 1","W","","2-2",TRUE,"Minnesota Vikings",17,12,20,298,203,95,0,14,330,267,63,2,2006-10-01,2,1,"buf",5
"5","Sun","October 8","L","","2-3",FALSE,"Chicago Bears",7,40,10,145,87,58,5,23,351,195,156,1,2006-10-08,-4,0,"buf",-33
"6","Sun","October 15","L","","2-4",FALSE,"Detroit Lions",17,20,16,242,157,85,3,21,397,262,135,1,2006-10-15,-2,0,"buf",-3
"7","Sun","October 22","L","","2-5",TRUE,"New England Patriots",6,28,12,255,180,75,4,18,265,171,94,0,2006-10-22,-4,0,"buf",-22
"9","Sun","November 5","W","","3-5",TRUE,"Green Bay Packers",24,10,11,184,64,120,0,26,427,280,147,4,2006-11-05,4,1,"buf",14
"10","Sun","November 12","L","","3-6",FALSE,"Indianapolis Colts",16,17,10,162,51,111,0,26,384,236,148,2,2006-11-12,2,0,"buf",-1
"11","Sun","November 19","W","","4-6",FALSE,"Houston Texans",24,21,17,403,333,70,1,20,394,206,188,2,2006-11-19,1,1,"buf",3
"12","Sun","November 26","W","","5-6",TRUE,"Jacksonville Jaguars",27,24,13,241,169,72,1,19,323,116,207,1,2006-11-26,0,1,"buf",3
"13","Sun","December 3","L","","5-7",TRUE,"San Diego Chargers",21,24,16,230,167,63,4,18,335,138,197,2,2006-12-03,-2,0,"buf",-3
"14","Sun","December 10","W","","6-7",FALSE,"New York Jets",31,13,14,318,144,174,1,16,275,143,132,3,2006-12-10,2,1,"buf",18
"15","Sun","December 17","W","","7-7",TRUE,"Miami Dolphins",21,0,13,286,186,100,2,12,212,100,112,2,2006-12-17,0,1,"buf",21
"16","Sun","December 24","L","","7-8",TRUE,"Tennessee Titans",29,30,22,368,251,117,2,18,396,181,215,0,2006-12-24,-2,0,"buf",-1
"17","Sun","December 31","L","","7-9",FALSE,"Baltimore Ravens",7,19,10,253,214,39,3,18,327,216,111,1,2006-12-31,-2,0,"buf",-12
"1","Sun","September 9","L","","0-1",TRUE,"Denver Broncos",14,15,13,184,72,112,1,23,470,299,171,1,2007-09-09,0,0,"buf",-1
"2","Sun","September 16","L","","0-2",FALSE,"Pittsburgh Steelers",3,26,10,223,121,102,0,24,420,236,184,1,2007-09-16,1,0,"buf",-23
"3","Sun","September 23","L","","0-3",FALSE,"New England Patriots",7,38,12,193,83,110,2,27,485,308,177,1,2007-09-23,-1,0,"buf",-31
"4","Sun","September 30","W","","1-3",TRUE,"New York Jets",17,14,19,304,218,86,2,20,347,287,60,2,2007-09-30,0,1,"buf",3
"5","Mon","October 8","L","","1-4",TRUE,"Dallas Cowboys",24,25,14,229,148,81,1,24,385,309,76,6,2007-10-08,5,0,"buf",-1
"7","Sun","October 21","W","","2-4",TRUE,"Baltimore Ravens",19,14,14,242,139,103,1,15,308,181,127,1,2007-10-21,0,1,"buf",5
"8","Sun","October 28","W","","3-4",FALSE,"New York Jets",13,3,19,347,239,108,1,14,254,154,100,3,2007-10-28,2,1,"buf",10
"9","Sun","November 4","W","","4-4",TRUE,"Cincinnati Bengals",33,21,23,479,303,176,1,16,299,271,28,1,2007-11-04,0,1,"buf",12
"10","Sun","November 11","W","","5-4",FALSE,"Miami Dolphins",13,10,15,214,151,63,1,15,269,126,143,0,2007-11-11,-1,1,"buf",3
"11","Sun","November 18","L","","5-5",TRUE,"New England Patriots",10,56,14,229,151,78,2,30,510,383,127,0,2007-11-18,-2,0,"buf",-46
"12","Sun","November 25","L","","5-6",FALSE,"Jacksonville Jaguars",14,36,20,297,203,94,3,21,416,292,124,1,2007-11-25,-2,0,"buf",-22
"13","Sun","December 2","W","","6-6",FALSE,"Washington Redskins",17,16,15,357,257,100,1,22,281,202,79,2,2007-12-02,1,1,"buf",1
"14","Sun","December 9","W","","7-6",TRUE,"Miami Dolphins",38,17,20,389,165,224,1,18,285,220,65,5,2007-12-09,4,1,"buf",21
"15","Sun","December 16","L","","7-7",FALSE,"Cleveland Browns",0,8,11,232,124,108,0,16,304,130,174,0,2007-12-16,0,0,"buf",-8
"16","Sun","December 23","L","","7-8",TRUE,"New York Giants",21,38,16,244,127,117,4,17,383,94,289,4,2007-12-23,0,0,"buf",-17
"17","Sun","December 30","L","","7-9",FALSE,"Philadelphia Eagles",9,17,13,271,133,138,0,20,391,322,69,2,2007-12-30,2,0,"buf",-8
"1","Sun","September 7","W","","1-0",TRUE,"Seattle Seahawks",34,10,13,338,232,106,0,16,252,167,85,2,2008-09-07,2,1,"buf",24
"2","Sun","September 14","W","","2-0",FALSE,"Jacksonville Jaguars",20,16,18,285,210,75,1,18,243,145,98,2,2008-09-14,1,1,"buf",4
"3","Sun","September 21","W","","3-0",TRUE,"Oakland Raiders",24,23,25,378,262,116,3,10,247,149,98,1,2008-09-21,-2,1,"buf",1
"4","Sun","September 28","W","","4-0",FALSE,"St. Louis Rams",31,14,14,277,166,111,1,16,380,213,167,2,2008-09-28,1,1,"buf",17
"5","Sun","October 5","L","","4-1",FALSE,"Arizona Cardinals",17,41,13,287,203,84,4,28,373,250,123,0,2008-10-05,-4,0,"buf",-24
"7","Sun","October 19","W","","5-1",TRUE,"San Diego Chargers",23,14,22,370,261,109,0,15,263,191,72,3,2008-10-19,3,1,"buf",9
"8","Sun","October 26","L","","5-2",FALSE,"Miami Dolphins",16,25,19,339,220,119,4,19,358,306,52,1,2008-10-26,-3,0,"buf",-9
"9","Sun","November 2","L","","5-3",TRUE,"New York Jets",17,26,18,292,262,30,3,16,297,201,96,1,2008-11-02,-2,0,"buf",-9
"10","Sun","November 9","L","","5-4",FALSE,"New England Patriots",10,20,10,168,108,60,2,24,370,226,144,1,2008-11-09,-1,0,"buf",-10
"11","Mon","November 17","L","","5-5",TRUE,"Cleveland Browns",27,29,19,334,148,186,4,18,337,176,161,0,2008-11-17,-4,0,"buf",-2
"12","Sun","November 23","W","","6-5",FALSE,"Kansas City Chiefs",54,31,27,444,273,171,0,21,462,303,159,5,2008-11-23,5,1,"buf",23
"13","Sun","November 30","L","","6-6",TRUE,"San Francisco 49ers",3,10,18,350,194,156,1,12,195,133,62,1,2008-11-30,0,0,"buf",-7
"14","Sun","December 7","L","","6-7",TRUE,"Miami Dolphins",3,16,13,163,79,84,2,18,295,180,115,0,2008-12-07,-2,0,"buf",-13
"15","Sun","December 14","L","","6-8",FALSE,"New York Jets",27,31,23,306,119,187,4,18,372,207,165,2,2008-12-14,-2,0,"buf",-4
"16","Sun","December 21","W","","7-8",FALSE,"Denver Broncos",30,23,20,275,188,87,0,27,532,351,181,2,2008-12-21,2,1,"buf",7
"17","Sun","December 28","L","","7-9",TRUE,"New England Patriots",0,13,15,276,115,161,1,16,241,73,168,0,2008-12-28,-1,0,"buf",-13
"1","Mon","September 14","L","","0-1",FALSE,"New England Patriots",24,25,17,276,186,90,1,28,441,368,73,1,2009-09-14,0,0,"buf",-1
"2","Sun","September 20","W","","1-1",TRUE,"Tampa Bay Buccaneers",33,20,25,438,220,218,2,19,353,296,57,2,2009-09-20,0,1,"buf",13
"3","Sun","September 27","L","","1-2",TRUE,"New Orleans Saints",7,27,13,243,154,89,2,21,378,156,222,1,2009-09-27,-1,0,"buf",-20
"4","Sun","October 4","L","","1-3",FALSE,"Miami Dolphins",10,38,10,206,160,46,3,25,336,86,250,0,2009-10-04,-3,0,"buf",-28
"5","Sun","October 11","L","","1-4",TRUE,"Cleveland Browns",3,6,13,288,143,145,3,9,193,22,171,1,2009-10-11,-2,0,"buf",-3
"6","Sun","October 18","W","OT","2-4",FALSE,"New York Jets",16,13,20,296,154,142,2,15,414,96,318,6,2009-10-18,4,1,"buf",3
"7","Sun","October 25","W","","3-4",FALSE,"Carolina Panthers",20,9,9,167,114,53,0,20,425,309,116,4,2009-10-25,4,1,"buf",11
"8","Sun","November 1","L","","3-5",TRUE,"Houston Texans",10,31,9,204,107,97,2,24,439,257,182,3,2009-11-01,1,0,"buf",-21
"10","Sun","November 15","L","","3-6",FALSE,"Tennessee Titans",17,41,14,296,207,89,2,20,378,210,168,1,2009-11-15,-1,0,"buf",-24
"11","Sun","November 22","L","","3-7",FALSE,"Jacksonville Jaguars",15,18,14,343,290,53,3,19,310,208,102,2,2009-11-22,-1,0,"buf",-3
"12","Sun","November 29","W","","4-7",TRUE,"Miami Dolphins",31,14,20,336,207,129,1,23,325,168,157,4,2009-11-29,3,1,"buf",17
"13","Thu","December 3","L","","4-8",TRUE,"New York Jets",13,19,10,194,71,123,2,17,331,82,249,0,2009-12-03,-2,0,"buf",-6
"14","Sun","December 13","W","","5-8",FALSE,"Kansas City Chiefs",16,10,13,273,73,200,3,16,354,202,152,4,2009-12-13,1,1,"buf",6
"15","Sun","December 20","L","","5-9",TRUE,"New England Patriots",10,17,16,241,136,105,1,19,224,115,109,1,2009-12-20,0,0,"buf",-7
"16","Sun","December 27","L","","5-10",FALSE,"Atlanta Falcons",3,31,11,178,138,40,3,24,391,234,157,0,2009-12-27,-3,0,"buf",-28
"17","Sun","January 3","W","","6-10",TRUE,"Indianapolis Colts",30,7,19,403,155,248,0,11,157,132,25,3,2010-01-03,3,1,"buf",23
"1","Sun","September 12","L","","0-1",TRUE,"Miami Dolphins",10,15,9,166,116,50,0,19,296,164,132,0,2010-09-12,0,0,"buf",-5
"2","Sun","September 19","L","","0-2",FALSE,"Green Bay Packers",7,34,14,186,62,124,2,18,346,255,91,0,2010-09-19,-2,0,"buf",-27
"3","Sun","September 26","L","","0-3",FALSE,"New England Patriots",30,38,19,374,240,134,2,25,445,245,200,1,2010-09-26,-1,0,"buf",-8
"4","Sun","October 3","L","","0-4",TRUE,"New York Jets",14,38,12,223,109,114,2,25,444,171,273,0,2010-10-03,-2,0,"buf",-24
"5","Sun","October 10","L","","0-5",TRUE,"Jacksonville Jaguars",26,36,17,306,196,110,0,21,381,165,216,3,2010-10-10,3,0,"buf",-10
"7","Sun","October 24","L","OT","0-6",FALSE,"Baltimore Ravens",34,37,27,514,382,132,4,21,364,229,135,2,2010-10-24,-2,0,"buf",-3
"8","Sun","October 31","L","OT","0-7",FALSE,"Kansas City Chiefs",10,13,23,328,191,137,1,24,414,140,274,0,2010-10-31,-1,0,"buf",-3
"9","Sun","November 7","L","","0-8",TRUE,"Chicago Bears",19,22,22,340,294,46,3,19,283,178,105,1,2010-11-07,-2,0,"buf",-3
"10","Sun","November 14","W","","1-8",TRUE,"Detroit Lions",14,12,12,288,139,149,1,19,390,314,76,1,2010-11-14,0,1,"buf",2
"11","Sun","November 21","W","","2-8",FALSE,"Cincinnati Bengals",49,31,23,449,308,141,2,26,361,228,133,3,2010-11-21,1,1,"buf",18
"12","Sun","November 28","L","OT","2-9",TRUE,"Pittsburgh Steelers",16,19,19,329,255,74,2,28,426,220,206,1,2010-11-28,-1,0,"buf",-3
"13","Sun","December 5","L","","2-10",FALSE,"Minnesota Vikings",14,38,10,239,155,84,5,22,387,177,210,4,2010-12-05,-1,0,"buf",-24
"14","Sun","December 12","W","","3-10",TRUE,"Cleveland Browns",13,6,19,323,131,192,1,9,187,82,105,3,2010-12-12,2,1,"buf",7
"15","Sun","December 19","W","","4-10",FALSE,"Miami Dolphins",17,14,15,282,211,71,1,22,326,261,65,2,2010-12-19,1,1,"buf",3
"16","Sun","December 26","L","","4-11",TRUE,"New England Patriots",3,34,16,369,244,125,7,20,348,131,217,0,2010-12-26,-7,0,"buf",-31
"17","Sun","January 2","L","","4-12",FALSE,"New York Jets",7,38,6,162,125,37,6,17,388,112,276,1,2011-01-02,-5,0,"buf",-31
"1","Sun","September 11","W","","1-0",FALSE,"Kansas City Chiefs",41,7,23,364,201,163,1,13,213,105,108,3,2011-09-11,2,1,"buf",34
"2","Sun","September 18","W","","2-0",TRUE,"Oakland Raiders",38,35,34,481,258,223,1,26,454,323,131,2,2011-09-18,1,1,"buf",3
"3","Sun","September 25","W","","3-0",TRUE,"New England Patriots",34,31,24,448,369,79,2,30,495,387,108,4,2011-09-25,2,1,"buf",3
"4","Sun","October 2","L","","3-1",FALSE,"Cincinnati Bengals",20,23,12,273,190,83,0,25,458,287,171,2,2011-10-02,2,0,"buf",-3
"5","Sun","October 9","W","","4-1",TRUE,"Philadelphia Eagles",31,24,21,331,188,143,1,24,489,315,174,5,2011-10-09,4,1,"buf",7
"6","Sun","October 16","L","","4-2",FALSE,"New York Giants",24,27,17,374,219,155,2,24,414,292,122,0,2011-10-16,-2,0,"buf",-3
"8","Sun","October 30","W","","5-2",TRUE,"Washington Redskins",23,0,17,390,252,138,2,10,178,152,26,2,2011-10-30,0,1,"buf",23
"9","Sun","November 6","L","","5-3",TRUE,"New York Jets",11,27,14,287,191,96,3,24,348,222,126,2,2011-11-06,-1,0,"buf",-16
"10","Sun","November 13","L","","5-4",FALSE,"Dallas Cowboys",7,44,20,271,136,135,4,24,433,270,163,0,2011-11-13,-4,0,"buf",-37
"11","Sun","November 20","L","","5-5",FALSE,"Miami Dolphins",8,35,14,245,204,41,2,16,242,147,95,0,2011-11-20,-2,0,"buf",-27
"12","Sun","November 27","L","","5-6",FALSE,"New York Jets",24,28,21,336,250,86,0,20,318,180,138,2,2011-11-27,2,0,"buf",-4
"13","Sun","December 4","L","","5-7",TRUE,"Tennessee Titans",17,23,18,386,282,104,2,18,317,130,187,0,2011-12-04,-2,0,"buf",-6
"14","Sun","December 11","L","","5-8",FALSE,"San Diego Chargers",10,37,17,281,185,96,3,23,366,216,150,1,2011-12-11,-2,0,"buf",-27
"15","Sun","December 18","L","","5-9",TRUE,"Miami Dolphins",23,30,21,404,291,113,3,17,448,194,254,3,2011-12-18,0,0,"buf",-7
"16","Sat","December 24","W","","6-9",TRUE,"Denver Broncos",40,14,14,351,191,160,0,18,285,152,133,3,2011-12-24,3,1,"buf",26
"17","Sun","January 1","L","","6-10",FALSE,"New England Patriots",21,49,26,402,296,106,4,28,480,342,138,1,2012-01-01,-3,0,"buf",-28
"1","Sun","September 1","W","","1-0",TRUE,"Oakland Raiders",19,14,21,314,219,95,1,13,238,178,60,2,1996-09-01,1,1,"rav",5
"2","Sun","September 8","L","","1-1",FALSE,"Pittsburgh Steelers",17,31,17,251,154,97,3,26,397,191,206,2,1996-09-08,-1,0,"rav",-14
"3","Sun","September 15","L","","1-2",FALSE,"Houston Oilers",13,29,19,281,208,73,3,19,312,172,140,0,1996-09-15,-3,0,"rav",-16
"5","Sun","September 29","W","","2-2",TRUE,"New Orleans Saints",17,10,16,343,178,165,0,18,298,202,96,0,1996-09-29,0,1,"rav",7
"6","Sun","October 6","L","","2-3",TRUE,"New England Patriots",38,46,28,463,330,133,1,26,364,310,54,0,1996-10-06,-1,0,"rav",-8
"7","Sun","October 13","L","","2-4",FALSE,"Indianapolis Colts",21,26,20,325,213,112,1,15,255,132,123,0,1996-10-13,-1,0,"rav",-5
"8","Sun","October 20","L","","2-5",FALSE,"Denver Broncos",34,45,23,392,317,75,1,26,548,326,222,1,1996-10-20,0,0,"rav",-11
"9","Sun","October 27","W","OT","3-5",TRUE,"St. Louis Rams",37,31,25,478,404,74,4,26,486,324,162,4,1996-10-27,0,1,"rav",6
"10","Sun","November 3","L","","3-6",TRUE,"Cincinnati Bengals",21,24,23,371,279,92,4,33,433,265,168,2,1996-11-03,-2,0,"rav",-3
"11","Sun","November 10","L","","3-7",FALSE,"Jacksonville Jaguars",27,30,24,387,235,152,3,22,418,332,86,2,1996-11-10,-1,0,"rav",-3
"12","Sun","November 17","L","","3-8",FALSE,"San Francisco 49ers",20,38,16,268,159,109,3,22,372,262,110,4,1996-11-17,1,0,"rav",-18
"13","Sun","November 24","L","OT","3-9",TRUE,"Jacksonville Jaguars",25,28,29,460,356,104,2,23,374,292,82,2,1996-11-24,0,0,"rav",-3
"14","Sun","December 1","W","","4-9",TRUE,"Pittsburgh Steelers",31,17,19,372,250,122,1,18,333,214,119,1,1996-12-01,0,1,"rav",14
"15","Sun","December 8","L","","4-10",FALSE,"Cincinnati Bengals",14,21,21,322,199,123,1,25,360,267,93,0,1996-12-08,-1,0,"rav",-7
"16","Sun","December 15","L","","4-11",FALSE,"Carolina Panthers",16,27,17,319,220,99,3,21,350,268,82,2,1996-12-15,-1,0,"rav",-11
"17","Sun","December 22","L","","4-12",TRUE,"Houston Oilers",21,24,20,377,257,120,2,18,351,234,117,0,1996-12-22,-2,0,"rav",-3
"1","Sun","August 31","L","","0-1",TRUE,"Jacksonville Jaguars",27,28,22,373,301,72,3,19,411,303,108,1,1997-08-31,-2,0,"rav",-1
"2","Sun","September 7","W","","1-1",TRUE,"Cincinnati Bengals",23,10,24,412,266,146,3,18,339,283,56,2,1997-09-07,-1,1,"rav",13
"3","Sun","September 14","W","","2-1",FALSE,"New York Giants",24,23,19,273,210,63,1,29,390,269,121,0,1997-09-14,-1,1,"rav",1
"4","Sun","September 21","W","","3-1",FALSE,"Tennessee Oilers",36,10,21,398,309,89,0,18,285,188,97,5,1997-09-21,5,1,"rav",26
"5","Sun","September 28","L","","3-2",FALSE,"San Diego Chargers",17,21,18,328,217,111,3,15,440,352,88,3,1997-09-28,0,0,"rav",-4
"6","Sun","October 5","L","","3-3",TRUE,"Pittsburgh Steelers",34,42,20,332,280,52,5,22,431,217,214,3,1997-10-05,-2,0,"rav",-8
"8","Sun","October 19","L","","3-4",TRUE,"Miami Dolphins",13,24,20,385,331,54,2,24,337,189,148,1,1997-10-19,-1,0,"rav",-11
"9","Sun","October 26","W","","4-4",FALSE,"Washington Redskins",20,17,20,332,133,199,1,16,249,182,67,1,1997-10-26,0,1,"rav",3
"10","Sun","November 2","L","OT","4-5",FALSE,"New York Jets",16,19,23,447,288,159,2,15,225,160,65,0,1997-11-02,-2,0,"rav",-3
"11","Sun","November 9","L","","4-6",FALSE,"Pittsburgh Steelers",0,37,11,172,112,60,7,19,341,198,143,0,1997-11-09,-7,0,"rav",-37
"12","Sun","November 16","T","OT","4-6-1",TRUE,"Philadelphia Eagles",10,10,19,329,125,204,2,18,273,210,63,1,1997-11-16,-1,0,"rav",0
"13","Sun","November 23","L","","4-7-1",TRUE,"Arizona Cardinals",13,16,17,314,185,129,0,15,273,202,71,2,1997-11-23,2,0,"rav",-3
"14","Sun","November 30","L","","4-8-1",FALSE,"Jacksonville Jaguars",27,29,17,221,163,58,0,23,404,313,91,1,1997-11-30,1,0,"rav",-2
"15","Sun","December 7","W","","5-8-1",TRUE,"Seattle Seahawks",31,24,15,374,286,88,3,14,273,170,103,4,1997-12-07,1,1,"rav",7
"16","Sun","December 14","W","","6-8-1",TRUE,"Tennessee Oilers",21,19,11,246,192,54,1,23,390,200,190,4,1997-12-14,3,1,"rav",2
"17","Sun","December 21","L","","6-9-1",FALSE,"Cincinnati Bengals",14,16,15,355,304,51,0,18,302,237,65,0,1997-12-21,0,0,"rav",-2
"1","Sun","September 6","L","","0-1",TRUE,"Pittsburgh Steelers",13,20,17,376,264,112,0,14,271,157,114,3,1998-09-06,3,0,"rav",-7
"2","Sun","September 13","W","","1-1",FALSE,"New York Jets",24,10,16,331,209,122,1,18,276,224,52,3,1998-09-13,2,1,"rav",14
"3","Sun","September 20","L","","1-2",FALSE,"Jacksonville Jaguars",10,24,11,313,232,81,1,21,519,365,154,1,1998-09-20,0,0,"rav",-14
"4","Sun","September 27","W","","2-2",TRUE,"Cincinnati Bengals",31,24,21,408,227,181,1,19,275,143,132,0,1998-09-27,-1,1,"rav",7
"6","Sun","October 11","L","","2-3",TRUE,"Tennessee Oilers",8,12,13,263,227,36,1,16,344,178,166,1,1998-10-11,0,0,"rav",-4
"7","Sun","October 18","L","","2-4",FALSE,"Pittsburgh Steelers",6,16,16,230,134,96,5,13,241,162,79,2,1998-10-18,-3,0,"rav",-10
"8","Sun","October 25","L","","2-5",FALSE,"Green Bay Packers",10,28,11,233,177,56,2,20,328,252,76,2,1998-10-25,0,0,"rav",-18
"9","Sun","November 1","L","","2-6",TRUE,"Jacksonville Jaguars",19,45,22,357,231,126,5,20,364,253,111,1,1998-11-01,-4,0,"rav",-26
"10","Sun","November 8","W","","3-6",TRUE,"Oakland Raiders",13,10,15,213,87,126,1,20,356,245,111,3,1998-11-08,2,1,"rav",3
"11","Sun","November 15","L","","3-7",FALSE,"San Diego Chargers",13,14,8,161,121,40,2,19,203,146,57,1,1998-11-15,-1,0,"rav",-1
"12","Sun","November 22","W","","4-7",FALSE,"Cincinnati Bengals",20,13,18,338,91,247,2,16,242,184,58,2,1998-11-22,0,1,"rav",7
"13","Sun","November 29","W","","5-7",TRUE,"Indianapolis Colts",38,31,18,314,198,116,0,26,540,344,196,1,1998-11-29,1,1,"rav",7
"14","Sun","December 6","L","","5-8",FALSE,"Tennessee Oilers",14,16,10,221,163,58,1,19,291,213,78,1,1998-12-06,0,0,"rav",-2
"15","Sun","December 13","L","","5-9",TRUE,"Minnesota Vikings",28,38,16,267,212,55,6,26,420,332,88,1,1998-12-13,-5,0,"rav",-10
"16","Sun","December 20","L","","5-10",FALSE,"Chicago Bears",3,24,12,178,154,24,1,20,391,202,189,0,1998-12-20,-1,0,"rav",-21
"17","Sun","December 27","W","","6-10",TRUE,"Detroit Lions",19,10,19,295,142,153,1,11,236,192,44,1,1998-12-27,0,1,"rav",9
"1","Sun","September 12","L","","0-1",FALSE,"St. Louis Rams",10,27,13,223,163,60,2,23,343,284,59,3,1999-09-12,1,0,"rav",-17
"2","Sun","September 19","L","","0-2",TRUE,"Pittsburgh Steelers",20,23,16,292,167,125,3,19,270,121,149,0,1999-09-19,-3,0,"rav",-3
"3","Sun","September 26","W","","1-2",TRUE,"Cleveland Browns",17,10,16,334,150,184,3,11,189,89,100,3,1999-09-26,0,1,"rav",7
"4","Sun","October 3","W","OT","2-2",FALSE,"Atlanta Falcons",19,13,17,307,163,144,0,20,298,246,52,3,1999-10-03,3,1,"rav",6
"5","Sun","October 10","L","","2-3",FALSE,"Tennessee Titans",11,14,16,246,178,68,1,16,272,216,56,0,1999-10-10,-1,0,"rav",-3
"7","Thu","October 21","L","","2-4",TRUE,"Kansas City Chiefs",8,35,18,277,172,105,3,12,218,106,112,0,1999-10-21,-3,0,"rav",-27
"8","Sun","October 31","L","","2-5",TRUE,"Buffalo Bills",10,13,12,200,118,82,2,19,249,138,111,3,1999-10-31,1,0,"rav",-3
"9","Sun","November 7","W","","3-5",FALSE,"Cleveland Browns",41,9,20,315,112,203,1,10,170,114,56,2,1999-11-07,1,1,"rav",32
"10","Sun","November 14","L","","3-6",FALSE,"Jacksonville Jaguars",3,6,13,242,154,88,1,9,132,85,47,0,1999-11-14,-1,0,"rav",-3
"11","Sun","November 21","W","","4-6",FALSE,"Cincinnati Bengals",34,31,19,281,225,56,2,20,348,246,102,3,1999-11-21,1,1,"rav",3
"12","Sun","November 28","L","","4-7",TRUE,"Jacksonville Jaguars",23,30,14,280,199,81,3,24,388,328,60,3,1999-11-28,0,0,"rav",-7
"13","Sun","December 5","W","","5-7",TRUE,"Tennessee Titans",41,14,17,448,332,116,1,21,353,288,65,2,1999-12-05,1,1,"rav",27
"14","Sun","December 12","W","","6-7",FALSE,"Pittsburgh Steelers",31,24,12,374,242,132,0,21,352,243,109,1,1999-12-12,1,1,"rav",7
"15","Sun","December 19","W","","7-7",TRUE,"New Orleans Saints",31,8,15,335,274,61,4,8,248,237,11,4,1999-12-19,0,1,"rav",23
"16","Sun","December 26","W","","8-7",TRUE,"Cincinnati Bengals",22,0,18,311,181,130,1,15,241,148,93,3,1999-12-26,2,1,"rav",22
"17","Sun","January 2","L","","8-8",FALSE,"New England Patriots",3,20,23,313,194,119,4,12,151,102,49,1,2000-01-02,-3,0,"rav",-17
"1","Sun","September 3","W","","1-0",FALSE,"Pittsburgh Steelers",16,0,18,336,196,140,0,12,223,193,30,1,2000-09-03,1,1,"rav",16
"2","Sun","September 10","W","","2-0",TRUE,"Jacksonville Jaguars",39,36,17,331,242,89,2,22,421,375,46,4,2000-09-10,2,1,"rav",3
"3","Sun","September 17","L","","2-1",FALSE,"Miami Dolphins",6,19,18,262,144,118,1,15,258,152,106,1,2000-09-17,0,0,"rav",-13
"4","Sun","September 24","W","","3-1",TRUE,"Cincinnati Bengals",37,0,27,391,215,176,1,7,94,90,4,4,2000-09-24,3,1,"rav",37
"5","Sun","October 1","W","","4-1",FALSE,"Cleveland Browns",12,0,22,348,160,188,1,11,230,207,23,4,2000-10-01,3,1,"rav",12
"6","Sun","October 8","W","","5-1",FALSE,"Jacksonville Jaguars",15,10,10,194,138,56,1,22,348,253,95,6,2000-10-08,5,1,"rav",5
"7","Sun","October 15","L","","5-2",FALSE,"Washington Redskins",3,10,15,199,108,91,1,15,246,145,101,2,2000-10-15,1,0,"rav",-7
"8","Sun","October 22","L","","5-3",TRUE,"Tennessee Titans",6,14,24,368,255,113,4,7,191,101,90,2,2000-10-22,-2,0,"rav",-8
"9","Sun","October 29","L","","5-4",TRUE,"Pittsburgh Steelers",6,9,14,274,139,135,3,14,231,111,120,1,2000-10-29,-2,0,"rav",-3
"10","Sun","November 5","W","","6-4",FALSE,"Cincinnati Bengals",27,7,19,378,236,142,0,11,174,130,44,1,2000-11-05,1,1,"rav",20
"11","Sun","November 12","W","","7-4",FALSE,"Tennessee Titans",24,23,19,361,258,103,1,17,286,224,62,2,2000-11-12,1,1,"rav",1
"12","Sun","November 19","W","","8-4",TRUE,"Dallas Cowboys",27,0,22,479,229,250,2,9,192,137,55,3,2000-11-19,1,1,"rav",27
"13","Sun","November 26","W","","9-4",TRUE,"Cleveland Browns",44,7,25,461,214,247,2,5,112,84,28,3,2000-11-26,1,1,"rav",37
"15","Sun","December 10","W","","10-4",TRUE,"San Diego Chargers",24,3,19,276,166,110,3,9,128,64,64,5,2000-12-10,2,1,"rav",21
"16","Sun","December 17","W","","11-4",FALSE,"Arizona Cardinals",13,7,14,214,37,177,2,18,309,258,51,4,2000-12-17,2,1,"rav",6
"17","Sun","December 24","W","","12-4",TRUE,"New York Jets",34,20,5,142,78,64,2,22,524,473,51,6,2000-12-24,4,1,"rav",14
"WildCard","Sun","December 31","W","","13-4",TRUE,"Denver Broncos",21,3,13,240,118,122,0,9,177,135,42,1,2000-12-31,1,1,"rav",18
"Division","Sun","January 7","W","","14-4",FALSE,"Tennessee Titans",24,10,6,134,85,49,0,23,317,191,126,1,2001-01-07,1,1,"rav",14
"ConfChamp","Sun","January 14","W","","15-4",FALSE,"Oakland Raiders",16,3,12,282,172,110,2,12,191,167,24,5,2001-01-14,3,1,"rav",13
"SuperBowl","Sun","January 28","W","","16-4",TRUE,"New York Giants",34,7,13,244,133,111,0,11,152,86,66,5,2001-01-28,5,1,"rav",27
"1","Sun","September 9","W","","1-0",TRUE,"Chicago Bears",17,6,19,316,262,54,2,16,189,133,56,2,2001-09-09,0,1,"rav",11
"2","Sun","September 23","L","","1-1",FALSE,"Cincinnati Bengals",10,21,24,382,318,64,6,13,203,136,67,1,2001-09-23,-5,0,"rav",-11
"3","Sun","September 30","W","","2-1",FALSE,"Denver Broncos",20,13,16,333,221,112,1,13,228,167,61,3,2001-09-30,2,1,"rav",7
"4","Sun","October 7","W","","3-1",TRUE,"Tennessee Titans",26,7,23,460,253,207,0,9,185,138,47,2,2001-10-07,2,1,"rav",19
"5","Sun","October 14","L","","3-2",FALSE,"Green Bay Packers",23,31,22,357,199,158,4,23,391,331,60,1,2001-10-14,-3,0,"rav",-8
"6","Sun","October 21","L","","3-3",FALSE,"Cleveland Browns",14,24,21,321,208,113,3,10,219,131,88,0,2001-10-21,-3,0,"rav",-10
"7","Sun","October 28","W","","4-3",TRUE,"Jacksonville Jaguars",18,17,23,305,191,114,1,19,365,284,81,1,2001-10-28,0,1,"rav",1
"8","Sun","November 4","W","","5-3",FALSE,"Pittsburgh Steelers",13,10,10,183,142,41,1,21,348,225,123,1,2001-11-04,0,1,"rav",3
"9","Mon","November 12","W","","6-3",FALSE,"Tennessee Titans",16,10,12,238,161,77,2,20,318,228,90,2,2001-11-12,0,1,"rav",6
"10","Sun","November 18","L","","6-4",TRUE,"Cleveland Browns",17,27,19,350,242,108,5,17,232,137,95,3,2001-11-18,-2,0,"rav",-10
"11","Sun","November 25","W","","7-4",FALSE,"Jacksonville Jaguars",24,21,24,361,246,115,2,19,305,230,75,0,2001-11-25,-2,1,"rav",3
"12","Sun","December 2","W","","8-4",TRUE,"Indianapolis Colts",39,27,20,398,268,130,4,16,314,263,51,4,2001-12-02,0,1,"rav",12
"14","Sun","December 16","L","","8-5",TRUE,"Pittsburgh Steelers",21,26,15,207,149,58,1,22,476,318,158,0,2001-12-16,-1,0,"rav",-5
"15","Sun","December 23","W","","9-5",TRUE,"Cincinnati Bengals",16,0,20,305,148,157,1,21,281,131,150,4,2001-12-23,3,1,"rav",16
"16","Sat","December 29","L","","9-6",FALSE,"Tampa Bay Buccaneers",10,22,15,257,167,90,3,13,213,90,123,0,2001-12-29,-3,0,"rav",-12
"17","Mon","January 7","W","","10-6",TRUE,"Minnesota Vikings",19,3,16,351,139,212,0,10,179,93,86,4,2002-01-07,4,1,"rav",16
"WildCard","Sun","January 13","W","","11-6",FALSE,"Miami Dolphins",20,3,20,347,121,226,1,9,151,105,46,3,2002-01-13,2,1,"rav",17
"Division","Sun","January 20","L","","11-7",FALSE,"Pittsburgh Steelers",10,27,7,150,128,22,4,21,297,143,154,1,2002-01-20,-3,0,"rav",-17
"1","Sun","September 8","L","","0-1",FALSE,"Carolina Panthers",7,10,15,289,212,77,1,15,265,120,145,0,2002-09-08,-1,0,"rav",-3
"2","Sun","September 15","L","","0-2",TRUE,"Tampa Bay Buccaneers",0,25,12,173,118,55,1,17,279,205,74,0,2002-09-15,-1,0,"rav",-25
"4","Mon","September 30","W","","1-2",TRUE,"Denver Broncos",34,23,14,230,146,84,2,30,403,306,97,3,2002-09-30,1,1,"rav",11
"5","Sun","October 6","W","","2-2",FALSE,"Cleveland Browns",26,21,18,409,208,201,1,21,433,371,62,5,2002-10-06,4,1,"rav",5
"6","Sun","October 13","L","","2-3",FALSE,"Indianapolis Colts",20,22,15,244,139,105,3,19,317,257,60,1,2002-10-13,-2,0,"rav",-2
"7","Sun","October 20","W","","3-3",TRUE,"Jacksonville Jaguars",17,10,16,261,143,118,2,22,397,224,173,3,2002-10-20,1,1,"rav",7
"8","Sun","October 27","L","","3-4",TRUE,"Pittsburgh Steelers",18,31,26,360,293,67,5,16,283,179,104,1,2002-10-27,-4,0,"rav",-13
"9","Sun","November 3","L","","3-5",FALSE,"Atlanta Falcons",17,20,15,340,187,153,2,14,241,115,126,1,2002-11-03,-1,0,"rav",-3
"10","Sun","November 10","W","","4-5",TRUE,"Cincinnati Bengals",38,27,21,325,163,162,2,20,372,249,123,4,2002-11-10,2,1,"rav",11
"11","Sun","November 17","L","","4-6",FALSE,"Miami Dolphins",7,26,10,157,91,66,1,17,337,221,116,0,2002-11-17,-1,0,"rav",-19
"12","Sun","November 24","W","","5-6",TRUE,"Tennessee Titans",13,12,12,199,87,112,2,19,402,281,121,4,2002-11-24,2,1,"rav",1
"13","Sun","December 1","W","","6-6",FALSE,"Cincinnati Bengals",27,23,15,247,99,148,0,25,381,303,78,2,2002-12-01,2,1,"rav",4
"14","Sun","December 8","L","","6-7",TRUE,"New Orleans Saints",25,37,19,410,296,114,5,22,359,209,150,2,2002-12-08,-3,0,"rav",-12
"15","Sun","December 15","W","","7-7",FALSE,"Houston Texans",23,19,16,298,228,70,0,15,277,182,95,2,2002-12-15,2,1,"rav",4
"16","Sun","December 22","L","","7-8",TRUE,"Cleveland Browns",13,14,16,275,129,146,1,19,256,193,63,1,2002-12-22,0,0,"rav",-1
"17","Sun","December 29","L","","7-9",FALSE,"Pittsburgh Steelers",31,34,21,422,308,114,4,25,351,176,175,2,2002-12-29,-2,0,"rav",-3
"1","Sun","September 7","L","","0-1",FALSE,"Pittsburgh Steelers",15,34,17,231,143,88,2,21,339,251,88,1,2003-09-07,-1,0,"rav",-19
"2","Sun","September 14","W","","1-1",TRUE,"Cleveland Browns",33,13,14,393,50,343,3,9,175,115,60,3,2003-09-14,0,1,"rav",20
"3","Sun","September 21","W","","2-1",FALSE,"San Diego Chargers",24,10,16,249,97,152,1,25,389,257,132,3,2003-09-21,2,1,"rav",14
"4","Sun","September 28","L","","2-2",TRUE,"Kansas City Chiefs",10,17,22,326,124,202,4,15,265,136,129,0,2003-09-28,-4,0,"rav",-7
"6","Sun","October 12","W","","3-2",FALSE,"Arizona Cardinals",26,18,13,285,72,213,0,16,320,230,90,3,2003-10-12,3,1,"rav",8
"7","Sun","October 19","L","","3-3",FALSE,"Cincinnati Bengals",26,34,21,401,281,120,3,17,303,244,59,0,2003-10-19,-3,0,"rav",-8
"8","Sun","October 26","W","","4-3",TRUE,"Denver Broncos",26,6,16,277,126,151,0,12,194,90,104,2,2003-10-26,2,1,"rav",20
"9","Sun","November 2","W","","5-3",TRUE,"Jacksonville Jaguars",24,17,9,259,156,103,2,20,320,186,134,3,2003-11-02,1,1,"rav",7
"10","Sun","November 9","L","","5-4",FALSE,"St. Louis Rams",22,33,16,267,122,145,7,7,121,74,47,4,2003-11-09,-3,0,"rav",-11
"11","Sun","November 16","L","OT","5-5",FALSE,"Miami Dolphins",6,9,13,223,109,114,3,19,267,126,141,1,2003-11-16,-2,0,"rav",-3
"12","Sun","November 23","W","OT","6-5",TRUE,"Seattle Seahawks",44,41,20,426,276,150,2,24,426,293,133,3,2003-11-23,1,1,"rav",3
"13","Sun","November 30","W","","7-5",TRUE,"San Francisco 49ers",44,6,15,282,165,117,2,10,264,158,106,4,2003-11-30,2,1,"rav",38
"14","Sun","December 7","W","","8-5",TRUE,"Cincinnati Bengals",31,13,21,353,130,223,3,15,268,168,100,5,2003-12-07,2,1,"rav",18
"15","Sun","December 14","L","","8-6",FALSE,"Oakland Raiders",12,20,14,319,170,149,3,15,265,186,79,0,2003-12-14,-3,0,"rav",-8
"16","Sun","December 21","W","","9-6",FALSE,"Cleveland Browns",35,0,18,359,83,276,1,14,211,133,78,4,2003-12-21,3,1,"rav",35
"17","Sun","December 28","W","OT","10-6",TRUE,"Pittsburgh Steelers",13,10,14,279,151,128,2,9,214,158,56,5,2003-12-28,3,1,"rav",3
"WildCard","Sat","January 3","L","","10-7",TRUE,"Tennessee Titans",17,20,12,255,201,54,2,16,324,159,165,3,2004-01-03,1,0,"rav",-3
"1","Sun","September 12","L","","0-1",FALSE,"Cleveland Browns",3,20,16,254,166,88,3,10,250,165,85,0,2004-09-12,-3,0,"rav",-17
"2","Sun","September 19","W","","1-1",TRUE,"Pittsburgh Steelers",30,13,15,259,87,172,0,16,310,217,93,3,2004-09-19,3,1,"rav",17
"3","Sun","September 26","W","","2-1",FALSE,"Cincinnati Bengals",23,9,14,380,126,254,2,26,398,289,109,4,2004-09-26,2,1,"rav",14
"4","Mon","October 4","L","","2-2",TRUE,"Kansas City Chiefs",24,27,13,207,127,80,0,25,398,220,178,0,2004-10-04,0,0,"rav",-3
"5","Sun","October 10","W","","3-2",FALSE,"Washington Redskins",17,10,15,232,76,156,3,9,107,55,52,2,2004-10-10,-1,1,"rav",7
"7","Sun","October 24","W","","4-2",TRUE,"Buffalo Bills",20,6,12,160,60,100,1,15,270,185,85,5,2004-10-24,4,1,"rav",14
"8","Sun","October 31","L","","4-3",FALSE,"Philadelphia Eagles",10,15,19,327,214,113,2,19,298,200,98,1,2004-10-31,-1,0,"rav",-5
"9","Sun","November 7","W","","5-3",TRUE,"Cleveland Browns",27,13,15,240,134,106,1,13,217,126,91,2,2004-11-07,1,1,"rav",14
"10","Sun","November 14","W","OT","6-3",FALSE,"New York Jets",20,17,18,262,186,76,1,16,305,149,156,1,2004-11-14,0,1,"rav",3
"11","Sun","November 21","W","","7-3",TRUE,"Dallas Cowboys",30,10,15,287,228,59,2,16,222,128,94,3,2004-11-21,1,1,"rav",20
"12","Sun","November 28","L","","7-4",FALSE,"New England Patriots",3,24,8,124,47,77,2,18,314,170,144,0,2004-11-28,-2,0,"rav",-21
"13","Sun","December 5","L","","7-5",TRUE,"Cincinnati Bengals",26,27,21,356,164,192,2,23,453,355,98,2,2004-12-05,0,0,"rav",-1
"14","Sun","December 12","W","","8-5",TRUE,"New York Giants",37,14,23,353,184,169,1,11,196,145,51,6,2004-12-12,5,1,"rav",23
"15","Sun","December 19","L","","8-6",FALSE,"Indianapolis Colts",10,20,19,354,194,160,2,17,316,249,67,0,2004-12-19,-2,0,"rav",-10
"16","Sun","December 26","L","","8-7",FALSE,"Pittsburgh Steelers",7,20,16,248,177,71,1,20,404,221,183,2,2004-12-26,1,0,"rav",-13
"17","Sun","January 2","W","","9-7",TRUE,"Miami Dolphins",30,23,21,332,142,190,0,18,345,248,97,3,2005-01-02,3,1,"rav",7
"1","Sun","September 11","L","","0-1",TRUE,"Indianapolis Colts",7,24,22,401,324,77,4,19,340,254,86,0,2005-09-11,-4,0,"rav",-17
"2","Sun","September 18","L","","0-2",FALSE,"Tennessee Titans",10,25,12,182,168,14,2,16,290,193,97,1,2005-09-18,-1,0,"rav",-15
"4","Sun","October 2","W","","1-2",TRUE,"New York Jets",13,3,17,259,144,115,2,8,152,124,28,0,2005-10-02,-2,1,"rav",10
"5","Sun","October 9","L","","1-3",FALSE,"Detroit Lions",17,35,26,387,228,159,4,22,266,97,169,2,2005-10-09,-2,0,"rav",-18
"6","Sun","October 16","W","","2-3",TRUE,"Cleveland Browns",16,3,16,351,201,150,1,12,186,116,70,3,2005-10-16,2,1,"rav",13
"7","Sun","October 23","L","","2-4",FALSE,"Chicago Bears",6,10,12,199,133,66,0,17,276,133,143,0,2005-10-23,0,0,"rav",-4
"8","Mon","October 31","L","","2-5",FALSE,"Pittsburgh Steelers",19,20,20,318,246,72,3,19,261,160,101,2,2005-10-31,-1,0,"rav",-1
"9","Sun","November 6","L","","2-6",TRUE,"Cincinnati Bengals",9,21,17,240,122,118,1,25,329,234,95,1,2005-11-06,0,0,"rav",-12
"10","Sun","November 13","L","","2-7",FALSE,"Jacksonville Jaguars",3,30,8,163,110,53,3,20,338,205,133,0,2005-11-13,-3,0,"rav",-27
"11","Sun","November 20","W","OT","3-7",TRUE,"Pittsburgh Steelers",16,13,18,241,137,104,2,17,282,212,70,2,2005-11-20,0,1,"rav",3
"12","Sun","November 27","L","","3-8",FALSE,"Cincinnati Bengals",29,42,23,322,189,133,3,23,437,302,135,3,2005-11-27,0,0,"rav",-13
"13","Sun","December 4","W","","4-8",TRUE,"Houston Texans",16,15,15,238,165,73,2,16,298,133,165,2,2005-12-04,0,1,"rav",1
"14","Sun","December 11","L","","4-9",FALSE,"Denver Broncos",10,12,20,323,251,72,4,17,318,222,96,1,2005-12-11,-3,0,"rav",-2
"15","Mon","December 19","W","","5-9",TRUE,"Green Bay Packers",48,3,25,435,253,182,0,16,288,181,107,5,2005-12-19,5,1,"rav",45
"16","Sun","December 25","W","","6-9",TRUE,"Minnesota Vikings",30,23,23,367,279,88,2,18,262,220,42,1,2005-12-25,-1,1,"rav",7
"17","Sun","January 1","L","","6-10",FALSE,"Cleveland Browns",16,20,12,267,138,129,3,12,226,172,54,3,2006-01-01,0,0,"rav",-4
"1","Sun","September 10","W","","1-0",FALSE,"Tampa Bay Buccaneers",27,0,16,271,168,103,0,8,142,116,26,3,2006-09-10,3,1,"rav",27
"2","Sun","September 17","W","","2-0",TRUE,"Oakland Raiders",28,6,14,264,126,138,1,14,162,123,39,6,2006-09-17,5,1,"rav",22
"3","Sun","September 24","W","","3-0",FALSE,"Cleveland Browns",15,14,18,340,254,86,0,17,288,250,38,2,2006-09-24,2,1,"rav",1
"4","Sun","October 1","W","","4-0",TRUE,"San Diego Chargers",16,13,14,206,150,56,3,13,284,134,150,1,2006-10-01,-2,1,"rav",3
"5","Mon","October 9","L","","4-1",FALSE,"Denver Broncos",3,13,16,257,154,103,3,13,222,106,116,2,2006-10-09,-1,0,"rav",-10
"6","Sun","October 15","L","","4-2",TRUE,"Carolina Panthers",21,23,16,292,212,80,3,20,414,356,58,3,2006-10-15,0,0,"rav",-2
"8","Sun","October 29","W","","5-2",FALSE,"New Orleans Saints",35,22,21,293,156,137,1,17,403,368,35,5,2006-10-29,4,1,"rav",13
"9","Sun","November 5","W","","6-2",TRUE,"Cincinnati Bengals",26,20,21,374,245,129,0,16,275,182,93,3,2006-11-05,3,1,"rav",6
"10","Sun","November 12","W","","7-2",FALSE,"Tennessee Titans",27,26,19,421,371,50,2,19,367,205,162,1,2006-11-12,-1,1,"rav",1
"11","Sun","November 19","W","","8-2",TRUE,"Atlanta Falcons",24,10,20,328,225,103,1,12,186,82,104,0,2006-11-19,-1,1,"rav",14
"12","Sun","November 26","W","","9-2",TRUE,"Pittsburgh Steelers",27,0,19,275,161,114,0,17,172,151,21,3,2006-11-26,3,1,"rav",27
"13","Thu","November 30","L","","9-3",FALSE,"Cincinnati Bengals",7,13,15,316,227,89,1,14,294,227,67,0,2006-11-30,-1,0,"rav",-6
"14","Sun","December 10","W","","10-3",FALSE,"Kansas City Chiefs",20,10,18,376,283,93,1,17,276,141,135,3,2006-12-10,2,1,"rav",10
"15","Sun","December 17","W","","11-3",TRUE,"Cleveland Browns",27,17,14,373,231,142,3,13,236,168,68,2,2006-12-17,-1,1,"rav",10
"16","Sun","December 24","W","","12-3",FALSE,"Pittsburgh Steelers",31,7,23,359,256,103,3,16,251,188,63,3,2006-12-24,0,1,"rav",24
"17","Sun","December 31","W","","13-3",TRUE,"Buffalo Bills",19,7,18,327,216,111,1,10,253,214,39,3,2006-12-31,2,1,"rav",12
"Division","Sat","January 13","L","","13-4",TRUE,"Indianapolis Colts",6,15,13,244,161,83,4,15,261,161,100,2,2007-01-13,-2,0,"rav",-9
"1","Mon","September 10","L","","0-1",FALSE,"Cincinnati Bengals",20,27,20,314,207,107,6,13,236,181,55,2,2007-09-10,-4,0,"rav",-7
"2","Sun","September 16","W","","1-1",TRUE,"New York Jets",20,13,17,303,185,118,0,18,304,235,69,2,2007-09-16,2,1,"rav",7
"3","Sun","September 23","W","","2-1",TRUE,"Arizona Cardinals",26,23,23,381,252,129,1,17,364,303,61,1,2007-09-23,0,1,"rav",3
"4","Sun","September 30","L","","2-2",FALSE,"Cleveland Browns",13,27,26,418,307,111,2,12,303,204,99,1,2007-09-30,-1,0,"rav",-14
"5","Sun","October 7","W","","3-2",FALSE,"San Francisco 49ers",9,7,19,315,214,101,0,6,163,114,49,1,2007-10-07,1,1,"rav",2
"6","Sun","October 14","W","","4-2",TRUE,"St. Louis Rams",22,3,14,248,171,77,2,14,264,197,67,6,2007-10-14,4,1,"rav",19
"7","Sun","October 21","L","","4-3",FALSE,"Buffalo Bills",14,19,15,308,181,127,1,14,242,139,103,1,2007-10-21,0,0,"rav",-5
"9","Mon","November 5","L","","4-4",FALSE,"Pittsburgh Steelers",7,38,5,104,40,64,4,14,291,201,90,1,2007-11-05,-3,0,"rav",-31
"10","Sun","November 11","L","","4-5",TRUE,"Cincinnati Bengals",7,21,16,272,206,66,6,17,326,256,70,0,2007-11-11,-6,0,"rav",-14
"11","Sun","November 18","L","OT","4-6",TRUE,"Cleveland Browns",30,33,23,368,240,128,4,22,380,269,111,2,2007-11-18,-2,0,"rav",-3
"12","Sun","November 25","L","","4-7",FALSE,"San Diego Chargers",14,32,19,210,154,56,2,18,332,249,83,0,2007-11-25,-2,0,"rav",-18
"13","Mon","December 3","L","","4-8",TRUE,"New England Patriots",24,27,20,376,210,166,2,21,326,236,90,1,2007-12-03,-1,0,"rav",-3
"14","Sun","December 9","L","","4-9",TRUE,"Indianapolis Colts",20,44,19,243,145,98,5,16,334,275,59,0,2007-12-09,-5,0,"rav",-24
"15","Sun","December 16","L","OT","4-10",FALSE,"Miami Dolphins",16,22,21,345,182,163,1,21,360,288,72,0,2007-12-16,-1,0,"rav",-6
"16","Sun","December 23","L","","4-11",FALSE,"Seattle Seahawks",6,27,13,293,187,106,3,21,336,192,144,2,2007-12-23,-1,0,"rav",-21
"17","Sun","December 30","W","","5-11",TRUE,"Pittsburgh Steelers",27,21,21,334,154,180,1,14,264,218,46,3,2007-12-30,2,1,"rav",6
"1","Sun","September 7","W","","1-0",TRUE,"Cincinnati Bengals",17,10,21,358,129,229,2,8,154,84,70,2,2008-09-07,0,1,"rav",7
"3","Sun","September 21","W","","2-0",TRUE,"Cleveland Browns",28,10,21,273,122,151,2,11,169,99,70,3,2008-09-21,1,1,"rav",18
"4","Mon","September 29","L","OT","2-1",FALSE,"Pittsburgh Steelers",20,23,16,243,140,103,1,11,237,168,69,1,2008-09-29,0,0,"rav",-3
"5","Sun","October 5","L","","2-2",TRUE,"Tennessee Titans",10,13,22,285,153,132,2,14,210,163,47,2,2008-10-05,0,0,"rav",-3
"6","Sun","October 12","L","","2-3",FALSE,"Indianapolis Colts",3,31,16,260,209,51,5,17,334,258,76,0,2008-10-12,-5,0,"rav",-28
"7","Sun","October 19","W","","3-3",FALSE,"Miami Dolphins",27,13,22,357,218,139,1,21,359,288,71,1,2008-10-19,0,1,"rav",14
"8","Sun","October 26","W","","4-3",TRUE,"Oakland Raiders",29,10,18,375,183,192,1,10,234,187,47,1,2008-10-26,0,1,"rav",19
"9","Sun","November 2","W","","5-3",FALSE,"Cleveland Browns",37,27,21,429,236,193,0,14,274,210,64,2,2008-11-02,2,1,"rav",10
"10","Sun","November 9","W","","6-3",FALSE,"Houston Texans",41,13,27,333,171,162,0,19,355,280,75,4,2008-11-09,4,1,"rav",28
"11","Sun","November 16","L","","6-4",FALSE,"New York Giants",10,30,18,275,154,121,2,22,353,146,207,1,2008-11-16,-1,0,"rav",-20
"12","Sun","November 23","W","","7-4",TRUE,"Philadelphia Eagles",36,7,14,248,138,110,0,13,206,120,86,5,2008-11-23,5,1,"rav",29
"13","Sun","November 30","W","","8-4",FALSE,"Cincinnati Bengals",34,3,20,451,304,147,0,6,155,98,57,1,2008-11-30,1,1,"rav",31
"14","Sun","December 7","W","","9-4",TRUE,"Washington Redskins",24,10,12,281,134,147,2,14,254,192,62,3,2008-12-07,1,1,"rav",14
"15","Sun","December 14","L","","9-5",TRUE,"Pittsburgh Steelers",9,13,12,202,90,112,2,18,311,220,91,2,2008-12-14,0,0,"rav",-4
"16","Sat","December 20","W","","10-5",FALSE,"Dallas Cowboys",33,24,20,388,123,265,1,16,327,235,92,2,2008-12-20,1,1,"rav",9
"17","Sun","December 28","W","","11-5",TRUE,"Jacksonville Jaguars",27,7,20,431,304,127,0,14,245,127,118,4,2008-12-28,4,1,"rav",20
"WildCard","Sun","January 4","W","","12-5",FALSE,"Miami Dolphins",27,9,16,286,135,151,1,18,276,224,52,5,2009-01-04,4,1,"rav",18
"Division","Sat","January 10","W","","13-5",FALSE,"Tennessee Titans",13,10,9,211,161,50,0,21,391,275,116,3,2009-01-10,3,1,"rav",3
"ConfChamp","Sun","January 18","L","","13-6",FALSE,"Pittsburgh Steelers",14,23,13,198,125,73,4,11,275,223,52,1,2009-01-18,-3,0,"rav",-9
"1","Sun","September 13","W","","1-0",TRUE,"Kansas City Chiefs",38,24,32,501,303,198,1,11,188,159,29,0,2009-09-13,-1,1,"rav",14
"2","Sun","September 20","W","","2-0",FALSE,"San Diego Chargers",31,26,22,311,181,130,1,20,474,421,53,2,2009-09-20,1,1,"rav",5
"3","Sun","September 27","W","","3-0",TRUE,"Cleveland Browns",34,3,28,479,337,142,1,11,186,115,71,4,2009-09-27,3,1,"rav",31
"4","Sun","October 4","L","","3-1",FALSE,"New England Patriots",21,27,24,363,247,116,2,25,319,234,85,1,2009-10-04,-1,0,"rav",-6
"5","Sun","October 11","L","","3-2",TRUE,"Cincinnati Bengals",14,17,12,257,175,82,2,22,403,261,142,2,2009-10-11,0,0,"rav",-3
"6","Sun","October 18","L","","3-3",FALSE,"Minnesota Vikings",31,33,20,448,367,81,0,19,426,259,167,0,2009-10-18,0,0,"rav",-2
"8","Sun","November 1","W","","4-3",TRUE,"Denver Broncos",30,7,16,292,167,125,0,17,200,134,66,1,2009-11-01,1,1,"rav",23
"9","Sun","November 8","L","","4-4",FALSE,"Cincinnati Bengals",7,17,16,215,160,55,2,20,369,223,146,1,2009-11-08,-1,0,"rav",-10
"10","Mon","November 16","W","","5-4",FALSE,"Cleveland Browns",16,0,14,274,146,128,0,11,160,74,86,2,2009-11-16,2,1,"rav",16
"11","Sun","November 22","L","","5-5",TRUE,"Indianapolis Colts",15,17,20,354,256,98,2,20,375,299,76,3,2009-11-22,1,0,"rav",-2
"12","Sun","November 29","W","OT","6-5",TRUE,"Pittsburgh Steelers",20,17,21,393,261,132,2,16,298,145,153,1,2009-11-29,-1,1,"rav",3
"13","Mon","December 7","L","","6-6",FALSE,"Green Bay Packers",14,27,17,185,119,66,4,25,350,256,94,3,2009-12-07,-1,0,"rav",-13
"14","Sun","December 13","W","","7-6",TRUE,"Detroit Lions",48,3,24,548,240,308,1,13,229,126,103,2,2009-12-13,1,1,"rav",45
"15","Sun","December 20","W","","8-6",TRUE,"Chicago Bears",31,7,18,346,222,124,1,13,220,98,122,6,2009-12-20,5,1,"rav",24
"16","Sun","December 27","L","","8-7",FALSE,"Pittsburgh Steelers",20,23,20,323,148,175,3,17,286,238,48,2,2009-12-27,-1,0,"rav",-3
"17","Sun","January 3","W","","9-7",FALSE,"Oakland Raiders",21,13,16,330,90,240,0,20,325,274,51,2,2010-01-03,2,1,"rav",8
"WildCard","Sun","January 10","W","","10-7",FALSE,"New England Patriots",33,14,16,268,34,234,2,15,196,132,64,4,2010-01-10,2,1,"rav",19
"Division","Sat","January 16","L","","10-8",FALSE,"Indianapolis Colts",3,20,12,270,183,87,4,22,275,233,42,1,2010-01-16,-3,0,"rav",-17
"1","Mon","September 13","W","","1-0",FALSE,"New York Jets",10,9,20,282,233,49,3,6,176,60,116,1,2010-09-13,-2,1,"rav",1
"2","Sun","September 19","L","","1-1",FALSE,"Cincinnati Bengals",10,15,14,259,150,109,4,14,253,159,94,0,2010-09-19,-4,0,"rav",-5
"3","Sun","September 26","W","","2-1",TRUE,"Cleveland Browns",24,17,19,365,256,109,0,18,304,131,173,0,2010-09-26,0,1,"rav",7
"4","Sun","October 3","W","","3-1",FALSE,"Pittsburgh Steelers",17,14,22,320,250,70,2,14,210,126,84,1,2010-10-03,-1,1,"rav",3
"5","Sun","October 10","W","","4-1",TRUE,"Denver Broncos",31,17,28,415,182,233,0,16,346,307,39,1,2010-10-10,1,1,"rav",14
"6","Sun","October 17","L","OT","4-2",FALSE,"New England Patriots",20,23,21,377,278,99,0,23,394,267,127,2,2010-10-17,2,0,"rav",-3
"7","Sun","October 24","W","OT","5-2",TRUE,"Buffalo Bills",37,34,21,364,229,135,2,27,514,382,132,4,2010-10-24,2,1,"rav",3
"9","Sun","November 7","W","","6-2",TRUE,"Miami Dolphins",26,10,23,402,256,146,0,17,289,216,73,3,2010-11-07,3,1,"rav",16
"10","Thu","November 11","L","","6-3",FALSE,"Atlanta Falcons",21,26,20,320,204,116,2,23,362,302,60,0,2010-11-11,-2,0,"rav",-5
"11","Sun","November 21","W","","7-3",FALSE,"Carolina Panthers",37,13,22,378,278,100,2,9,270,150,120,2,2010-11-21,0,1,"rav",24
"12","Sun","November 28","W","","8-3",TRUE,"Tampa Bay Buccaneers",17,10,18,349,257,92,1,14,263,162,101,0,2010-11-28,-1,1,"rav",7
"13","Sun","December 5","L","","8-4",TRUE,"Pittsburgh Steelers",10,13,14,269,226,43,1,17,288,234,54,1,2010-12-05,0,0,"rav",-3
"14","Mon","December 13","W","OT","9-4",FALSE,"Houston Texans",34,28,19,253,190,63,0,28,489,378,111,2,2010-12-13,2,1,"rav",6
"15","Sun","December 19","W","","10-4",TRUE,"New Orleans Saints",30,24,17,356,148,208,0,21,269,242,27,1,2010-12-19,1,1,"rav",6
"16","Sun","December 26","W","","11-4",FALSE,"Cleveland Browns",20,10,15,258,97,161,1,17,280,178,102,4,2010-12-26,3,1,"rav",10
"17","Sun","January 2","W","","12-4",TRUE,"Cincinnati Bengals",13,7,10,199,101,98,2,20,395,305,90,5,2011-01-02,3,1,"rav",6
"WildCard","Sun","January 9","W","","13-4",FALSE,"Kansas City Chiefs",30,7,26,390,248,142,2,8,161,53,108,5,2011-01-09,3,1,"rav",23
"Division","Sat","January 15","L","","13-5",FALSE,"Pittsburgh Steelers",24,31,12,126,91,35,3,21,263,192,71,2,2011-01-15,-1,0,"rav",-7
"1","Sun","September 11","W","","1-0",TRUE,"Pittsburgh Steelers",35,7,17,385,215,170,0,20,312,246,66,7,2011-09-11,7,1,"rav",28
"2","Sun","September 18","L","","1-1",FALSE,"Tennessee Titans",13,26,15,229,184,45,3,21,432,358,74,1,2011-09-18,-2,0,"rav",-13
"3","Sun","September 25","W","","2-1",FALSE,"St. Louis Rams",37,7,25,553,385,168,1,17,244,132,112,2,2011-09-25,1,1,"rav",30
"4","Sun","October 2","W","","3-1",TRUE,"New York Jets",34,17,16,267,155,112,3,7,150,112,38,4,2011-10-02,1,1,"rav",17
"6","Sun","October 16","W","","4-1",TRUE,"Houston Texans",29,14,24,402,289,113,2,18,293,200,93,0,2011-10-16,-2,1,"rav",15
"7","Mon","October 24","L","","4-2",FALSE,"Jacksonville Jaguars",7,12,11,146,112,34,2,13,205,73,132,1,2011-10-24,-1,0,"rav",-5
"8","Sun","October 30","W","","5-2",TRUE,"Arizona Cardinals",30,27,30,405,298,107,2,17,207,98,109,1,2011-10-30,-1,1,"rav",3
"9","Sun","November 6","W","","6-2",FALSE,"Pittsburgh Steelers",23,20,23,356,289,67,1,20,392,322,70,2,2011-11-06,1,1,"rav",3
"10","Sun","November 13","L","","6-3",FALSE,"Seattle Seahawks",17,22,25,323,248,75,3,16,327,208,119,0,2011-11-13,-3,0,"rav",-5
"11","Sun","November 20","W","","7-3",TRUE,"Cincinnati Bengals",31,24,13,373,268,105,1,23,483,364,119,3,2011-11-20,2,1,"rav",7
"12","Thu","November 24","W","","8-3",TRUE,"San Francisco 49ers",16,6,16,253,161,92,0,12,170,96,74,1,2011-11-24,1,1,"rav",10
"13","Sun","December 4","W","","9-3",FALSE,"Cleveland Browns",24,10,24,448,158,290,1,13,233,174,59,1,2011-12-04,0,1,"rav",14
"14","Sun","December 11","W","","10-3",TRUE,"Indianapolis Colts",24,10,24,358,212,146,2,12,167,117,50,1,2011-12-11,-1,1,"rav",14
"15","Sun","December 18","L","","10-4",FALSE,"San Diego Chargers",14,34,19,290,201,89,2,23,415,270,145,0,2011-12-18,-2,0,"rav",-20
"16","Sat","December 24","W","","11-4",TRUE,"Cleveland Browns",20,14,15,284,122,162,1,18,256,139,117,1,2011-12-24,0,1,"rav",6
"17","Sun","January 1","W","","12-4",FALSE,"Cincinnati Bengals",24,16,15,347,126,221,0,19,336,231,105,1,2012-01-01,1,1,"rav",8
"Division","Sun","January 15","W","","13-4",TRUE,"Houston Texans",20,13,11,227,140,87,0,16,315,184,131,4,2012-01-15,4,1,"rav",7
"ConfChamp","Sun","January 22","L","","13-5",FALSE,"New England Patriots",20,23,19,398,282,116,1,25,330,234,96,3,2012-01-22,2,0,"rav",-3
"1","Sun","September 8","L","","0-1",TRUE,"Seattle Seahawks",24,28,19,344,193,151,1,20,297,206,91,0,1985-09-08,-1,0,"cin",-4
"2","Sun","September 15","L","","0-2",FALSE,"St. Louis Cardinals",27,41,20,370,254,116,2,27,447,237,210,2,1985-09-15,0,0,"cin",-14
"3","Sun","September 22","L","","0-3",TRUE,"San Diego Chargers",41,44,32,448,296,152,5,26,517,344,173,3,1985-09-22,-2,0,"cin",-3
"4","Mon","September 30","W","","1-3",FALSE,"Pittsburgh Steelers",37,24,23,366,144,222,2,27,453,340,113,3,1985-09-30,1,1,"cin",13
"5","Sun","October 6","L","","1-4",TRUE,"New York Jets",20,29,25,301,212,89,1,21,255,178,77,1,1985-10-06,0,0,"cin",-9
"6","Sun","October 13","W","","2-4",TRUE,"New York Giants",35,30,16,199,157,42,0,34,470,443,27,4,1985-10-13,4,1,"cin",5
"7","Sun","October 20","L","","2-5",FALSE,"Houston Oilers",27,44,24,458,352,106,5,26,401,266,135,0,1985-10-20,-5,0,"cin",-17
"8","Sun","October 27","W","","3-5",TRUE,"Pittsburgh Steelers",26,21,20,306,221,85,2,14,256,169,87,6,1985-10-27,4,1,"cin",5
"9","Sun","November 3","W","","4-5",FALSE,"Buffalo Bills",23,17,21,389,182,207,2,16,268,173,95,3,1985-11-03,1,1,"cin",6
"10","Sun","November 10","W","","5-5",TRUE,"Cleveland Browns",27,10,23,370,252,118,0,13,325,213,112,3,1985-11-10,3,1,"cin",17
"11","Sun","November 17","L","","5-6",FALSE,"Los Angeles Raiders",6,13,13,240,146,94,0,19,284,132,152,1,1985-11-17,1,0,"cin",-7
"12","Sun","November 24","L","","5-7",FALSE,"Cleveland Browns",6,24,14,226,90,136,1,14,283,102,181,0,1985-11-24,-1,0,"cin",-18
"13","Sun","December 1","W","","6-7",TRUE,"Houston Oilers",45,27,28,555,324,231,1,22,345,272,73,2,1985-12-01,1,1,"cin",18
"14","Sun","December 8","W","","7-7",TRUE,"Dallas Cowboys",50,24,31,570,296,274,2,20,260,196,64,4,1985-12-08,2,1,"cin",26
"15","Sun","December 15","L","","7-8",FALSE,"Washington Redskins",24,27,18,399,330,69,3,21,383,255,128,4,1985-12-15,1,0,"cin",-3
"16","Sun","December 22","L","","7-9",FALSE,"New England Patriots",23,34,17,359,268,91,2,17,419,138,281,2,1985-12-22,0,0,"cin",-11
"1","Sun","September 7","L","","0-1",FALSE,"Kansas City Chiefs",14,24,17,283,223,60,3,21,325,145,180,3,1986-09-07,0,0,"cin",-10
"2","Sun","September 14","W","OT","1-1",TRUE,"Buffalo Bills",36,33,22,405,240,165,3,20,378,207,171,2,1986-09-14,-1,1,"cin",3
"3","Thu","September 18","W","","2-1",FALSE,"Cleveland Browns",30,13,20,399,142,257,1,24,338,255,83,1,1986-09-18,0,1,"cin",17
"4","Sun","September 28","L","","2-2",TRUE,"Chicago Bears",7,44,16,338,278,60,5,23,476,254,222,2,1986-09-28,-3,0,"cin",-37
"5","Sun","October 5","W","","3-2",FALSE,"Green Bay Packers",34,28,26,378,183,195,1,24,328,253,75,2,1986-10-05,1,1,"cin",6
"6","Mon","October 13","W","","4-2",TRUE,"Pittsburgh Steelers",24,22,16,359,211,148,1,15,288,180,108,1,1986-10-13,0,1,"cin",2
"7","Sun","October 19","W","","5-2",TRUE,"Houston Oilers",31,28,22,412,188,224,1,16,233,155,78,3,1986-10-19,2,1,"cin",3
"8","Sun","October 26","L","","5-3",FALSE,"Pittsburgh Steelers",9,30,23,371,249,122,2,22,332,94,238,0,1986-10-26,-2,0,"cin",-21
"9","Sun","November 2","W","","6-3",FALSE,"Detroit Lions",24,17,26,389,167,222,2,21,365,268,97,2,1986-11-02,0,1,"cin",7
"10","Sun","November 9","L","","6-4",FALSE,"Houston Oilers",28,32,22,404,358,46,2,26,358,297,61,1,1986-11-09,-1,0,"cin",-4
"11","Sun","November 16","W","","7-4",TRUE,"Seattle Seahawks",34,7,23,425,320,105,4,22,306,127,179,5,1986-11-16,1,1,"cin",27
"12","Sun","November 23","W","","8-4",TRUE,"Minnesota Vikings",24,20,24,413,248,165,2,22,284,164,120,1,1986-11-23,-1,1,"cin",4
"13","Sun","November 30","L","","8-5",FALSE,"Denver Broncos",28,34,22,426,302,124,3,27,401,219,182,0,1986-11-30,-3,0,"cin",-6
"14","Sun","December 7","W","","9-5",FALSE,"New England Patriots",31,7,22,584,284,300,1,18,291,215,76,2,1986-12-07,1,1,"cin",24
"15","Sun","December 14","L","","9-6",TRUE,"Cleveland Browns",3,34,15,283,148,135,3,19,372,246,126,0,1986-12-14,-3,0,"cin",-31
"16","Sun","December 21","W","","10-6",TRUE,"New York Jets",52,21,32,621,416,205,2,16,199,73,126,3,1986-12-21,1,1,"cin",31
"1","Sun","September 13","W","","1-0",FALSE,"Indianapolis Colts",23,21,25,403,216,187,1,15,291,206,85,3,1987-09-13,2,1,"cin",2
"2","Sun","September 20","L","","1-1",TRUE,"San Francisco 49ers",26,27,19,292,164,128,1,16,261,205,56,1,1987-09-20,0,0,"cin",-1
"3","Sun","October 4","L","","1-2",TRUE,"San Diego Chargers",9,10,11,206,-13,219,0,15,261,169,92,2,1987-10-04,2,0,"cin",-1
"4","Sun","October 11","W","","2-2",FALSE,"Seattle Seahawks",17,10,22,367,97,270,3,17,216,126,90,2,1987-10-11,-1,1,"cin",7
"5","Sun","October 18","L","","2-3",TRUE,"Cleveland Browns",0,34,6,95,30,65,3,29,410,287,123,4,1987-10-18,1,0,"cin",-34
"6","Sun","October 25","L","","2-4",FALSE,"Pittsburgh Steelers",20,23,17,433,292,141,2,17,282,204,78,0,1987-10-25,-2,0,"cin",-3
"7","Sun","November 1","L","","2-5",TRUE,"Houston Oilers",29,31,25,504,383,121,3,19,227,145,82,3,1987-11-01,0,0,"cin",-2
"8","Sun","November 8","L","","2-6",TRUE,"Miami Dolphins",14,20,23,358,202,156,2,22,333,235,98,0,1987-11-08,-2,0,"cin",-6
"9","Sun","November 15","W","","3-6",FALSE,"Atlanta Falcons",16,10,27,416,146,270,2,13,266,147,119,2,1987-11-15,0,1,"cin",6
"10","Sun","November 22","L","","3-7",TRUE,"Pittsburgh Steelers",16,30,28,448,373,75,5,14,328,194,134,2,1987-11-22,-3,0,"cin",-14
"11","Sun","November 29","L","","3-8",FALSE,"New York Jets",20,27,21,339,233,106,2,20,328,205,123,2,1987-11-29,0,0,"cin",-7
"12","Sun","December 6","W","OT","4-8",TRUE,"Kansas City Chiefs",30,27,31,503,359,144,0,21,322,209,113,1,1987-12-06,1,1,"cin",3
"13","Sun","December 13","L","","4-9",FALSE,"Cleveland Browns",24,38,24,417,352,65,2,19,390,237,153,1,1987-12-13,-1,0,"cin",-14
"14","Sun","December 20","L","","4-10",TRUE,"New Orleans Saints",24,41,24,237,112,125,4,24,321,220,101,0,1987-12-20,-4,0,"cin",-17
"15","Sun","December 27","L","","4-11",FALSE,"Houston Oilers",17,21,16,359,267,92,2,25,461,267,194,3,1987-12-27,1,0,"cin",-4
"1","Sun","September 4","W","","1-0",TRUE,"Phoenix Cardinals",21,14,21,403,251,152,1,23,374,207,167,2,1988-09-04,1,1,"cin",7
"2","Sun","September 11","W","","2-0",FALSE,"Philadelphia Eagles",28,24,20,431,353,78,3,28,415,225,190,1,1988-09-11,-2,1,"cin",4
"3","Sun","September 18","W","","3-0",FALSE,"Pittsburgh Steelers",17,12,20,306,190,116,1,19,319,195,124,6,1988-09-18,5,1,"cin",5
"4","Sun","September 25","W","","4-0",TRUE,"Cleveland Browns",24,17,22,393,180,213,0,20,322,254,68,1,1988-09-25,1,1,"cin",7
"5","Sun","October 2","W","","5-0",FALSE,"Los Angeles Raiders",45,21,28,496,332,164,1,20,405,309,96,5,1988-10-02,4,1,"cin",24
"6","Sun","October 9","W","","6-0",TRUE,"New York Jets",36,19,23,402,196,206,2,16,226,117,109,1,1988-10-09,-1,1,"cin",17
"7","Sun","October 16","L","","6-1",FALSE,"New England Patriots",21,27,23,365,225,140,6,22,311,153,158,0,1988-10-16,-6,0,"cin",-6
"8","Sun","October 23","W","","7-1",TRUE,"Houston Oilers",44,21,25,353,131,222,4,18,205,101,104,4,1988-10-23,0,1,"cin",23
"9","Sun","October 30","L","","7-2",FALSE,"Cleveland Browns",16,23,18,281,153,128,0,17,302,203,99,2,1988-10-30,2,0,"cin",-7
"10","Sun","November 6","W","","8-2",TRUE,"Pittsburgh Steelers",42,7,28,559,338,221,2,15,198,97,101,0,1988-11-06,-2,1,"cin",35
"11","Sun","November 13","L","","8-3",FALSE,"Kansas City Chiefs",28,31,19,307,157,150,2,24,418,276,142,0,1988-11-13,-2,0,"cin",-3
"12","Sun","November 20","W","","9-3",FALSE,"Dallas Cowboys",38,24,23,410,196,214,1,23,355,176,179,2,1988-11-20,1,1,"cin",14
"13","Sun","November 27","W","","10-3",TRUE,"Buffalo Bills",35,21,34,455,223,232,0,21,353,243,110,4,1988-11-27,4,1,"cin",14
"14","Sun","December 4","W","","11-3",TRUE,"San Diego Chargers",27,10,21,352,145,207,2,14,211,123,88,4,1988-12-04,2,1,"cin",17
"15","Sun","December 11","L","","11-4",FALSE,"Houston Oilers",6,41,10,226,94,132,2,19,396,249,147,2,1988-12-11,0,0,"cin",-35
"16","Sat","December 17","W","OT","12-4",TRUE,"Washington Redskins",20,17,16,318,183,135,0,23,372,206,166,2,1988-12-17,2,1,"cin",3
"Division","Sat","December 31","W","","13-4",TRUE,"Seattle Seahawks",21,13,22,345,91,254,2,19,294,276,18,3,1988-12-31,1,1,"cin",8
"ConfChamp","Sun","January 8","W","","14-4",TRUE,"Buffalo Bills",21,10,23,249,74,175,2,10,181,136,45,3,1989-01-08,1,1,"cin",11
"SuperBowl","Sun","January 22","L","","14-5",TRUE,"San Francisco 49ers",16,20,13,229,123,106,1,23,452,341,111,2,1989-01-22,1,0,"cin",-4
"1","Sun","September 10","L","","0-1",FALSE,"Chicago Bears",14,17,23,330,151,179,0,19,365,153,212,3,1989-09-10,3,0,"cin",-3
"2","Sun","September 17","W","","1-1",TRUE,"Pittsburgh Steelers",41,10,31,520,328,192,1,18,274,188,86,0,1989-09-17,-1,1,"cin",31
"3","Mon","September 25","W","","2-1",TRUE,"Cleveland Browns",21,14,21,371,184,187,1,16,267,175,92,0,1989-09-25,-1,1,"cin",7
"4","Sun","October 1","W","","3-1",FALSE,"Kansas City Chiefs",21,17,14,277,114,163,3,16,292,153,139,6,1989-10-01,3,1,"cin",4
"5","Sun","October 8","W","","4-1",FALSE,"Pittsburgh Steelers",26,16,21,382,192,190,1,25,340,168,172,1,1989-10-08,0,1,"cin",10
"6","Sun","October 15","L","","4-2",TRUE,"Miami Dolphins",13,20,14,314,168,146,0,19,373,266,107,1,1989-10-15,1,0,"cin",-7
"7","Sun","October 22","L","","4-3",TRUE,"Indianapolis Colts",12,23,15,218,123,95,3,18,336,168,168,3,1989-10-22,0,0,"cin",-11
"8","Sun","October 29","W","","5-3",TRUE,"Tampa Bay Buccaneers",56,23,30,482,294,188,2,21,475,336,139,4,1989-10-29,2,1,"cin",33
"9","Sun","November 5","L","","5-4",FALSE,"Los Angeles Raiders",7,28,20,350,196,154,3,12,429,223,206,1,1989-11-05,-2,0,"cin",-21
"10","Mon","November 13","L","","5-5",FALSE,"Houston Oilers",24,26,16,337,175,162,1,20,311,175,136,1,1989-11-13,0,0,"cin",-2
"11","Sun","November 19","W","","6-5",TRUE,"Detroit Lions",42,7,27,546,447,99,3,10,278,156,122,5,1989-11-19,2,1,"cin",35
"12","Sun","November 26","L","","6-6",FALSE,"Buffalo Bills",7,24,16,298,133,165,3,18,345,117,228,2,1989-11-26,-1,0,"cin",-17
"13","Sun","December 3","W","","7-6",FALSE,"Cleveland Browns",21,0,16,298,197,101,3,15,264,176,88,3,1989-12-03,0,1,"cin",21
"14","Sun","December 10","L","","7-7",TRUE,"Seattle Seahawks",17,24,23,365,215,150,1,15,361,252,109,1,1989-12-10,0,0,"cin",-7
"15","Sun","December 17","W","","8-7",TRUE,"Houston Oilers",61,7,35,584,392,192,2,14,194,155,39,5,1989-12-17,3,1,"cin",54
"16","Mon","December 25","L","","8-8",FALSE,"Minnesota Vikings",21,29,26,429,309,120,5,24,393,274,119,1,1989-12-25,-4,0,"cin",-8
"1","Sun","September 9","W","","1-0",TRUE,"New York Jets",25,20,18,303,192,111,2,21,342,270,72,3,1990-09-09,1,1,"cin",5
"2","Sun","September 16","W","","2-0",FALSE,"San Diego Chargers",21,16,18,302,223,79,3,17,417,278,139,3,1990-09-16,0,1,"cin",5
"3","Sun","September 23","W","","3-0",TRUE,"New England Patriots",41,7,18,346,236,110,2,18,302,250,52,5,1990-09-23,3,1,"cin",34
"4","Mon","October 1","L","","3-1",FALSE,"Seattle Seahawks",16,31,16,230,161,69,2,20,352,201,151,2,1990-10-01,0,0,"cin",-15
"5","Sun","October 7","W","OT","4-1",FALSE,"Los Angeles Rams",34,31,27,582,483,99,2,26,477,364,113,1,1990-10-07,-1,1,"cin",3
"6","Sun","October 14","L","","4-2",FALSE,"Houston Oilers",17,48,17,251,135,116,4,27,514,401,113,2,1990-10-14,-2,0,"cin",-31
"7","Mon","October 22","W","","5-2",FALSE,"Cleveland Browns",34,13,15,312,79,233,2,17,253,157,96,2,1990-10-22,0,1,"cin",21
"8","Sun","October 28","L","","5-3",FALSE,"Atlanta Falcons",17,38,21,309,225,84,4,17,299,124,175,0,1990-10-28,-4,0,"cin",-21
"9","Sun","November 4","L","","5-4",TRUE,"New Orleans Saints",7,21,13,261,125,136,1,21,350,101,249,1,1990-11-04,0,0,"cin",-14
"11","Sun","November 18","W","","6-4",TRUE,"Pittsburgh Steelers",27,3,20,312,134,178,1,11,206,112,94,1,1990-11-18,0,1,"cin",24
"12","Sun","November 25","L","","6-5",TRUE,"Indianapolis Colts",20,34,20,381,236,145,3,21,419,237,182,0,1990-11-25,-3,0,"cin",-14
"13","Sun","December 2","W","","7-5",FALSE,"Pittsburgh Steelers",16,12,17,319,154,165,3,16,305,226,79,2,1990-12-02,-1,1,"cin",4
"14","Sun","December 9","L","OT","7-6",TRUE,"San Francisco 49ers",17,20,14,215,102,113,1,25,372,170,202,1,1990-12-09,0,0,"cin",-3
"15","Sun","December 16","L","","7-7",FALSE,"Los Angeles Raiders",7,24,11,251,142,109,2,13,348,163,185,1,1990-12-16,-1,0,"cin",-17
"16","Sun","December 23","W","","8-7",TRUE,"Houston Oilers",40,20,18,387,165,222,0,19,304,282,22,4,1990-12-23,4,1,"cin",20
"17","Sun","December 30","W","","9-7",TRUE,"Cleveland Browns",21,14,14,302,151,151,3,19,345,184,161,3,1990-12-30,0,1,"cin",7
"WildCard","Sun","January 6","W","","10-7",TRUE,"Houston Oilers",41,14,24,349,162,187,0,13,226,159,67,2,1991-01-06,2,1,"cin",27
"Division","Sun","January 13","L","","10-8",FALSE,"Los Angeles Raiders",10,20,12,182,58,124,0,20,389,154,235,1,1991-01-13,1,0,"cin",-10
"1","Sun","September 1","L","","0-1",FALSE,"Denver Broncos",14,45,10,246,193,53,4,25,471,286,185,0,1991-09-01,-4,0,"cin",-31
"2","Sun","September 8","L","","0-2",TRUE,"Houston Oilers",7,30,19,349,218,131,2,21,425,315,110,1,1991-09-08,-1,0,"cin",-23
"3","Sun","September 15","L","","0-3",FALSE,"Cleveland Browns",13,14,16,268,134,134,3,17,263,179,84,2,1991-09-15,-1,0,"cin",-1
"4","Sun","September 22","L","","0-4",TRUE,"Washington Redskins",27,34,21,322,186,136,1,20,344,212,132,2,1991-09-22,1,0,"cin",-7
"6","Sun","October 6","L","","0-5",TRUE,"Seattle Seahawks",7,13,20,364,240,124,5,15,305,202,103,3,1991-10-06,-2,0,"cin",-6
"7","Sun","October 13","L","","0-6",FALSE,"Dallas Cowboys",23,35,17,352,178,174,3,19,376,264,112,2,1991-10-13,-1,0,"cin",-12
"8","Mon","October 21","L","","0-7",FALSE,"Buffalo Bills",16,35,24,411,224,187,2,19,487,392,95,3,1991-10-21,1,0,"cin",-19
"9","Sun","October 27","L","","0-8",FALSE,"Houston Oilers",3,35,8,183,146,37,3,26,486,376,110,3,1991-10-27,0,0,"cin",-32
"10","Sun","November 3","W","","1-8",TRUE,"Cleveland Browns",23,21,19,347,185,162,1,22,363,280,83,1,1991-11-03,0,1,"cin",2
"11","Sun","November 10","L","OT","1-9",TRUE,"Pittsburgh Steelers",27,33,25,406,336,70,3,18,352,294,58,0,1991-11-10,-3,0,"cin",-6
"12","Sun","November 17","L","","1-10",FALSE,"Philadelphia Eagles",10,17,17,198,124,74,4,17,265,195,70,2,1991-11-17,-2,0,"cin",-7
"13","Sun","November 24","L","","1-11",TRUE,"Los Angeles Raiders",14,38,21,279,114,165,5,14,176,19,157,1,1991-11-24,-4,0,"cin",-24
"14","Sun","December 1","W","","2-11",TRUE,"New York Giants",27,24,15,251,204,47,0,22,347,278,69,1,1991-12-01,1,1,"cin",3
"15","Mon","December 9","L","","2-12",FALSE,"Miami Dolphins",13,37,19,355,196,159,2,21,358,266,92,0,1991-12-09,-2,0,"cin",-24
"16","Sun","December 15","L","","2-13",FALSE,"Pittsburgh Steelers",10,17,13,195,120,75,2,18,326,177,149,5,1991-12-15,3,0,"cin",-7
"17","Sun","December 22","W","","3-13",TRUE,"New England Patriots",29,7,22,443,360,83,2,14,308,255,53,5,1991-12-22,3,1,"cin",22
"1","Sun","September 6","W","","1-0",FALSE,"Seattle Seahawks",21,3,18,269,102,167,2,18,202,110,92,2,1992-09-06,0,1,"cin",18
"2","Sun","September 13","W","OT","2-0",TRUE,"Los Angeles Raiders",24,21,19,332,154,178,0,22,454,367,87,3,1992-09-13,3,1,"cin",3
"3","Sun","September 20","L","","2-1",FALSE,"Green Bay Packers",23,24,18,301,137,164,3,22,345,252,93,3,1992-09-20,0,0,"cin",-1
"4","Sun","September 27","L","","2-2",TRUE,"Minnesota Vikings",7,42,14,178,65,113,4,28,423,317,106,0,1992-09-27,-4,0,"cin",-35
"6","Sun","October 11","L","","2-3",TRUE,"Houston Oilers",24,38,15,274,205,69,2,28,418,216,202,3,1992-10-11,1,0,"cin",-14
"7","Mon","October 19","L","","2-4",FALSE,"Pittsburgh Steelers",0,20,6,118,70,48,2,26,424,251,173,1,1992-10-19,-1,0,"cin",-20
"8","Sun","October 25","L","","2-5",FALSE,"Houston Oilers",10,26,11,201,113,88,1,26,425,332,93,1,1992-10-25,0,0,"cin",-16
"9","Sun","November 1","W","","3-5",TRUE,"Cleveland Browns",30,10,20,300,195,105,1,16,328,270,58,2,1992-11-01,1,1,"cin",20
"10","Sun","November 8","W","OT","4-5",FALSE,"Chicago Bears",31,28,17,287,140,147,1,15,301,149,152,4,1992-11-08,3,1,"cin",3
"11","Sun","November 15","L","","4-6",FALSE,"New York Jets",14,17,16,227,79,148,3,17,271,98,173,2,1992-11-15,-1,0,"cin",-3
"12","Sun","November 22","L","","4-7",TRUE,"Detroit Lions",13,19,10,95,43,52,3,17,277,116,161,3,1992-11-22,0,0,"cin",-6
"13","Sun","November 29","L","","4-8",TRUE,"Pittsburgh Steelers",9,21,15,228,68,160,1,17,240,141,99,2,1992-11-29,1,0,"cin",-12
"14","Sun","December 6","L","","4-9",FALSE,"Cleveland Browns",21,37,15,227,165,62,1,17,381,232,149,2,1992-12-06,1,0,"cin",-16
"15","Sun","December 13","L","","4-10",FALSE,"San Diego Chargers",10,27,15,223,156,67,2,22,370,209,161,2,1992-12-13,0,0,"cin",-17
"16","Sun","December 20","W","","5-10",TRUE,"New England Patriots",20,10,21,365,154,211,0,10,176,60,116,3,1992-12-20,3,1,"cin",10
"17","Sun","December 27","L","","5-11",TRUE,"Indianapolis Colts",17,21,18,294,97,197,1,18,298,206,92,0,1992-12-27,-1,0,"cin",-4
"1","Sun","September 5","L","","0-1",FALSE,"Cleveland Browns",14,27,12,227,172,55,3,18,263,167,96,0,1993-09-05,-3,0,"cin",-13
"2","Sun","September 12","L","","0-2",TRUE,"Indianapolis Colts",6,9,16,269,141,128,1,17,332,212,120,3,1993-09-12,2,0,"cin",-3
"3","Sun","September 19","L","","0-3",FALSE,"Pittsburgh Steelers",7,34,11,170,126,44,1,23,404,181,223,1,1993-09-19,0,0,"cin",-27
"4","Sun","September 26","L","","0-4",TRUE,"Seattle Seahawks",10,19,19,354,324,30,3,17,305,166,139,2,1993-09-26,-1,0,"cin",-9
"6","Sun","October 10","L","","0-5",FALSE,"Kansas City Chiefs",15,17,17,277,162,115,1,14,203,109,94,2,1993-10-10,1,0,"cin",-2
"7","Sun","October 17","L","","0-6",TRUE,"Cleveland Browns",17,28,14,194,160,34,1,17,293,110,183,2,1993-10-17,1,0,"cin",-11
"8","Sun","October 24","L","","0-7",FALSE,"Houston Oilers",12,28,20,338,241,97,2,24,369,244,125,2,1993-10-24,0,0,"cin",-16
"10","Sun","November 7","L","","0-8",TRUE,"Pittsburgh Steelers",16,24,14,199,96,103,1,21,390,244,146,2,1993-11-07,1,0,"cin",-8
"11","Sun","November 14","L","","0-9",TRUE,"Houston Oilers",3,38,9,165,63,102,2,32,462,222,240,4,1993-11-14,2,0,"cin",-35
"12","Sun","November 21","L","","0-10",FALSE,"New York Jets",12,17,14,226,176,50,2,21,288,177,111,0,1993-11-21,-2,0,"cin",-5
"13","Sun","November 28","W","","1-10",TRUE,"Los Angeles Raiders",16,10,14,264,133,131,0,16,283,202,81,2,1993-11-28,2,1,"cin",6
"14","Sun","December 5","L","","1-11",FALSE,"San Francisco 49ers",8,21,19,339,195,144,1,19,284,173,111,2,1993-12-05,1,0,"cin",-13
"15","Sun","December 12","L","","1-12",FALSE,"New England Patriots",2,7,11,165,63,102,1,16,224,106,118,0,1993-12-12,-1,0,"cin",-5
"16","Sun","December 19","W","","2-12",TRUE,"Los Angeles Rams",15,3,20,393,223,170,0,14,273,107,166,2,1993-12-19,2,1,"cin",12
"17","Sun","December 26","W","","3-12",TRUE,"Atlanta Falcons",21,17,16,284,162,122,0,22,376,185,191,1,1993-12-26,1,1,"cin",4
"18","Sun","January 2","L","","3-13",FALSE,"New Orleans Saints",13,20,13,188,104,84,1,15,269,193,76,1,1994-01-02,0,0,"cin",-7
"1","Sun","September 4","L","","0-1",TRUE,"Cleveland Browns",20,28,23,331,213,118,2,16,256,149,107,2,1994-09-04,0,0,"cin",-8
"2","Sun","September 11","L","","0-2",FALSE,"San Diego Chargers",10,27,17,280,167,113,3,21,465,299,166,0,1994-09-11,-3,0,"cin",-17
"3","Sun","September 18","L","","0-3",TRUE,"New England Patriots",28,31,21,318,219,99,2,28,447,365,82,2,1994-09-18,0,0,"cin",-3
"4","Sun","September 25","L","","0-4",FALSE,"Houston Oilers",13,20,13,176,74,102,4,19,341,193,148,4,1994-09-25,0,0,"cin",-7
"5","Sun","October 2","L","","0-5",TRUE,"Miami Dolphins",7,23,14,246,184,62,5,21,345,204,141,0,1994-10-02,-5,0,"cin",-16
"7","Sun","October 16","L","","0-6",FALSE,"Pittsburgh Steelers",10,14,11,241,135,106,2,16,243,129,114,1,1994-10-16,-1,0,"cin",-4
"8","Sun","October 23","L","","0-7",FALSE,"Cleveland Browns",13,37,15,221,146,75,1,13,240,120,120,1,1994-10-23,0,0,"cin",-24
"9","Sun","October 30","L","","0-8",TRUE,"Dallas Cowboys",20,23,13,320,243,77,1,20,368,272,96,2,1994-10-30,1,0,"cin",-3
"10","Sun","November 6","W","OT","1-8",FALSE,"Seattle Seahawks",20,17,23,496,377,119,2,21,318,170,148,1,1994-11-06,-1,1,"cin",3
"11","Sun","November 13","W","","2-8",TRUE,"Houston Oilers",34,31,17,387,348,39,2,24,284,129,155,0,1994-11-13,-2,1,"cin",3
"12","Sun","November 20","L","","2-9",TRUE,"Indianapolis Colts",13,17,16,353,250,103,2,15,237,165,72,0,1994-11-20,-2,0,"cin",-4
"13","Sun","November 27","L","","2-10",FALSE,"Denver Broncos",13,15,16,328,198,130,4,12,256,206,50,0,1994-11-27,-4,0,"cin",-2
"14","Sun","December 4","L","","2-11",TRUE,"Pittsburgh Steelers",15,38,13,195,119,76,3,23,308,123,185,0,1994-12-04,-3,0,"cin",-23
"15","Sun","December 11","L","","2-12",FALSE,"New York Giants",20,27,20,326,205,121,1,18,304,215,89,2,1994-12-11,1,0,"cin",-7
"16","Sun","December 18","L","","2-13",FALSE,"Arizona Cardinals",7,28,12,189,125,64,3,24,364,212,152,0,1994-12-18,-3,0,"cin",-21
"17","Sat","December 24","W","","3-13",TRUE,"Philadelphia Eagles",33,30,23,385,233,152,4,19,378,297,81,3,1994-12-24,-1,1,"cin",3
"1","Sun","September 3","W","OT","1-0",FALSE,"Indianapolis Colts",24,21,18,336,249,87,1,24,390,246,144,3,1995-09-03,2,1,"cin",3
"2","Sun","September 10","W","","2-0",TRUE,"Jacksonville Jaguars",24,17,17,346,228,118,2,14,259,140,119,2,1995-09-10,0,1,"cin",7
"3","Sun","September 17","L","","2-1",FALSE,"Seattle Seahawks",21,24,18,401,291,110,1,24,406,263,143,1,1995-09-17,0,0,"cin",-3
"4","Sun","September 24","L","","2-2",TRUE,"Houston Oilers",28,38,20,407,347,60,2,24,487,350,137,1,1995-09-24,-1,0,"cin",-10
"5","Sun","October 1","L","","2-3",TRUE,"Miami Dolphins",23,26,23,342,198,144,0,27,490,442,48,1,1995-10-01,1,0,"cin",-3
"6","Sun","October 8","L","","2-4",FALSE,"Tampa Bay Buccaneers",16,19,13,312,204,108,6,20,299,182,117,0,1995-10-08,-6,0,"cin",-3
"8","Thu","October 19","W","","3-4",FALSE,"Pittsburgh Steelers",27,9,18,368,275,93,0,24,468,347,121,1,1995-10-19,1,1,"cin",18
"9","Sun","October 29","L","OT","3-5",TRUE,"Cleveland Browns",26,29,27,384,292,92,4,26,480,301,179,2,1995-10-29,-2,0,"cin",-3
"10","Sun","November 5","L","","3-6",TRUE,"Oakland Raiders",17,20,14,240,121,119,3,16,352,168,184,1,1995-11-05,-2,0,"cin",-3
"11","Sun","November 12","W","","4-6",FALSE,"Houston Oilers",32,25,16,300,220,80,3,19,287,180,107,4,1995-11-12,1,1,"cin",7
"12","Sun","November 19","L","","4-7",TRUE,"Pittsburgh Steelers",31,49,19,265,208,57,2,28,556,365,191,2,1995-11-19,0,0,"cin",-18
"13","Sun","November 26","W","","5-7",FALSE,"Jacksonville Jaguars",17,13,20,323,210,113,3,18,291,213,78,2,1995-11-26,-1,1,"cin",4
"14","Sun","December 3","L","","5-8",FALSE,"Green Bay Packers",10,24,12,217,186,31,2,23,434,339,95,1,1995-12-03,-1,0,"cin",-14
"15","Sun","December 10","W","","6-8",TRUE,"Chicago Bears",16,10,19,337,246,91,0,17,302,183,119,1,1995-12-10,1,1,"cin",6
"16","Sun","December 17","L","","6-9",FALSE,"Cleveland Browns",10,26,16,312,247,65,1,23,400,241,159,1,1995-12-17,0,0,"cin",-16
"17","Sun","December 24","W","","7-9",TRUE,"Minnesota Vikings",27,24,18,302,231,71,2,27,448,285,163,1,1995-12-24,-1,1,"cin",3
"1","Sun","September 1","L","","0-1",FALSE,"St. Louis Rams",16,26,14,242,205,37,5,18,209,139,70,3,1996-09-01,-2,0,"cin",-10
"2","Sun","September 8","L","","0-2",FALSE,"San Diego Chargers",14,27,14,249,187,62,2,25,383,269,114,2,1996-09-08,0,0,"cin",-13
"3","Sun","September 15","W","","1-2",TRUE,"New Orleans Saints",30,15,24,319,218,101,0,15,314,287,27,4,1996-09-15,4,1,"cin",15
"5","Sun","September 29","L","","1-3",TRUE,"Denver Broncos",10,14,17,253,147,106,1,22,402,288,114,3,1996-09-29,2,0,"cin",-4
"6","Sun","October 6","L","OT","1-4",TRUE,"Houston Oilers",27,30,22,315,152,163,0,18,335,175,160,2,1996-10-06,2,0,"cin",-3
"7","Sun","October 13","L","","1-5",FALSE,"Pittsburgh Steelers",10,20,20,252,158,94,2,17,306,182,124,2,1996-10-13,0,0,"cin",-10
"8","Sun","October 20","L","","1-6",FALSE,"San Francisco 49ers",21,28,18,345,196,149,1,20,418,338,80,5,1996-10-20,4,0,"cin",-7
"9","Sun","October 27","W","","2-6",TRUE,"Jacksonville Jaguars",28,21,18,267,207,60,0,19,338,189,149,2,1996-10-27,2,1,"cin",7
"10","Sun","November 3","W","","3-6",FALSE,"Baltimore Ravens",24,21,33,433,265,168,2,23,371,279,92,4,1996-11-03,2,1,"cin",3
"11","Sun","November 10","W","","4-6",TRUE,"Pittsburgh Steelers",34,24,25,372,260,112,3,18,317,180,137,4,1996-11-10,1,1,"cin",10
"12","Sun","November 17","L","","4-7",FALSE,"Buffalo Bills",17,31,13,224,105,119,4,23,308,174,134,2,1996-11-17,-2,0,"cin",-14
"13","Sun","November 24","W","","5-7",TRUE,"Atlanta Falcons",41,31,24,463,342,121,0,21,417,305,112,4,1996-11-24,4,1,"cin",10
"14","Sun","December 1","L","","5-8",FALSE,"Jacksonville Jaguars",27,30,27,485,313,172,2,19,422,356,66,0,1996-12-01,-2,0,"cin",-3
"15","Sun","December 8","W","","6-8",TRUE,"Baltimore Ravens",21,14,25,360,267,93,0,21,322,199,123,1,1996-12-08,1,1,"cin",7
"16","Sun","December 15","W","","7-8",FALSE,"Houston Oilers",21,13,12,205,126,79,0,22,341,235,106,4,1996-12-15,4,1,"cin",8
"17","Sun","December 22","W","","8-8",TRUE,"Indianapolis Colts",31,24,26,441,284,157,3,16,266,231,35,2,1996-12-22,-1,1,"cin",7
"1","Sun","August 31","W","","1-0",TRUE,"Arizona Cardinals",24,21,21,317,230,87,1,18,323,248,75,2,1997-08-31,1,1,"cin",3
"2","Sun","September 7","L","","1-1",FALSE,"Baltimore Ravens",10,23,18,339,283,56,2,24,412,266,146,3,1997-09-07,1,0,"cin",-13
"4","Sun","September 21","L","","1-2",FALSE,"Denver Broncos",20,38,22,389,194,195,1,23,372,150,222,1,1997-09-21,0,0,"cin",-18
"5","Sun","September 28","L","","1-3",TRUE,"New York Jets",14,31,10,215,149,66,1,28,402,212,190,1,1997-09-28,0,0,"cin",-17
"6","Sun","October 5","L","","1-4",FALSE,"Jacksonville Jaguars",13,21,17,348,200,148,0,21,308,148,160,0,1997-10-05,0,0,"cin",-8
"7","Sun","October 12","L","","1-5",FALSE,"Tennessee Oilers",7,30,14,202,137,65,1,26,391,193,198,0,1997-10-12,-1,0,"cin",-23
"8","Sun","October 19","L","","1-6",TRUE,"Pittsburgh Steelers",10,26,13,236,165,71,4,24,412,246,166,2,1997-10-19,-2,0,"cin",-16
"9","Sun","October 26","L","","1-7",FALSE,"New York Giants",27,29,22,323,225,98,2,28,323,214,109,0,1997-10-26,-2,0,"cin",-2
"10","Sun","November 2","W","","2-7",TRUE,"San Diego Chargers",38,31,18,336,162,174,1,14,235,168,67,3,1997-11-02,2,1,"cin",7
"11","Sun","November 9","W","","3-7",FALSE,"Indianapolis Colts",28,13,17,273,129,144,1,22,341,191,150,4,1997-11-09,3,1,"cin",15
"12","Sun","November 16","L","","3-8",FALSE,"Pittsburgh Steelers",3,20,16,244,128,116,3,20,309,123,186,0,1997-11-16,-3,0,"cin",-17
"13","Sun","November 23","W","","4-8",TRUE,"Jacksonville Jaguars",31,26,24,327,203,124,0,20,415,280,135,3,1997-11-23,3,1,"cin",5
"14","Sun","November 30","L","","4-9",FALSE,"Philadelphia Eagles",42,44,29,497,373,124,3,27,507,311,196,2,1997-11-30,-1,0,"cin",-2
"15","Thu","December 4","W","","5-9",TRUE,"Tennessee Oilers",41,14,34,515,239,276,0,12,175,131,44,0,1997-12-04,0,1,"cin",27
"16","Sun","December 14","W","","6-9",TRUE,"Dallas Cowboys",31,24,17,419,262,157,2,29,402,274,128,2,1997-12-14,0,1,"cin",7
"17","Sun","December 21","W","","7-9",TRUE,"Baltimore Ravens",16,14,18,302,237,65,0,15,355,304,51,0,1997-12-21,0,1,"cin",2
"1","Sun","September 6","L","","0-1",TRUE,"Tennessee Oilers",14,23,16,292,192,100,1,19,353,264,89,0,1998-09-06,-1,0,"cin",-9
"2","Sun","September 13","W","OT","1-1",FALSE,"Detroit Lions",34,28,18,384,284,100,0,22,412,188,224,2,1998-09-13,2,1,"cin",6
"3","Sun","September 20","L","","1-2",TRUE,"Green Bay Packers",6,13,7,160,132,28,0,22,328,242,86,3,1998-09-20,3,0,"cin",-7
"4","Sun","September 27","L","","1-3",FALSE,"Baltimore Ravens",24,31,19,275,143,132,0,21,408,227,181,1,1998-09-27,1,0,"cin",-7
"6","Sun","October 11","W","","2-3",TRUE,"Pittsburgh Steelers",25,20,17,389,281,108,0,20,386,129,257,1,1998-10-11,1,1,"cin",5
"7","Sun","October 18","L","","2-4",FALSE,"Tennessee Oilers",14,44,14,332,184,148,1,24,515,344,171,0,1998-10-18,-1,0,"cin",-30
"8","Sun","October 25","L","","2-5",FALSE,"Oakland Raiders",10,27,14,170,108,62,3,23,411,160,251,0,1998-10-25,-3,0,"cin",-17
"9","Sun","November 1","L","","2-6",TRUE,"Denver Broncos",26,33,25,372,245,127,1,20,352,202,150,1,1998-11-01,0,0,"cin",-7
"10","Sun","November 8","L","","2-7",FALSE,"Jacksonville Jaguars",11,24,19,318,200,118,2,14,272,135,137,1,1998-11-08,-1,0,"cin",-13
"11","Sun","November 15","L","","2-8",FALSE,"Minnesota Vikings",3,24,15,194,91,103,2,16,349,224,125,3,1998-11-15,1,0,"cin",-21
"12","Sun","November 22","L","","2-9",TRUE,"Baltimore Ravens",13,20,16,242,184,58,2,18,338,91,247,2,1998-11-22,0,0,"cin",-7
"13","Sun","November 29","L","","2-10",TRUE,"Jacksonville Jaguars",17,34,20,355,224,131,4,16,322,243,79,0,1998-11-29,-4,0,"cin",-17
"14","Sun","December 6","L","","2-11",TRUE,"Buffalo Bills",20,33,15,234,176,58,1,21,448,309,139,3,1998-12-06,2,0,"cin",-13
"15","Sun","December 13","L","","2-12",FALSE,"Indianapolis Colts",26,39,22,378,223,155,0,21,338,210,128,0,1998-12-13,0,0,"cin",-13
"16","Sun","December 20","W","","3-12",FALSE,"Pittsburgh Steelers",25,24,23,483,359,124,2,11,211,86,125,2,1998-12-20,0,1,"cin",1
"17","Sun","December 27","L","","3-13",TRUE,"Tampa Bay Buccaneers",0,35,11,246,159,87,3,22,320,97,223,1,1998-12-27,-2,0,"cin",-35
"1","Sun","September 12","L","","0-1",FALSE,"Tennessee Titans",35,36,28,398,197,201,2,22,403,334,69,4,1999-09-12,2,0,"cin",-1
"2","Sun","September 19","L","","0-2",TRUE,"San Diego Chargers",7,34,10,180,133,47,5,14,266,175,91,0,1999-09-19,-5,0,"cin",-27
"3","Sun","September 26","L","","0-3",FALSE,"Carolina Panthers",3,27,20,372,243,129,1,13,343,197,146,2,1999-09-26,1,0,"cin",-24
"4","Sun","October 3","L","","0-4",TRUE,"St. Louis Rams",10,38,18,257,165,92,1,18,399,326,73,2,1999-10-03,1,0,"cin",-28
"5","Sun","October 10","W","","1-4",FALSE,"Cleveland Browns",18,17,25,419,204,215,1,13,224,144,80,1,1999-10-10,0,1,"cin",1
"6","Sun","October 17","L","","1-5",TRUE,"Pittsburgh Steelers",3,17,14,261,177,84,3,18,255,125,130,0,1999-10-17,-3,0,"cin",-14
"7","Sun","October 24","L","","1-6",FALSE,"Indianapolis Colts",10,31,12,254,149,105,0,18,335,278,57,1,1999-10-24,1,0,"cin",-21
"8","Sun","October 31","L","","1-7",TRUE,"Jacksonville Jaguars",10,41,14,300,207,93,3,23,377,194,183,0,1999-10-31,-3,0,"cin",-31
"9","Sun","November 7","L","","1-8",FALSE,"Seattle Seahawks",20,37,19,397,294,103,2,26,360,187,173,2,1999-11-07,0,0,"cin",-17
"10","Sun","November 14","L","","1-9",TRUE,"Tennessee Titans",14,24,15,264,197,67,4,16,247,98,149,1,1999-11-14,-3,0,"cin",-10
"11","Sun","November 21","L","","1-10",TRUE,"Baltimore Ravens",31,34,20,348,246,102,3,19,281,225,56,2,1999-11-21,-1,0,"cin",-3
"12","Sun","November 28","W","","2-10",FALSE,"Pittsburgh Steelers",27,20,18,415,235,180,1,20,391,280,111,3,1999-11-28,2,1,"cin",7
"13","Sun","December 5","W","","3-10",TRUE,"San Francisco 49ers",44,30,27,476,325,151,0,29,542,437,105,3,1999-12-05,3,1,"cin",14
"14","Sun","December 12","W","","4-10",TRUE,"Cleveland Browns",44,28,25,459,180,279,1,19,323,312,11,4,1999-12-12,3,1,"cin",16
"16","Sun","December 26","L","","4-11",FALSE,"Baltimore Ravens",0,22,15,241,148,93,3,18,311,181,130,1,1999-12-26,-2,0,"cin",-22
"17","Sun","January 2","L","","4-12",FALSE,"Jacksonville Jaguars",7,24,13,236,126,110,2,30,440,305,135,1,2000-01-02,-1,0,"cin",-17
"2","Sun","September 10","L","","0-1",TRUE,"Cleveland Browns",7,24,17,318,207,111,3,17,354,249,105,1,2000-09-10,-2,0,"cin",-17
"3","Sun","September 17","L","","0-2",FALSE,"Jacksonville Jaguars",0,13,14,233,162,71,4,15,241,157,84,1,2000-09-17,-3,0,"cin",-13
"4","Sun","September 24","L","","0-3",FALSE,"Baltimore Ravens",0,37,7,94,90,4,4,27,391,215,176,1,2000-09-24,-3,0,"cin",-37
"5","Sun","October 1","L","","0-4",TRUE,"Miami Dolphins",16,31,24,350,159,191,1,18,302,143,159,2,2000-10-01,1,0,"cin",-15
"6","Sun","October 8","L","","0-5",TRUE,"Tennessee Titans",14,23,7,213,84,129,2,21,417,214,203,2,2000-10-08,0,0,"cin",-9
"7","Sun","October 15","L","","0-6",FALSE,"Pittsburgh Steelers",0,15,12,232,112,120,3,13,274,171,103,0,2000-10-15,-3,0,"cin",-15
"8","Sun","October 22","W","","1-6",TRUE,"Denver Broncos",31,21,15,421,14,407,1,32,500,358,142,3,2000-10-22,2,1,"cin",10
"9","Sun","October 29","W","","2-6",FALSE,"Cleveland Browns",12,3,18,253,61,192,1,10,182,128,54,1,2000-10-29,0,1,"cin",9
"10","Sun","November 5","L","","2-7",TRUE,"Baltimore Ravens",7,27,11,174,130,44,1,19,378,236,142,0,2000-11-05,-1,0,"cin",-20
"11","Sun","November 12","L","","2-8",FALSE,"Dallas Cowboys",6,23,15,195,56,139,2,22,405,308,97,1,2000-11-12,-1,0,"cin",-17
"12","Sun","November 19","L","","2-9",FALSE,"New England Patriots",13,16,25,365,228,137,2,17,291,252,39,1,2000-11-19,-1,0,"cin",-3
"13","Sun","November 26","L","","2-10",TRUE,"Pittsburgh Steelers",28,48,23,309,100,209,3,21,372,187,185,0,2000-11-26,-3,0,"cin",-20
"14","Sun","December 3","W","","3-10",TRUE,"Arizona Cardinals",24,13,27,398,106,292,1,15,340,268,72,2,2000-12-03,1,1,"cin",11
"15","Sun","December 10","L","","3-11",FALSE,"Tennessee Titans",3,35,9,171,111,60,0,21,443,331,112,1,2000-12-10,1,0,"cin",-32
"16","Sun","December 17","W","","4-11",TRUE,"Jacksonville Jaguars",17,14,15,263,157,106,4,17,276,162,114,1,2000-12-17,-3,1,"cin",3
"17","Sun","December 24","L","","4-12",FALSE,"Philadelphia Eagles",7,16,15,271,169,102,3,22,321,183,138,4,2000-12-24,1,0,"cin",-9
"1","Sun","September 9","W","","1-0",TRUE,"New England Patriots",23,17,18,353,196,157,1,16,292,224,68,0,2001-09-09,-1,1,"cin",6
"2","Sun","September 23","W","","2-0",TRUE,"Baltimore Ravens",21,10,13,203,136,67,1,24,382,318,64,6,2001-09-23,5,1,"cin",11
"3","Sun","September 30","L","","2-1",FALSE,"San Diego Chargers",14,28,17,237,126,111,4,16,245,112,133,0,2001-09-30,-4,0,"cin",-14
"4","Sun","October 7","L","","2-2",FALSE,"Pittsburgh Steelers",7,16,15,214,149,65,1,19,413,138,275,2,2001-10-07,1,0,"cin",-9
"5","Sun","October 14","W","","3-2",TRUE,"Cleveland Browns",24,14,23,400,201,199,0,15,211,171,40,1,2001-10-14,1,1,"cin",10
"6","Sun","October 21","L","","3-3",TRUE,"Chicago Bears",0,24,16,264,229,35,1,21,435,232,203,1,2001-10-21,0,0,"cin",-24
"7","Sun","October 28","W","","4-3",FALSE,"Detroit Lions",31,27,21,412,188,224,2,17,276,215,61,3,2001-10-28,1,1,"cin",4
"9","Sun","November 11","L","","4-4",FALSE,"Jacksonville Jaguars",13,30,18,352,279,73,1,21,261,164,97,0,2001-11-11,-1,0,"cin",-17
"10","Sun","November 18","L","","4-5",TRUE,"Tennessee Titans",7,20,17,264,224,40,3,13,293,164,129,2,2001-11-18,-1,0,"cin",-13
"11","Sun","November 25","L","","4-6",FALSE,"Cleveland Browns",0,18,12,191,107,84,7,14,249,171,78,3,2001-11-25,-4,0,"cin",-18
"12","Sun","December 2","L","OT","4-7",TRUE,"Tampa Bay Buccaneers",13,16,17,201,115,86,2,19,264,199,65,1,2001-12-02,-1,0,"cin",-3
"13","Sun","December 9","L","","4-8",TRUE,"Jacksonville Jaguars",10,14,12,200,140,60,1,17,255,193,62,1,2001-12-09,0,0,"cin",-4
"14","Sun","December 16","L","","4-9",FALSE,"New York Jets",14,15,17,248,128,120,3,17,309,196,113,0,2001-12-16,-3,0,"cin",-1
"15","Sun","December 23","L","","4-10",FALSE,"Baltimore Ravens",0,16,21,281,131,150,4,20,305,148,157,1,2001-12-23,-3,0,"cin",-16
"16","Sun","December 30","W","OT","5-10",TRUE,"Pittsburgh Steelers",26,23,32,544,403,141,3,16,313,240,73,5,2001-12-30,2,1,"cin",3
"17","Sun","January 6","W","","6-10",FALSE,"Tennessee Titans",23,21,25,436,336,100,3,16,329,272,57,2,2002-01-06,-1,1,"cin",2
"1","Sun","September 8","L","","0-1",TRUE,"San Diego Chargers",6,34,13,203,167,36,1,27,401,160,241,0,2002-09-08,-1,0,"cin",-28
"2","Sun","September 15","L","","0-2",FALSE,"Cleveland Browns",7,20,28,357,201,156,3,15,265,190,75,0,2002-09-15,-3,0,"cin",-13
"3","Sun","September 22","L","","0-3",FALSE,"Atlanta Falcons",3,30,11,191,125,66,2,18,306,163,143,0,2002-09-22,-2,0,"cin",-27
"4","Sun","September 29","L","","0-4",TRUE,"Tampa Bay Buccaneers",7,35,11,168,94,74,2,17,363,262,101,3,2002-09-29,1,0,"cin",-28
"5","Sun","October 6","L","","0-5",FALSE,"Indianapolis Colts",21,28,23,410,237,173,4,19,311,224,87,1,2002-10-06,-3,0,"cin",-7
"6","Sun","October 13","L","","0-6",TRUE,"Pittsburgh Steelers",7,34,18,268,190,78,4,21,408,197,211,2,2002-10-13,-2,0,"cin",-27
"8","Sun","October 27","L","","0-7",TRUE,"Tennessee Titans",24,30,22,384,193,191,1,20,342,208,134,1,2002-10-27,0,0,"cin",-6
"9","Sun","November 3","W","","1-7",FALSE,"Houston Texans",38,3,25,390,263,127,0,22,268,186,82,2,2002-11-03,2,1,"cin",35
"10","Sun","November 10","L","","1-8",FALSE,"Baltimore Ravens",27,38,20,372,249,123,4,21,325,163,162,2,2002-11-10,-2,0,"cin",-11
"11","Sun","November 17","L","","1-9",TRUE,"Cleveland Browns",20,27,14,350,248,102,1,22,382,242,140,1,2002-11-17,0,0,"cin",-7
"12","Sun","November 24","L","","1-10",FALSE,"Pittsburgh Steelers",21,29,17,352,298,54,1,21,391,235,156,0,2002-11-24,-1,0,"cin",-8
"13","Sun","December 1","L","","1-11",TRUE,"Baltimore Ravens",23,27,25,381,303,78,2,15,247,99,148,0,2002-12-01,-2,0,"cin",-4
"14","Sun","December 8","L","","1-12",FALSE,"Carolina Panthers",31,52,25,340,257,83,1,23,401,319,82,3,2002-12-08,2,0,"cin",-21
"15","Sun","December 15","L","","1-13",TRUE,"Jacksonville Jaguars",15,29,19,300,235,65,2,20,321,212,109,0,2002-12-15,-2,0,"cin",-14
"16","Sun","December 22","W","","2-13",TRUE,"New Orleans Saints",20,13,25,423,183,240,4,11,210,177,33,2,2002-12-22,-2,1,"cin",7
"17","Sun","December 29","L","","2-14",FALSE,"Buffalo Bills",9,27,19,317,233,84,3,23,324,225,99,3,2002-12-29,0,0,"cin",-18
"1","Sun","September 7","L","","0-1",TRUE,"Denver Broncos",10,30,15,294,243,51,4,19,293,109,184,3,2003-09-07,-1,0,"cin",-20
"2","Sun","September 14","L","","0-2",FALSE,"Oakland Raiders",20,23,27,416,287,129,2,12,237,103,134,0,2003-09-14,-2,0,"cin",-3
"3","Sun","September 21","L","","0-3",TRUE,"Pittsburgh Steelers",10,17,11,182,125,57,1,22,376,238,138,1,2003-09-21,0,0,"cin",-7
"4","Sun","September 28","W","","1-3",FALSE,"Cleveland Browns",21,14,17,295,215,80,0,18,339,270,69,1,2003-09-28,1,1,"cin",7
"5","Sun","October 5","L","OT","1-4",FALSE,"Buffalo Bills",16,22,18,279,212,67,2,17,257,177,80,0,2003-10-05,-2,0,"cin",-6
"7","Sun","October 19","W","","2-4",TRUE,"Baltimore Ravens",34,26,17,303,244,59,0,21,401,281,120,3,2003-10-19,3,1,"cin",8
"8","Sun","October 26","W","","3-4",TRUE,"Seattle Seahawks",27,24,19,412,218,194,0,24,459,338,121,5,2003-10-26,5,1,"cin",3
"9","Sun","November 2","L","","3-5",FALSE,"Arizona Cardinals",14,17,17,263,215,48,2,20,304,143,161,1,2003-11-02,-1,0,"cin",-3
"10","Sun","November 9","W","","4-5",TRUE,"Houston Texans",34,27,27,422,182,240,1,13,269,129,140,1,2003-11-09,0,1,"cin",7
"11","Sun","November 16","W","","5-5",TRUE,"Kansas City Chiefs",24,19,21,422,222,200,0,20,371,304,67,0,2003-11-16,0,1,"cin",5
"12","Sun","November 23","W","","6-5",FALSE,"San Diego Chargers",34,27,33,444,234,210,1,17,325,207,118,0,2003-11-23,-1,1,"cin",7
"13","Sun","November 30","W","","7-5",FALSE,"Pittsburgh Steelers",24,20,18,379,266,113,0,23,384,299,85,2,2003-11-30,2,1,"cin",4
"14","Sun","December 7","L","","7-6",FALSE,"Baltimore Ravens",13,31,15,268,168,100,5,21,353,130,223,3,2003-12-07,-2,0,"cin",-18
"15","Sun","December 14","W","","8-6",TRUE,"San Francisco 49ers",41,38,23,393,168,225,0,31,502,331,171,3,2003-12-14,3,1,"cin",3
"16","Sun","December 21","L","","8-7",FALSE,"St. Louis Rams",10,27,14,286,187,99,3,23,371,228,143,1,2003-12-21,-2,0,"cin",-17
"17","Sun","December 28","L","","8-8",TRUE,"Cleveland Browns",14,22,21,271,156,115,1,19,379,115,264,0,2003-12-28,-1,0,"cin",-8
"1","Sun","September 12","L","","0-1",FALSE,"New York Jets",24,31,19,351,238,113,2,24,438,219,219,1,2004-09-12,-1,0,"cin",-7
"2","Sun","September 19","W","","1-1",TRUE,"Miami Dolphins",16,13,12,210,116,94,1,11,226,201,25,3,2004-09-19,2,1,"cin",3
"3","Sun","September 26","L","","1-2",TRUE,"Baltimore Ravens",9,23,26,398,289,109,4,14,380,126,254,2,2004-09-26,-2,0,"cin",-14
"4","Sun","October 3","L","","1-3",FALSE,"Pittsburgh Steelers",17,28,22,293,156,137,3,23,333,168,165,2,2004-10-03,-1,0,"cin",-11
"6","Sun","October 17","L","","1-4",FALSE,"Cleveland Browns",17,34,11,189,131,58,1,21,449,310,139,4,2004-10-17,3,0,"cin",-17
"7","Mon","October 25","W","","2-4",TRUE,"Denver Broncos",23,10,13,321,188,133,1,22,318,195,123,3,2004-10-25,2,1,"cin",13
"8","Sun","October 31","L","","2-5",FALSE,"Tennessee Titans",20,27,16,274,217,57,2,22,358,195,163,1,2004-10-31,-1,0,"cin",-7
"9","Sun","November 7","W","","3-5",TRUE,"Dallas Cowboys",26,3,15,328,212,116,0,13,311,202,109,5,2004-11-07,5,1,"cin",23
"10","Sun","November 14","W","","4-5",FALSE,"Washington Redskins",17,10,19,316,217,99,3,17,268,181,87,3,2004-11-14,0,1,"cin",7
"11","Sun","November 21","L","","4-6",TRUE,"Pittsburgh Steelers",14,19,10,209,147,62,1,21,235,84,151,1,2004-11-21,0,0,"cin",-5
"12","Sun","November 28","W","","5-6",TRUE,"Cleveland Browns",58,48,26,504,251,253,3,23,462,386,76,2,2004-11-28,-1,1,"cin",10
"13","Sun","December 5","W","","6-6",FALSE,"Baltimore Ravens",27,26,23,453,355,98,2,21,356,164,192,2,2004-12-05,0,1,"cin",1
"14","Sun","December 12","L","","6-7",FALSE,"New England Patriots",28,35,26,478,328,150,3,22,351,257,94,0,2004-12-12,-3,0,"cin",-7
"15","Sun","December 19","L","","6-8",TRUE,"Buffalo Bills",17,33,16,275,126,149,4,13,212,169,43,1,2004-12-19,-3,0,"cin",-16
"16","Sun","December 26","W","","7-8",TRUE,"New York Giants",23,22,16,233,170,63,2,18,326,184,142,1,2004-12-26,-1,1,"cin",1
"17","Sun","January 2","W","","8-8",FALSE,"Philadelphia Eagles",38,10,16,308,160,148,0,18,342,262,80,5,2005-01-02,5,1,"cin",28
"1","Sun","September 11","W","","1-0",FALSE,"Cleveland Browns",27,13,26,420,272,148,2,16,373,278,95,3,2005-09-11,1,1,"cin",14
"2","Sun","September 18","W","","2-0",TRUE,"Minnesota Vikings",37,8,26,504,337,167,1,21,304,227,77,7,2005-09-18,6,1,"cin",29
"3","Sun","September 25","W","","3-0",FALSE,"Chicago Bears",24,7,11,244,161,83,1,16,255,149,106,6,2005-09-25,5,1,"cin",17
"4","Sun","October 2","W","","4-0",TRUE,"Houston Texans",16,10,22,371,273,98,0,18,254,128,126,1,2005-10-02,1,1,"cin",6
"5","Sun","October 9","L","","4-1",FALSE,"Jacksonville Jaguars",20,23,20,364,232,132,1,19,342,161,181,1,2005-10-09,0,0,"cin",-3
"6","Sun","October 16","W","","5-1",FALSE,"Tennessee Titans",31,23,24,387,268,119,0,21,377,259,118,3,2005-10-16,3,1,"cin",8
"7","Sun","October 23","L","","5-2",TRUE,"Pittsburgh Steelers",13,27,20,302,211,91,2,20,304,83,221,2,2005-10-23,0,0,"cin",-14
"8","Sun","October 30","W","","6-2",TRUE,"Green Bay Packers",21,14,21,317,222,95,1,23,353,277,76,5,2005-10-30,4,1,"cin",7
"9","Sun","November 6","W","","7-2",FALSE,"Baltimore Ravens",21,9,25,329,234,95,1,17,240,122,118,1,2005-11-06,0,1,"cin",12
"11","Sun","November 20","L","","7-3",TRUE,"Indianapolis Colts",37,45,23,492,328,164,1,28,451,359,92,1,2005-11-20,0,0,"cin",-8
"12","Sun","November 27","W","","8-3",TRUE,"Baltimore Ravens",42,29,23,437,302,135,3,23,322,189,133,3,2005-11-27,0,1,"cin",13
"13","Sun","December 4","W","","9-3",FALSE,"Pittsburgh Steelers",38,31,21,324,222,102,0,28,474,379,95,4,2005-12-04,4,1,"cin",7
"14","Sun","December 11","W","","10-3",TRUE,"Cleveland Browns",23,20,18,278,93,185,1,15,208,124,84,1,2005-12-11,0,1,"cin",3
"15","Sun","December 18","W","","11-3",FALSE,"Detroit Lions",41,17,29,426,271,155,2,13,270,211,59,4,2005-12-18,2,1,"cin",24
"16","Sat","December 24","L","","11-4",TRUE,"Buffalo Bills",27,37,23,374,270,104,2,19,355,288,67,1,2005-12-24,-1,0,"cin",-10
"17","Sun","January 1","L","","11-5",FALSE,"Kansas City Chiefs",3,37,10,161,124,37,2,24,537,335,202,1,2006-01-01,-1,0,"cin",-34
"WildCard","Sun","January 8","L","","11-6",TRUE,"Pittsburgh Steelers",17,31,19,327,243,84,2,19,346,202,144,0,2006-01-08,-2,0,"cin",-14
"1","Sun","September 10","W","","1-0",FALSE,"Kansas City Chiefs",23,10,12,236,120,116,1,18,289,176,113,3,2006-09-10,2,1,"cin",13
"2","Sun","September 17","W","","2-0",TRUE,"Cleveland Browns",34,17,27,481,321,160,2,17,301,244,57,3,2006-09-17,1,1,"cin",17
"3","Sun","September 24","W","","3-0",FALSE,"Pittsburgh Steelers",28,20,15,246,159,87,3,27,365,195,170,5,2006-09-24,2,1,"cin",8
"4","Sun","October 1","L","","3-1",TRUE,"New England Patriots",13,38,17,279,208,71,2,26,424,188,236,1,2006-10-01,-1,0,"cin",-25
"6","Sun","October 15","L","","3-2",FALSE,"Tampa Bay Buccaneers",13,14,14,305,252,53,0,21,300,174,126,1,2006-10-15,1,0,"cin",-1
"7","Sun","October 22","W","","4-2",TRUE,"Carolina Panthers",17,14,22,342,230,112,0,17,277,217,60,1,2006-10-22,1,1,"cin",3
"8","Sun","October 29","L","","4-3",TRUE,"Atlanta Falcons",27,29,22,331,258,73,1,25,420,277,143,0,2006-10-29,-1,0,"cin",-2
"9","Sun","November 5","L","","4-4",FALSE,"Baltimore Ravens",20,26,16,275,182,93,3,21,374,245,129,0,2006-11-05,-3,0,"cin",-6
"10","Sun","November 12","L","","4-5",TRUE,"San Diego Chargers",41,49,29,545,417,128,1,25,431,324,107,0,2006-11-12,-1,0,"cin",-8
"11","Sun","November 19","W","","5-5",FALSE,"New Orleans Saints",31,16,15,385,266,119,1,29,595,504,91,4,2006-11-19,3,1,"cin",15
"12","Sun","November 26","W","","6-5",FALSE,"Cleveland Browns",30,0,24,388,300,88,1,9,203,152,51,5,2006-11-26,4,1,"cin",30
"13","Thu","November 30","W","","7-5",TRUE,"Baltimore Ravens",13,7,14,294,227,67,0,15,316,227,89,1,2006-11-30,1,1,"cin",6
"14","Sun","December 10","W","","8-5",TRUE,"Oakland Raiders",27,10,28,439,303,136,4,14,223,178,45,2,2006-12-10,-2,1,"cin",17
"15","Mon","December 18","L","","8-6",FALSE,"Indianapolis Colts",16,34,20,278,145,133,1,27,394,282,112,1,2006-12-18,0,0,"cin",-18
"16","Sun","December 24","L","","8-7",FALSE,"Denver Broncos",23,24,23,343,194,149,4,17,287,160,127,2,2006-12-24,-2,0,"cin",-1
"17","Sun","December 31","L","OT","8-8",TRUE,"Pittsburgh Steelers",17,23,15,295,251,44,0,29,482,275,207,2,2006-12-31,2,0,"cin",-6
"1","Mon","September 10","W","","1-0",TRUE,"Baltimore Ravens",27,20,13,236,181,55,2,20,314,207,107,6,2007-09-10,4,1,"cin",7
"2","Sun","September 16","L","","1-1",FALSE,"Cleveland Browns",45,51,33,531,394,137,3,23,554,328,226,1,2007-09-16,-2,0,"cin",-6
"3","Sun","September 23","L","","1-2",FALSE,"Seattle Seahawks",21,24,24,412,328,84,4,19,340,238,102,2,2007-09-23,-2,0,"cin",-3
"4","Mon","October 1","L","","1-3",TRUE,"New England Patriots",13,34,17,283,226,57,2,25,404,231,173,1,2007-10-01,-1,0,"cin",-21
"6","Sun","October 14","L","","1-4",FALSE,"Kansas City Chiefs",20,27,22,373,295,78,3,20,354,233,121,2,2007-10-14,-1,0,"cin",-7
"7","Sun","October 21","W","","2-4",TRUE,"New York Jets",38,31,26,395,218,177,1,19,342,258,84,2,2007-10-21,1,1,"cin",7
"8","Sun","October 28","L","","2-5",TRUE,"Pittsburgh Steelers",13,24,15,296,205,91,1,23,390,230,160,1,2007-10-28,0,0,"cin",-11
"9","Sun","November 4","L","","2-6",FALSE,"Buffalo Bills",21,33,16,299,271,28,1,23,479,303,176,1,2007-11-04,0,0,"cin",-12
"10","Sun","November 11","W","","3-6",FALSE,"Baltimore Ravens",21,7,17,326,256,70,0,16,272,206,66,6,2007-11-11,6,1,"cin",14
"11","Sun","November 18","L","","3-7",TRUE,"Arizona Cardinals",27,35,21,396,324,72,5,17,247,197,50,0,2007-11-18,-5,0,"cin",-8
"12","Sun","November 25","W","","4-7",TRUE,"Tennessee Titans",35,6,30,426,278,148,1,10,305,244,61,2,2007-11-25,1,1,"cin",29
"13","Sun","December 2","L","","4-8",FALSE,"Pittsburgh Steelers",10,24,15,249,175,74,1,20,285,184,101,4,2007-12-02,3,0,"cin",-14
"14","Sun","December 9","W","","5-8",TRUE,"St. Louis Rams",19,10,18,370,178,192,2,10,241,153,88,2,2007-12-09,0,1,"cin",9
"15","Sat","December 15","L","","5-9",FALSE,"San Francisco 49ers",13,20,15,313,252,61,0,22,337,181,156,0,2007-12-15,0,0,"cin",-7
"16","Sun","December 23","W","","6-9",TRUE,"Cleveland Browns",19,14,15,270,115,155,3,25,380,244,136,4,2007-12-23,1,1,"cin",5
"17","Sun","December 30","W","","7-9",FALSE,"Miami Dolphins",38,25,23,393,316,77,1,21,336,250,86,1,2007-12-30,0,1,"cin",13
"1","Sun","September 7","L","","0-1",FALSE,"Baltimore Ravens",10,17,8,154,84,70,2,21,358,129,229,2,2008-09-07,0,0,"cin",-7
"2","Sun","September 14","L","","0-2",TRUE,"Tennessee Titans",7,24,11,215,127,88,2,16,295,118,177,1,2008-09-14,-1,0,"cin",-17
"3","Sun","September 21","L","OT","0-3",FALSE,"New York Giants",23,26,24,347,245,102,0,24,406,289,117,0,2008-09-21,0,0,"cin",-3
"4","Sun","September 28","L","","0-4",TRUE,"Cleveland Browns",12,20,14,211,142,69,5,19,261,127,134,2,2008-09-28,-3,0,"cin",-8
"5","Sun","October 5","L","","0-5",FALSE,"Dallas Cowboys",22,31,18,269,208,61,2,18,373,175,198,2,2008-10-05,0,0,"cin",-9
"6","Sun","October 12","L","","0-6",FALSE,"New York Jets",14,26,13,171,128,43,1,19,252,166,86,3,2008-10-12,2,0,"cin",-12
"7","Sun","October 19","L","","0-7",TRUE,"Pittsburgh Steelers",10,38,16,212,128,84,1,20,375,250,125,0,2008-10-19,-1,0,"cin",-28
"8","Sun","October 26","L","","0-8",FALSE,"Houston Texans",6,35,16,253,148,105,3,23,384,275,109,0,2008-10-26,-3,0,"cin",-29
"9","Sun","November 2","W","","1-8",TRUE,"Jacksonville Jaguars",21,19,20,312,153,159,2,9,282,214,68,1,2008-11-02,-1,1,"cin",2
"11","Sun","November 16","T","OT","1-8-1",TRUE,"Philadelphia Eagles",13,13,19,282,226,56,1,16,391,323,68,4,2008-11-16,3,0,"cin",0
"12","Thu","November 20","L","","1-9-1",FALSE,"Pittsburgh Steelers",10,27,11,208,165,43,1,20,364,243,121,1,2008-11-20,0,0,"cin",-17
"13","Sun","November 30","L","","1-10-1",TRUE,"Baltimore Ravens",3,34,6,155,98,57,1,20,451,304,147,0,2008-11-30,-1,0,"cin",-31
"14","Sun","December 7","L","","1-11-1",FALSE,"Indianapolis Colts",3,35,17,252,170,82,4,20,334,277,57,1,2008-12-07,-3,0,"cin",-32
"15","Sun","December 14","W","","2-11-1",TRUE,"Washington Redskins",20,13,17,310,204,106,0,15,280,167,113,2,2008-12-14,2,1,"cin",7
"16","Sun","December 21","W","","3-11-1",FALSE,"Cleveland Browns",14,0,12,246,55,191,1,13,182,41,141,4,2008-12-21,3,1,"cin",14
"17","Sun","December 28","W","","4-11-1",TRUE,"Kansas City Chiefs",16,6,23,329,125,204,0,14,220,189,31,1,2008-12-28,1,1,"cin",10
"1","Sun","September 13","L","","0-1",TRUE,"Denver Broncos",7,12,16,307,221,86,2,10,302,227,75,0,2009-09-13,-2,0,"cin",-5
"2","Sun","September 20","W","","1-1",FALSE,"Green Bay Packers",31,24,19,319,168,151,2,22,311,222,89,1,2009-09-20,-1,1,"cin",7
"3","Sun","September 27","W","","2-1",TRUE,"Pittsburgh Steelers",23,20,19,273,173,100,0,17,373,271,102,1,2009-09-27,1,1,"cin",3
"4","Sun","October 4","W","OT","3-1",FALSE,"Cleveland Browns",23,20,21,375,221,154,2,22,395,249,146,2,2009-10-04,0,1,"cin",3
"5","Sun","October 11","W","","4-1",FALSE,"Baltimore Ravens",17,14,22,403,261,142,2,12,257,175,82,2,2009-10-11,0,1,"cin",3
"6","Sun","October 18","L","","4-2",TRUE,"Houston Texans",17,28,14,296,250,46,3,26,472,385,87,2,2009-10-18,-1,0,"cin",-11
"7","Sun","October 25","W","","5-2",TRUE,"Chicago Bears",45,10,30,448,233,215,0,15,279,244,35,4,2009-10-25,4,1,"cin",35
"9","Sun","November 8","W","","6-2",TRUE,"Baltimore Ravens",17,7,20,369,223,146,1,16,215,160,55,2,2009-11-08,1,1,"cin",10
"10","Sun","November 15","W","","7-2",FALSE,"Pittsburgh Steelers",18,12,14,218,157,61,0,16,226,146,80,1,2009-11-15,1,1,"cin",6
"11","Sun","November 22","L","","7-3",FALSE,"Oakland Raiders",17,20,23,348,171,177,4,16,275,183,92,3,2009-11-22,-1,0,"cin",-3
"12","Sun","November 29","W","","8-3",TRUE,"Cleveland Browns",16,7,21,306,96,210,0,11,169,111,58,0,2009-11-29,0,1,"cin",9
"13","Sun","December 6","W","","9-3",TRUE,"Detroit Lions",23,13,22,321,202,119,3,14,245,165,80,2,2009-12-06,-1,1,"cin",10
"14","Sun","December 13","L","","9-4",FALSE,"Minnesota Vikings",10,30,13,210,91,119,1,21,322,180,142,1,2009-12-13,0,0,"cin",-20
"15","Sun","December 20","L","","9-5",FALSE,"San Diego Chargers",24,27,19,407,293,114,1,20,366,296,70,2,2009-12-20,1,0,"cin",-3
"16","Sun","December 27","W","","10-5",TRUE,"Kansas City Chiefs",17,10,17,274,130,144,1,17,295,172,123,2,2009-12-27,1,1,"cin",7
"17","Sun","January 3","L","","10-6",FALSE,"New York Jets",0,37,5,72,0,72,3,21,320,63,257,0,2010-01-03,-3,0,"cin",-37
"WildCard","Sat","January 9","L","","10-7",TRUE,"New York Jets",14,24,18,281,110,171,2,15,353,182,171,0,2010-01-09,-2,0,"cin",-10
"1","Sun","September 12","L","","0-1",FALSE,"New England Patriots",24,38,26,428,341,87,2,20,376,258,118,0,2010-09-12,-2,0,"cin",-14
"2","Sun","September 19","W","","1-1",TRUE,"Baltimore Ravens",15,10,14,253,159,94,0,14,259,150,109,4,2010-09-19,4,1,"cin",5
"3","Sun","September 26","W","","2-1",FALSE,"Carolina Panthers",20,7,21,305,185,120,2,17,267,180,87,4,2010-09-26,2,1,"cin",13
"4","Sun","October 3","L","","2-2",FALSE,"Cleveland Browns",20,23,21,413,346,67,2,21,295,179,116,1,2010-10-03,-1,0,"cin",-3
"5","Sun","October 10","L","","2-3",TRUE,"Tampa Bay Buccaneers",21,24,20,358,209,149,4,21,391,266,125,3,2010-10-10,-1,0,"cin",-3
"7","Sun","October 24","L","","2-4",FALSE,"Atlanta Falcons",32,39,28,469,385,84,1,22,452,299,153,2,2010-10-24,1,0,"cin",-7
"8","Sun","October 31","L","","2-5",TRUE,"Miami Dolphins",14,22,16,262,156,106,1,20,354,217,137,2,2010-10-31,1,0,"cin",-8
"9","Mon","November 8","L","","2-6",TRUE,"Pittsburgh Steelers",21,27,18,272,218,54,2,14,314,193,121,2,2010-11-08,0,0,"cin",-6
"10","Sun","November 14","L","","2-7",FALSE,"Indianapolis Colts",17,23,19,341,269,72,5,16,256,180,76,0,2010-11-14,-5,0,"cin",-6
"11","Sun","November 21","L","","2-8",TRUE,"Buffalo Bills",31,49,26,361,228,133,3,23,449,308,141,2,2010-11-21,-1,0,"cin",-18
"12","Thu","November 25","L","","2-9",FALSE,"New York Jets",10,26,13,163,117,46,3,18,319,149,170,1,2010-11-25,-2,0,"cin",-16
"13","Sun","December 5","L","","2-10",TRUE,"New Orleans Saints",30,34,21,311,215,96,0,19,436,290,146,1,2010-12-05,1,0,"cin",-4
"14","Sun","December 12","L","","2-11",FALSE,"Pittsburgh Steelers",7,23,14,190,156,34,3,18,354,231,123,0,2010-12-12,-3,0,"cin",-16
"15","Sun","December 19","W","","3-11",TRUE,"Cleveland Browns",19,17,22,397,209,188,0,14,278,219,59,0,2010-12-19,0,1,"cin",2
"16","Sun","December 26","W","","4-11",TRUE,"San Diego Chargers",34,20,18,371,269,102,1,23,313,249,64,2,2010-12-26,1,1,"cin",14
"17","Sun","January 2","L","","4-12",FALSE,"Baltimore Ravens",7,13,20,395,305,90,5,10,199,101,98,2,2011-01-02,-3,0,"cin",-6
"1","Sun","September 11","W","","1-0",FALSE,"Cleveland Browns",27,17,17,294,155,139,0,17,285,202,83,1,2011-09-11,1,1,"cin",10
"2","Sun","September 18","L","","1-1",FALSE,"Denver Broncos",22,24,18,382,310,72,0,19,318,187,131,2,2011-09-18,2,0,"cin",-2
"3","Sun","September 25","L","","1-2",TRUE,"San Francisco 49ers",8,13,14,228,149,79,3,16,226,176,50,1,2011-09-25,-2,0,"cin",-5
"4","Sun","October 2","W","","2-2",TRUE,"Buffalo Bills",23,20,25,458,287,171,2,12,273,190,83,0,2011-10-02,-2,1,"cin",3
"5","Sun","October 9","W","","3-2",FALSE,"Jacksonville Jaguars",30,20,13,239,162,77,1,12,296,200,96,2,2011-10-09,1,1,"cin",10
"6","Sun","October 16","W","","4-2",TRUE,"Indianapolis Colts",27,17,17,358,264,94,0,18,273,179,94,3,2011-10-16,3,1,"cin",10
"8","Sun","October 30","W","","5-2",FALSE,"Seattle Seahawks",34,12,18,252,160,92,2,20,411,350,61,2,2011-10-30,0,1,"cin",22
"9","Sun","November 6","W","","6-2",FALSE,"Tennessee Titans",24,17,20,319,210,109,0,19,328,250,78,1,2011-11-06,1,1,"cin",7
"10","Sun","November 13","L","","6-3",TRUE,"Pittsburgh Steelers",17,24,14,279,170,109,2,24,328,223,105,1,2011-11-13,-1,0,"cin",-7
"11","Sun","November 20","L","","6-4",FALSE,"Baltimore Ravens",24,31,23,483,364,119,3,13,373,268,105,1,2011-11-20,-2,0,"cin",-7
"12","Sun","November 27","W","","7-4",TRUE,"Cleveland Browns",23,20,18,389,257,132,1,17,274,140,134,1,2011-11-27,0,1,"cin",3
"13","Sun","December 4","L","","7-5",FALSE,"Pittsburgh Steelers",7,35,13,232,128,104,2,22,295,159,136,0,2011-12-04,-2,0,"cin",-28
"14","Sun","December 11","L","","7-6",TRUE,"Houston Texans",19,20,16,285,184,101,2,25,412,268,144,4,2011-12-11,2,0,"cin",-1
"15","Sun","December 18","W","","8-6",FALSE,"St. Louis Rams",20,13,19,283,173,110,1,18,305,210,95,0,2011-12-18,-1,1,"cin",7
"16","Sat","December 24","W","","9-6",TRUE,"Arizona Cardinals",23,16,21,301,136,165,2,17,316,257,59,3,2011-12-24,1,1,"cin",7
"17","Sun","January 1","L","","9-7",TRUE,"Baltimore Ravens",16,24,19,336,231,105,1,15,347,126,221,0,2012-01-01,-1,0,"cin",-8
"WildCard","Sat","January 7","L","","9-8",FALSE,"Houston Texans",10,31,21,300,224,76,3,19,340,152,188,0,2012-01-07,-3,0,"cin",-21
"1","Sun","September 8","W","","1-0",TRUE,"Indianapolis Colts",45,3,30,445,282,163,1,9,159,112,47,2,1985-09-08,1,1,"pit",42
"2","Mon","September 16","L","","1-1",FALSE,"Cleveland Browns",7,17,15,216,162,54,2,21,293,148,145,1,1985-09-16,-1,0,"pit",-10
"3","Sun","September 22","W","","2-1",TRUE,"Houston Oilers",20,0,22,335,102,233,0,8,134,84,50,2,1985-09-22,2,1,"pit",20
"4","Mon","September 30","L","","2-2",TRUE,"Cincinnati Bengals",24,37,27,453,340,113,3,23,366,144,222,2,1985-09-30,-1,0,"pit",-13
"5","Sun","October 6","L","","2-3",FALSE,"Miami Dolphins",20,24,15,282,145,137,1,24,399,277,122,4,1985-10-06,3,0,"pit",-4
"6","Sun","October 13","L","","2-4",FALSE,"Dallas Cowboys",13,27,14,315,231,84,3,18,374,241,133,2,1985-10-13,-1,0,"pit",-14
"7","Sun","October 20","W","","3-4",TRUE,"St. Louis Cardinals",23,10,15,326,184,142,1,22,286,160,126,3,1985-10-20,2,1,"pit",13
"8","Sun","October 27","L","","3-5",FALSE,"Cincinnati Bengals",21,26,14,256,169,87,6,20,306,221,85,2,1985-10-27,-4,0,"pit",-5
"9","Sun","November 3","W","","4-5",TRUE,"Cleveland Browns",10,9,17,238,83,155,0,9,153,87,66,0,1985-11-03,0,1,"pit",1
"10","Sun","November 10","W","","5-5",FALSE,"Kansas City Chiefs",36,28,17,396,251,145,1,13,295,259,36,2,1985-11-10,1,1,"pit",8
"11","Sun","November 17","W","","6-5",FALSE,"Houston Oilers",30,7,24,378,130,248,2,10,162,56,106,2,1985-11-17,0,1,"pit",23
"12","Sun","November 24","L","","6-6",TRUE,"Washington Redskins",23,30,20,308,206,102,3,16,259,176,83,1,1985-11-24,-2,0,"pit",-7
"13","Sun","December 1","L","","6-7",TRUE,"Denver Broncos",23,31,22,327,250,77,4,20,331,238,93,1,1985-12-01,-3,0,"pit",-8
"14","Sun","December 8","L","","6-8",FALSE,"San Diego Chargers",44,54,28,427,275,152,4,23,448,364,84,3,1985-12-08,-1,0,"pit",-10
"15","Sun","December 15","W","","7-8",TRUE,"Buffalo Bills",30,24,25,434,264,170,3,14,323,134,189,5,1985-12-15,2,1,"pit",6
"16","Sat","December 21","L","","7-9",FALSE,"New York Giants",10,28,10,214,99,115,2,23,371,82,289,2,1985-12-21,0,0,"pit",-18
"1","Sun","September 7","L","","0-1",FALSE,"Seattle Seahawks",0,30,9,146,61,85,5,20,374,172,202,2,1986-09-07,-3,0,"pit",-30
"2","Mon","September 15","L","","0-2",TRUE,"Denver Broncos",10,21,17,236,206,30,3,20,326,235,91,1,1986-09-15,-2,0,"pit",-11
"3","Sun","September 21","L","","0-3",FALSE,"Minnesota Vikings",7,31,13,235,154,81,3,22,412,250,162,1,1986-09-21,-2,0,"pit",-24
"4","Sun","September 28","W","OT","1-3",FALSE,"Houston Oilers",22,16,22,375,161,214,2,19,281,200,81,3,1986-09-28,1,1,"pit",6
"5","Sun","October 5","L","","1-4",TRUE,"Cleveland Browns",24,27,19,308,132,176,4,16,270,162,108,3,1986-10-05,-1,0,"pit",-3
"6","Mon","October 13","L","","1-5",FALSE,"Cincinnati Bengals",22,24,15,288,180,108,1,16,359,211,148,1,1986-10-13,0,0,"pit",-2
"7","Sun","October 19","L","","1-6",TRUE,"New England Patriots",0,34,11,168,54,114,4,16,317,243,74,1,1986-10-19,-3,0,"pit",-34
"8","Sun","October 26","W","","2-6",TRUE,"Cincinnati Bengals",30,9,22,332,94,238,0,23,371,249,122,2,1986-10-26,2,1,"pit",21
"9","Sun","November 2","W","","3-6",TRUE,"Green Bay Packers",27,3,19,321,195,126,2,11,240,179,61,4,1986-11-02,2,1,"pit",24
"10","Sun","November 9","L","","3-7",FALSE,"Buffalo Bills",12,16,11,185,132,53,1,18,248,76,172,1,1986-11-09,0,0,"pit",-4
"11","Sun","November 16","W","","4-7",TRUE,"Houston Oilers",21,10,20,287,116,171,1,19,291,220,71,2,1986-11-16,1,1,"pit",11
"12","Sun","November 23","L","OT","4-8",FALSE,"Cleveland Browns",31,37,20,339,197,142,1,35,536,414,122,1,1986-11-23,0,0,"pit",-6
"13","Sun","November 30","L","OT","4-9",FALSE,"Chicago Bears",10,13,18,291,159,132,3,25,406,235,171,3,1986-11-30,0,0,"pit",-3
"14","Sun","December 7","W","","5-9",TRUE,"Detroit Lions",27,17,23,421,218,203,3,13,281,178,103,3,1986-12-07,0,1,"pit",10
"15","Sat","December 13","W","","6-9",FALSE,"New York Jets",45,24,25,364,189,175,1,22,369,223,146,4,1986-12-13,3,1,"pit",21
"16","Sun","December 21","L","","6-10",TRUE,"Kansas City Chiefs",19,24,28,515,340,175,2,8,171,133,38,1,1986-12-21,-1,0,"pit",-5
"1","Sun","September 13","W","","1-0",TRUE,"San Francisco 49ers",30,17,21,266,83,183,0,24,356,309,47,4,1987-09-13,4,1,"pit",13
"2","Sun","September 20","L","","1-1",FALSE,"Cleveland Browns",10,34,17,185,127,58,6,18,304,180,124,2,1987-09-20,-4,0,"pit",-24
"3","Sun","October 4","W","","2-1",FALSE,"Atlanta Falcons",28,12,19,361,219,142,3,13,215,148,67,4,1987-10-04,1,1,"pit",16
"4","Sun","October 11","L","","2-2",FALSE,"Los Angeles Rams",21,31,16,319,170,149,1,15,313,141,172,2,1987-10-11,1,0,"pit",-10
"5","Sun","October 18","W","","3-2",TRUE,"Indianapolis Colts",21,7,23,378,126,252,1,15,270,195,75,5,1987-10-18,4,1,"pit",14
"6","Sun","October 25","W","","4-2",TRUE,"Cincinnati Bengals",23,20,17,282,204,78,0,17,433,292,141,2,1987-10-25,2,1,"pit",3
"7","Sun","November 1","L","","4-3",FALSE,"Miami Dolphins",24,35,22,315,199,116,1,26,478,332,146,3,1987-11-01,2,0,"pit",-11
"8","Sun","November 8","W","","5-3",FALSE,"Kansas City Chiefs",17,16,25,391,141,250,4,15,224,123,101,5,1987-11-08,1,1,"pit",1
"9","Sun","November 15","L","","5-4",TRUE,"Houston Oilers",3,23,8,170,84,86,3,21,373,221,152,1,1987-11-15,-2,0,"pit",-20
"10","Sun","November 22","W","","6-4",FALSE,"Cincinnati Bengals",30,16,14,328,194,134,2,28,448,373,75,5,1987-11-22,3,1,"pit",14
"11","Sun","November 29","L","","6-5",TRUE,"New Orleans Saints",16,20,17,284,172,112,6,15,258,144,114,2,1987-11-29,-4,0,"pit",-4
"12","Sun","December 6","W","","7-5",TRUE,"Seattle Seahawks",13,9,18,308,99,209,0,16,215,80,135,2,1987-12-06,2,1,"pit",4
"13","Sun","December 13","W","","8-5",FALSE,"San Diego Chargers",20,16,14,254,150,104,1,27,435,321,114,5,1987-12-13,4,1,"pit",4
"14","Sun","December 20","L","","8-6",FALSE,"Houston Oilers",16,24,22,348,172,176,3,17,283,221,62,1,1987-12-20,-2,0,"pit",-8
"15","Sat","December 26","L","","8-7",TRUE,"Cleveland Browns",13,19,10,221,126,95,2,22,315,230,85,1,1987-12-26,-1,0,"pit",-6
"1","Sun","September 4","W","","1-0",TRUE,"Dallas Cowboys",24,21,17,356,214,142,0,25,414,280,134,3,1988-09-04,3,1,"pit",3
"2","Sun","September 11","L","","1-1",FALSE,"Washington Redskins",29,30,14,341,258,83,1,25,515,422,93,3,1988-09-11,2,0,"pit",-1
"3","Sun","September 18","L","","1-2",TRUE,"Cincinnati Bengals",12,17,19,319,195,124,6,20,306,190,116,1,1988-09-18,-5,0,"pit",-5
"4","Sun","September 25","L","","1-3",FALSE,"Buffalo Bills",28,36,25,408,314,94,5,22,398,282,116,3,1988-09-25,-2,0,"pit",-8
"5","Sun","October 2","L","","1-4",TRUE,"Cleveland Browns",9,23,13,183,94,89,5,15,299,131,168,1,1988-10-02,-4,0,"pit",-14
"6","Sun","October 9","L","","1-5",FALSE,"Phoenix Cardinals",14,31,10,203,125,78,2,21,388,285,103,3,1988-10-09,1,0,"pit",-17
"7","Sun","October 16","L","","1-6",TRUE,"Houston Oilers",14,34,23,344,251,93,4,18,309,185,124,0,1988-10-16,-4,0,"pit",-20
"8","Sun","October 23","W","","2-6",TRUE,"Denver Broncos",39,21,18,386,130,256,2,15,323,278,45,4,1988-10-23,2,1,"pit",18
"9","Sun","October 30","L","","2-7",FALSE,"New York Jets",20,24,15,352,209,143,4,15,196,112,84,1,1988-10-30,-3,0,"pit",-4
"10","Sun","November 6","L","","2-8",FALSE,"Cincinnati Bengals",7,42,15,198,97,101,0,28,559,338,221,2,1988-11-06,2,0,"pit",-35
"11","Sun","November 13","L","","2-9",TRUE,"Philadelphia Eagles",26,27,19,361,197,164,1,27,358,252,106,3,1988-11-13,2,0,"pit",-1
"12","Sun","November 20","L","","2-10",FALSE,"Cleveland Browns",7,27,18,285,167,118,4,11,262,192,70,0,1988-11-20,-4,0,"pit",-20
"13","Sun","November 27","W","","3-10",TRUE,"Kansas City Chiefs",16,10,19,336,122,214,1,19,366,278,88,2,1988-11-27,1,1,"pit",6
"14","Sun","December 4","W","","4-10",FALSE,"Houston Oilers",37,34,23,426,332,94,0,23,403,269,134,4,1988-12-04,4,1,"pit",3
"15","Sun","December 11","L","","4-11",FALSE,"San Diego Chargers",14,20,20,302,172,130,3,17,324,144,180,0,1988-12-11,-3,0,"pit",-6
"16","Sun","December 18","W","","5-11",TRUE,"Miami Dolphins",40,24,24,404,99,305,1,18,385,303,82,3,1988-12-18,2,1,"pit",16
"1","Sun","September 10","L","","0-1",TRUE,"Cleveland Browns",0,51,5,53,17,36,8,19,357,205,152,0,1989-09-10,-8,0,"pit",-51
"2","Sun","September 17","L","","0-2",FALSE,"Cincinnati Bengals",10,41,18,274,188,86,0,31,520,328,192,1,1989-09-17,1,0,"pit",-31
"3","Sun","September 24","W","","1-2",TRUE,"Minnesota Vikings",27,14,23,278,119,159,1,17,258,146,112,2,1989-09-24,1,1,"pit",13
"4","Sun","October 1","W","","2-2",FALSE,"Detroit Lions",23,3,20,315,213,102,0,13,240,222,18,4,1989-10-01,4,1,"pit",20
"5","Sun","October 8","L","","2-3",TRUE,"Cincinnati Bengals",16,26,25,340,168,172,1,21,382,192,190,1,1989-10-08,0,0,"pit",-10
"6","Sun","October 15","W","","3-3",FALSE,"Cleveland Browns",17,7,16,231,138,93,2,17,260,153,107,7,1989-10-15,5,1,"pit",10
"7","Sun","October 22","L","","3-4",FALSE,"Houston Oilers",0,27,10,132,100,32,4,22,361,229,132,1,1989-10-22,-3,0,"pit",-27
"8","Sun","October 29","W","","4-4",TRUE,"Kansas City Chiefs",23,17,19,312,232,80,1,23,438,318,120,2,1989-10-29,1,1,"pit",6
"9","Sun","November 5","L","","4-5",FALSE,"Denver Broncos",7,34,7,170,77,93,1,22,414,261,153,2,1989-11-05,1,0,"pit",-27
"10","Sun","November 12","L","","4-6",TRUE,"Chicago Bears",0,20,10,216,162,54,6,20,337,134,203,4,1989-11-12,-2,0,"pit",-20
"11","Sun","November 19","W","","5-6",TRUE,"San Diego Chargers",20,17,14,191,103,88,1,20,359,225,134,3,1989-11-19,2,1,"pit",3
"12","Sun","November 26","W","","6-6",FALSE,"Miami Dolphins",34,14,13,292,161,131,0,15,302,222,80,5,1989-11-26,5,1,"pit",20
"13","Sun","December 3","L","","6-7",TRUE,"Houston Oilers",16,23,15,212,43,169,1,19,284,144,140,3,1989-12-03,2,0,"pit",-7
"14","Sun","December 10","W","","7-7",FALSE,"New York Jets",13,0,17,317,160,157,1,19,313,243,70,3,1989-12-10,2,1,"pit",13
"15","Sun","December 17","W","","8-7",TRUE,"New England Patriots",28,10,18,347,128,219,1,26,403,282,121,3,1989-12-17,2,1,"pit",18
"16","Sun","December 24","W","","9-7",FALSE,"Tampa Bay Buccaneers",31,22,14,316,169,147,3,19,321,237,84,1,1989-12-24,-2,1,"pit",9
"WildCard","Sun","December 31","W","OT","10-7",FALSE,"Houston Oilers",26,23,17,289,112,177,1,22,380,315,65,2,1989-12-31,1,1,"pit",3
"Division","Sun","January 7","L","","10-8",FALSE,"Denver Broncos",23,24,19,404,229,175,2,19,364,226,138,1,1990-01-07,-1,0,"pit",-1
"1","Sun","September 9","L","","0-1",FALSE,"Cleveland Browns",3,13,14,210,161,49,3,11,158,78,80,1,1990-09-09,-2,0,"pit",-10
"2","Sun","September 16","W","","1-1",TRUE,"Houston Oilers",20,9,10,123,55,68,0,20,309,258,51,4,1990-09-16,4,1,"pit",11
"3","Sun","September 23","L","","1-2",FALSE,"Los Angeles Raiders",3,20,18,208,118,90,3,16,273,148,125,1,1990-09-23,-2,0,"pit",-17
"4","Sun","September 30","L","","1-3",TRUE,"Miami Dolphins",6,28,8,160,119,41,3,20,324,202,122,1,1990-09-30,-2,0,"pit",-22
"5","Sun","October 7","W","","2-3",TRUE,"San Diego Chargers",36,14,25,374,191,183,1,14,188,96,92,3,1990-10-07,2,1,"pit",22
"6","Sun","October 14","W","","3-3",FALSE,"Denver Broncos",34,17,25,451,343,108,2,16,244,178,66,1,1990-10-14,-1,1,"pit",17
"7","Sun","October 21","L","","3-4",FALSE,"San Francisco 49ers",7,27,14,200,103,97,2,22,304,154,150,3,1990-10-21,1,0,"pit",-20
"8","Mon","October 29","W","","4-4",TRUE,"Los Angeles Rams",41,10,18,345,156,189,1,13,217,173,44,3,1990-10-29,2,1,"pit",31
"9","Sun","November 4","W","","5-4",TRUE,"Atlanta Falcons",21,9,10,333,214,119,3,21,332,239,93,5,1990-11-04,2,1,"pit",12
"11","Sun","November 18","L","","5-5",FALSE,"Cincinnati Bengals",3,27,11,206,112,94,1,20,312,134,178,1,1990-11-18,0,0,"pit",-24
"12","Sun","November 25","W","","6-5",FALSE,"New York Jets",24,7,22,333,175,158,3,8,173,100,73,2,1990-11-25,-1,1,"pit",17
"13","Sun","December 2","L","","6-6",TRUE,"Cincinnati Bengals",12,16,16,305,226,79,2,17,319,154,165,3,1990-12-02,1,0,"pit",-4
"14","Sun","December 9","W","","7-6",TRUE,"New England Patriots",24,3,21,417,166,251,3,9,182,126,56,3,1990-12-09,0,1,"pit",21
"15","Sun","December 16","W","","8-6",FALSE,"New Orleans Saints",9,6,14,232,154,78,1,12,195,95,100,1,1990-12-16,0,1,"pit",3
"16","Sun","December 23","W","","9-6",TRUE,"Cleveland Browns",35,0,20,329,132,197,2,10,158,133,25,9,1990-12-23,7,1,"pit",35
"17","Sun","December 30","L","","9-7",FALSE,"Houston Oilers",14,34,17,299,220,79,2,28,427,232,195,1,1990-12-30,-1,0,"pit",-20
"1","Sun","September 1","W","","1-0",TRUE,"San Diego Chargers",26,20,16,390,266,124,2,20,281,186,95,2,1991-09-01,0,1,"pit",6
"2","Sun","September 8","L","","1-1",FALSE,"Buffalo Bills",34,52,14,265,113,152,1,31,537,343,194,3,1991-09-08,2,0,"pit",-18
"3","Sun","September 15","W","","2-1",TRUE,"New England Patriots",20,6,16,290,247,43,2,12,174,92,82,2,1991-09-15,0,1,"pit",14
"4","Sun","September 22","L","","2-2",FALSE,"Philadelphia Eagles",14,23,11,226,160,66,1,20,374,279,95,1,1991-09-22,0,0,"pit",-9
"6","Sun","October 6","W","","3-2",FALSE,"Indianapolis Colts",21,3,17,292,172,120,3,15,189,147,42,2,1991-10-06,-1,1,"pit",18
"7","Mon","October 14","L","","3-3",TRUE,"New York Giants",20,23,20,377,229,148,1,17,311,114,197,0,1991-10-14,-1,0,"pit",-3
"8","Sun","October 20","L","","3-4",TRUE,"Seattle Seahawks",7,27,12,240,162,78,3,18,324,259,65,0,1991-10-20,-3,0,"pit",-20
"9","Sun","October 27","L","","3-5",FALSE,"Cleveland Browns",14,17,18,282,207,75,2,19,262,179,83,0,1991-10-27,-2,0,"pit",-3
"10","Sun","November 3","L","","3-6",FALSE,"Denver Broncos",13,20,19,309,163,146,1,17,274,130,144,2,1991-11-03,1,0,"pit",-7
"11","Sun","November 10","W","OT","4-6",FALSE,"Cincinnati Bengals",33,27,18,352,294,58,0,25,406,336,70,3,1991-11-10,3,1,"pit",6
"12","Sun","November 17","L","","4-7",TRUE,"Washington Redskins",14,41,16,282,241,41,2,23,462,365,97,0,1991-11-17,-2,0,"pit",-27
"13","Sun","November 24","W","","5-7",TRUE,"Houston Oilers",26,14,16,294,155,139,2,21,331,307,24,6,1991-11-24,4,1,"pit",12
"14","Thu","November 28","L","","5-8",FALSE,"Dallas Cowboys",10,20,17,199,134,65,1,20,297,181,116,0,1991-11-28,-1,0,"pit",-10
"15","Sun","December 8","L","","5-9",FALSE,"Houston Oilers",6,31,14,232,147,85,4,23,350,233,117,2,1991-12-08,-2,0,"pit",-25
"16","Sun","December 15","W","","6-9",TRUE,"Cincinnati Bengals",17,10,18,326,177,149,5,13,195,120,75,2,1991-12-15,-3,1,"pit",7
"17","Sun","December 22","W","","7-9",TRUE,"Cleveland Browns",17,10,12,225,87,138,0,26,401,315,86,5,1991-12-22,5,1,"pit",7
"1","Sun","September 6","W","","1-0",FALSE,"Houston Oilers",29,24,19,381,245,136,2,24,434,330,104,5,1992-09-06,3,1,"pit",5
"2","Sun","September 13","W","","2-0",TRUE,"New York Jets",27,10,17,370,155,215,5,12,239,129,110,7,1992-09-13,2,1,"pit",17
"3","Sun","September 20","W","","3-0",FALSE,"San Diego Chargers",23,6,15,272,205,67,3,15,330,221,109,3,1992-09-20,0,1,"pit",17
"4","Sun","September 27","L","","3-1",FALSE,"Green Bay Packers",3,17,16,353,208,145,1,16,294,195,99,0,1992-09-27,-1,0,"pit",-14
"6","Sun","October 11","L","","3-2",FALSE,"Cleveland Browns",9,17,20,348,228,120,1,12,253,168,85,1,1992-10-11,0,0,"pit",-8
"7","Mon","October 19","W","","4-2",TRUE,"Cincinnati Bengals",20,0,26,424,251,173,1,6,118,70,48,2,1992-10-19,1,1,"pit",20
"8","Sun","October 25","W","","5-2",FALSE,"Kansas City Chiefs",27,3,16,263,109,154,0,13,179,58,121,3,1992-10-25,3,1,"pit",24
"9","Sun","November 1","W","","6-2",TRUE,"Houston Oilers",21,20,20,302,183,119,3,21,283,228,55,2,1992-11-01,-1,1,"pit",1
"10","Sun","November 8","L","","6-3",FALSE,"Buffalo Bills",20,28,17,233,146,87,0,31,458,284,174,2,1992-11-08,2,0,"pit",-8
"11","Sun","November 15","W","","7-3",TRUE,"Detroit Lions",17,14,18,316,164,152,2,20,376,286,90,6,1992-11-15,4,1,"pit",3
"12","Sun","November 22","W","","8-3",TRUE,"Indianapolis Colts",30,14,20,362,109,253,2,16,329,258,71,3,1992-11-22,1,1,"pit",16
"13","Sun","November 29","W","","9-3",FALSE,"Cincinnati Bengals",21,9,17,240,141,99,2,15,228,68,160,1,1992-11-29,-1,1,"pit",12
"14","Sun","December 6","W","","10-3",TRUE,"Seattle Seahawks",20,14,16,306,168,138,5,10,220,153,67,2,1992-12-06,-3,1,"pit",6
"15","Sun","December 13","L","","10-4",FALSE,"Chicago Bears",6,30,10,140,105,35,4,20,283,71,212,0,1992-12-13,-4,0,"pit",-24
"16","Sun","December 20","L","","10-5",TRUE,"Minnesota Vikings",3,6,17,288,130,158,1,18,341,125,216,3,1992-12-20,2,0,"pit",-3
"17","Sun","December 27","W","","11-5",TRUE,"Cleveland Browns",23,13,20,308,203,105,0,17,293,173,120,3,1992-12-27,3,1,"pit",10
"Division","Sat","January 9","L","","11-6",TRUE,"Buffalo Bills",3,24,18,240,111,129,3,19,325,156,169,0,1993-01-09,-3,0,"pit",-21
"1","Sun","September 5","L","","0-1",TRUE,"San Francisco 49ers",13,24,12,211,109,102,3,21,326,240,86,3,1993-09-05,0,0,"pit",-11
"2","Sun","September 12","L","","0-2",FALSE,"Los Angeles Rams",0,27,11,175,120,55,3,20,314,215,99,2,1993-09-12,-1,0,"pit",-27
"3","Sun","September 19","W","","1-2",TRUE,"Cincinnati Bengals",34,7,23,404,181,223,1,11,170,126,44,1,1993-09-19,0,1,"pit",27
"4","Mon","September 27","W","","2-2",FALSE,"Atlanta Falcons",45,17,22,368,259,109,1,16,220,176,44,6,1993-09-27,5,1,"pit",28
"6","Sun","October 10","W","","3-2",TRUE,"San Diego Chargers",16,3,15,304,156,148,0,12,138,119,19,3,1993-10-10,3,1,"pit",13
"7","Sun","October 17","W","","4-2",TRUE,"New Orleans Saints",37,14,22,393,192,201,3,11,264,215,49,5,1993-10-17,2,1,"pit",23
"8","Sun","October 24","L","","4-3",FALSE,"Cleveland Browns",23,28,26,440,348,92,2,12,245,147,98,1,1993-10-24,-1,0,"pit",-5
"10","Sun","November 7","W","","5-3",FALSE,"Cincinnati Bengals",24,16,21,390,244,146,2,14,199,96,103,1,1993-11-07,-1,1,"pit",8
"11","Mon","November 15","W","","6-3",TRUE,"Buffalo Bills",23,0,26,400,173,227,0,9,157,110,47,1,1993-11-15,1,1,"pit",23
"12","Sun","November 21","L","","6-4",FALSE,"Denver Broncos",13,37,19,349,248,101,3,23,364,257,107,0,1993-11-21,-3,0,"pit",-24
"13","Sun","November 28","L","","6-5",FALSE,"Houston Oilers",3,23,18,234,169,65,4,20,391,266,125,1,1993-11-28,-3,0,"pit",-20
"14","Sun","December 5","W","","7-5",TRUE,"New England Patriots",17,14,14,217,92,125,0,20,349,296,53,6,1993-12-05,6,1,"pit",3
"15","Mon","December 13","W","","8-5",FALSE,"Miami Dolphins",21,20,19,265,145,120,0,21,348,299,49,3,1993-12-13,3,1,"pit",1
"16","Sun","December 19","L","","8-6",TRUE,"Houston Oilers",17,26,21,385,347,38,3,20,383,266,117,2,1993-12-19,-1,0,"pit",-9
"17","Sun","December 26","L","","8-7",FALSE,"Seattle Seahawks",6,16,18,380,264,116,2,25,368,101,267,1,1993-12-26,-1,0,"pit",-10
"18","Sun","January 2","W","","9-7",TRUE,"Cleveland Browns",16,9,20,320,185,135,0,12,295,234,61,2,1994-01-02,2,1,"pit",7
"WildCard","Sat","January 8","L","OT","9-8",FALSE,"Kansas City Chiefs",24,27,21,369,272,97,0,28,401,276,125,0,1994-01-08,0,0,"pit",-3
"1","Sun","September 4","L","","0-1",TRUE,"Dallas Cowboys",9,26,14,126,71,55,0,26,442,245,197,1,1994-09-04,1,0,"pit",-17
"2","Sun","September 11","W","","1-1",FALSE,"Cleveland Browns",17,10,17,315,199,116,0,18,278,197,81,5,1994-09-11,5,1,"pit",7
"3","Sun","September 18","W","","2-1",TRUE,"Indianapolis Colts",31,21,32,500,239,261,2,10,175,102,73,1,1994-09-18,-1,1,"pit",10
"4","Sun","September 25","L","","2-2",FALSE,"Seattle Seahawks",13,30,29,452,321,131,4,20,297,152,145,1,1994-09-25,-3,0,"pit",-17
"5","Mon","October 3","W","","3-2",TRUE,"Houston Oilers",30,14,21,379,164,215,0,14,290,221,69,2,1994-10-03,2,1,"pit",16
"7","Sun","October 16","W","","4-2",TRUE,"Cincinnati Bengals",14,10,16,243,129,114,1,11,241,135,106,2,1994-10-16,1,1,"pit",4
"8","Sun","October 23","W","","5-2",FALSE,"New York Giants",10,6,16,296,121,175,4,8,215,162,53,3,1994-10-23,-1,1,"pit",4
"9","Sun","October 30","L","OT","5-3",FALSE,"Arizona Cardinals",17,20,12,317,232,85,3,16,335,236,99,1,1994-10-30,-2,0,"pit",-3
"10","Sun","November 6","W","OT","6-3",FALSE,"Houston Oilers",12,9,17,266,155,111,0,17,244,160,84,1,1994-11-06,1,1,"pit",3
"11","Mon","November 14","W","","7-3",TRUE,"Buffalo Bills",23,10,10,226,140,86,1,24,326,198,128,3,1994-11-14,2,1,"pit",13
"12","Sun","November 20","W","OT","8-3",TRUE,"Miami Dolphins",16,13,21,423,335,88,0,20,323,283,40,2,1994-11-20,2,1,"pit",3
"13","Sun","November 27","W","","9-3",FALSE,"Los Angeles Raiders",21,3,19,306,131,175,0,14,179,122,57,2,1994-11-27,2,1,"pit",18
"14","Sun","December 4","W","","10-3",FALSE,"Cincinnati Bengals",38,15,23,308,123,185,0,13,195,119,76,3,1994-12-04,3,1,"pit",23
"15","Sun","December 11","W","","11-3",TRUE,"Philadelphia Eagles",14,3,20,269,145,124,2,9,105,34,71,1,1994-12-11,-1,1,"pit",11
"16","Sun","December 18","W","","12-3",TRUE,"Cleveland Browns",17,7,18,276,153,123,0,21,331,245,86,3,1994-12-18,3,1,"pit",10
"17","Sat","December 24","L","","12-4",FALSE,"San Diego Chargers",34,37,22,442,306,136,0,21,350,263,87,0,1994-12-24,0,0,"pit",-3
"Division","Sat","January 7","W","","13-4",TRUE,"Cleveland Browns",29,9,23,424,186,238,1,10,186,131,55,2,1995-01-07,1,1,"pit",20
"ConfChamp","Sun","January 15","L","","13-5",TRUE,"San Diego Chargers",13,17,22,415,349,66,1,13,226,160,66,1,1995-01-15,0,0,"pit",-4
"1","Sun","September 3","W","","1-0",TRUE,"Detroit Lions",23,20,26,354,204,150,4,16,302,180,122,1,1995-09-03,-3,1,"pit",3
"2","Sun","September 10","W","","2-0",FALSE,"Houston Oilers",34,17,19,250,123,127,1,19,216,178,38,3,1995-09-10,2,1,"pit",17
"3","Mon","September 18","L","","2-1",FALSE,"Miami Dolphins",10,23,21,366,273,93,5,16,256,210,46,0,1995-09-18,-5,0,"pit",-13
"4","Sun","September 24","L","","2-2",TRUE,"Minnesota Vikings",24,44,22,405,335,70,7,20,378,244,134,4,1995-09-24,-3,0,"pit",-20
"5","Sun","October 1","W","","3-2",TRUE,"San Diego Chargers",31,16,21,261,141,120,1,20,327,232,95,4,1995-10-01,3,1,"pit",15
"6","Sun","October 8","L","","3-3",FALSE,"Jacksonville Jaguars",16,20,16,350,282,68,1,17,267,171,96,0,1995-10-08,-1,0,"pit",-4
"8","Thu","October 19","L","","3-4",TRUE,"Cincinnati Bengals",9,27,24,468,347,121,1,18,368,275,93,0,1995-10-19,-1,0,"pit",-18
"9","Sun","October 29","W","","4-4",TRUE,"Jacksonville Jaguars",24,7,20,316,178,138,1,14,229,145,84,1,1995-10-29,0,1,"pit",17
"10","Sun","November 5","W","OT","5-4",FALSE,"Chicago Bears",37,34,27,383,298,85,4,20,343,223,120,5,1995-11-05,1,1,"pit",3
"11","Mon","November 13","W","","6-4",TRUE,"Cleveland Browns",20,3,22,310,157,153,0,7,120,43,77,1,1995-11-13,1,1,"pit",17
"12","Sun","November 19","W","","7-4",FALSE,"Cincinnati Bengals",49,31,28,556,365,191,2,19,265,208,57,2,1995-11-19,0,1,"pit",18
"13","Sun","November 26","W","","8-4",FALSE,"Cleveland Browns",20,17,19,318,258,60,0,19,253,178,75,3,1995-11-26,3,1,"pit",3
"14","Sun","December 3","W","","9-4",TRUE,"Houston Oilers",21,7,17,358,205,153,4,11,249,174,75,2,1995-12-03,-2,1,"pit",14
"15","Sun","December 10","W","","10-4",FALSE,"Oakland Raiders",29,10,21,355,211,144,2,9,190,162,28,4,1995-12-10,2,1,"pit",19
"16","Sat","December 16","W","","11-4",TRUE,"New England Patriots",41,27,14,321,226,95,1,28,439,322,117,3,1995-12-16,2,1,"pit",14
"17","Sun","December 24","L","","11-5",FALSE,"Green Bay Packers",19,24,27,398,314,84,0,19,359,295,64,1,1995-12-24,1,0,"pit",-5
"Division","Sat","January 6","W","","12-5",TRUE,"Buffalo Bills",40,21,23,409,262,147,2,18,250,156,94,4,1996-01-06,2,1,"pit",19
"ConfChamp","Sun","January 14","W","","13-5",TRUE,"Indianapolis Colts",20,16,21,285,205,80,1,16,328,245,83,0,1996-01-14,-1,1,"pit",4
"SuperBowl","Sun","January 28","L","","13-6",TRUE,"Dallas Cowboys",17,27,25,310,207,103,3,15,254,198,56,0,1996-01-28,-3,0,"pit",-10
"1","Sun","September 1","L","","0-1",FALSE,"Jacksonville Jaguars",9,24,13,187,86,101,2,22,313,194,119,2,1996-09-01,0,0,"pit",-15
"2","Sun","September 8","W","","1-1",TRUE,"Baltimore Ravens",31,17,26,397,191,206,2,17,251,154,97,3,1996-09-08,1,1,"pit",14
"3","Mon","September 16","W","","2-1",TRUE,"Buffalo Bills",24,6,22,382,160,222,1,11,185,99,86,4,1996-09-16,3,1,"pit",18
"5","Sun","September 29","W","","3-1",TRUE,"Houston Oilers",30,16,15,309,197,112,2,16,273,193,80,5,1996-09-29,3,1,"pit",14
"6","Mon","October 7","W","","4-1",FALSE,"Kansas City Chiefs",17,7,21,436,338,98,3,17,300,170,130,3,1996-10-07,0,1,"pit",10
"7","Sun","October 13","W","","5-1",TRUE,"Cincinnati Bengals",20,10,17,306,182,124,2,20,252,158,94,2,1996-10-13,0,1,"pit",10
"8","Sun","October 20","L","","5-2",FALSE,"Houston Oilers",13,23,12,275,192,83,2,23,328,237,91,2,1996-10-20,0,0,"pit",-10
"9","Sun","October 27","W","","6-2",FALSE,"Atlanta Falcons",20,17,20,311,184,127,0,19,301,234,67,1,1996-10-27,1,1,"pit",3
"10","Sun","November 3","W","","7-2",TRUE,"St. Louis Rams",42,6,20,348,100,248,1,18,201,137,64,3,1996-11-03,2,1,"pit",36
"11","Sun","November 10","L","","7-3",FALSE,"Cincinnati Bengals",24,34,18,317,180,137,4,25,372,260,112,3,1996-11-10,-1,0,"pit",-10
"12","Sun","November 17","W","","8-3",TRUE,"Jacksonville Jaguars",28,3,15,198,90,108,1,20,239,161,78,4,1996-11-17,3,1,"pit",25
"13","Mon","November 25","W","","9-3",FALSE,"Miami Dolphins",24,17,23,381,239,142,3,15,312,237,75,1,1996-11-25,-2,1,"pit",7
"14","Sun","December 1","L","","9-4",FALSE,"Baltimore Ravens",17,31,18,333,214,119,1,19,372,250,122,1,1996-12-01,0,0,"pit",-14
"15","Sun","December 8","W","","10-4",TRUE,"San Diego Chargers",16,3,21,327,160,167,4,8,148,83,65,4,1996-12-08,0,1,"pit",13
"16","Sun","December 15","L","","10-5",TRUE,"San Francisco 49ers",15,25,23,368,248,120,3,21,288,232,56,0,1996-12-15,-3,0,"pit",-10
"17","Sun","December 22","L","","10-6",FALSE,"Carolina Panthers",14,18,12,265,80,185,2,15,227,148,79,2,1996-12-22,0,0,"pit",-4
"WildCard","Sun","December 29","W","","11-6",TRUE,"Indianapolis Colts",42,14,24,407,176,231,3,8,146,105,41,2,1996-12-29,-1,1,"pit",28
"Division","Sun","January 5","L","","11-7",FALSE,"New England Patriots",3,28,12,213,90,123,2,17,346,152,194,2,1997-01-05,0,0,"pit",-25
"1","Sun","August 31","L","","0-1",TRUE,"Dallas Cowboys",7,37,15,174,89,85,2,21,380,295,85,0,1997-08-31,-2,0,"pit",-30
"2","Sun","September 7","W","","1-1",TRUE,"Washington Redskins",14,13,23,295,73,222,1,19,354,285,69,3,1997-09-07,2,1,"pit",1
"4","Mon","September 22","L","","1-2",FALSE,"Jacksonville Jaguars",21,30,19,306,153,153,2,23,343,303,40,0,1997-09-22,-2,0,"pit",-9
"5","Sun","September 28","W","","2-2",TRUE,"Tennessee Oilers",37,24,19,399,262,137,1,20,284,226,58,3,1997-09-28,2,1,"pit",13
"6","Sun","October 5","W","","3-2",FALSE,"Baltimore Ravens",42,34,22,431,217,214,3,20,332,280,52,5,1997-10-05,2,1,"pit",8
"7","Sun","October 12","W","","4-2",TRUE,"Indianapolis Colts",24,22,17,327,142,185,6,18,270,191,79,2,1997-10-12,-4,1,"pit",2
"8","Sun","October 19","W","","5-2",FALSE,"Cincinnati Bengals",26,10,24,412,246,166,2,13,236,165,71,4,1997-10-19,2,1,"pit",16
"9","Sun","October 26","W","OT","6-2",TRUE,"Jacksonville Jaguars",23,17,26,439,298,141,3,16,267,194,73,1,1997-10-26,-2,1,"pit",6
"10","Mon","November 3","L","","6-3",FALSE,"Kansas City Chiefs",10,13,12,235,93,142,1,24,392,209,183,2,1997-11-03,1,0,"pit",-3
"11","Sun","November 9","W","","7-3",TRUE,"Baltimore Ravens",37,0,19,341,198,143,0,11,172,112,60,7,1997-11-09,7,1,"pit",37
"12","Sun","November 16","W","","8-3",TRUE,"Cincinnati Bengals",20,3,20,309,123,186,0,16,244,128,116,3,1997-11-16,3,1,"pit",17
"13","Sun","November 23","L","","8-4",FALSE,"Philadelphia Eagles",20,23,22,383,272,111,5,19,326,229,97,0,1997-11-23,-5,0,"pit",-3
"14","Sun","November 30","W","OT","9-4",FALSE,"Arizona Cardinals",26,20,25,342,165,177,0,18,291,243,48,0,1997-11-30,0,1,"pit",6
"15","Sun","December 7","W","","10-4",TRUE,"Denver Broncos",35,24,22,476,290,186,2,18,320,231,89,1,1997-12-07,-1,1,"pit",11
"16","Sat","December 13","W","OT","11-4",FALSE,"New England Patriots",24,21,22,404,266,138,2,15,253,211,42,2,1997-12-13,0,1,"pit",3
"17","Sun","December 21","L","","11-5",FALSE,"Tennessee Oilers",6,16,19,269,176,93,3,14,241,85,156,1,1997-12-21,-2,0,"pit",-10
"Division","Sat","January 3","W","","12-5",TRUE,"New England Patriots",7,6,16,279,134,145,1,15,280,244,36,4,1998-01-03,3,1,"pit",1
"ConfChamp","Sun","January 11","L","","12-6",TRUE,"Denver Broncos",21,24,23,354,193,161,4,23,345,195,150,2,1998-01-11,-2,0,"pit",-3
"1","Sun","September 6","W","","1-0",FALSE,"Baltimore Ravens",20,13,14,271,157,114,3,17,376,264,112,0,1998-09-06,-3,1,"pit",7
"2","Sun","September 13","W","","2-0",TRUE,"Chicago Bears",17,12,17,251,109,142,1,19,320,190,130,2,1998-09-13,1,1,"pit",5
"3","Sun","September 20","L","","2-1",FALSE,"Miami Dolphins",0,21,13,200,78,122,3,11,219,109,110,1,1998-09-20,-2,0,"pit",-21
"4","Sun","September 27","W","","3-1",TRUE,"Seattle Seahawks",13,10,16,285,100,185,0,14,230,169,61,4,1998-09-27,4,1,"pit",3
"6","Sun","October 11","L","","3-2",FALSE,"Cincinnati Bengals",20,25,20,386,129,257,1,17,389,281,108,0,1998-10-11,-1,0,"pit",-5
"7","Sun","October 18","W","","4-2",TRUE,"Baltimore Ravens",16,6,13,241,162,79,2,16,230,134,96,5,1998-10-18,3,1,"pit",10
"8","Mon","October 26","W","","5-2",FALSE,"Kansas City Chiefs",20,13,20,272,90,182,1,16,290,218,72,3,1998-10-26,2,1,"pit",7
"9","Sun","November 1","L","","5-3",TRUE,"Tennessee Oilers",31,41,26,401,347,54,3,19,321,152,169,0,1998-11-01,-3,0,"pit",-10
"10","Mon","November 9","W","","6-3",TRUE,"Green Bay Packers",27,20,19,360,218,142,1,17,256,217,39,1,1998-11-09,0,1,"pit",7
"11","Sun","November 15","L","","6-4",FALSE,"Tennessee Oilers",14,23,16,310,231,79,2,18,338,230,108,1,1998-11-15,-1,0,"pit",-9
"12","Sun","November 22","W","","7-4",TRUE,"Jacksonville Jaguars",30,15,18,329,208,121,0,17,301,204,97,4,1998-11-22,4,1,"pit",15
"13","Thu","November 26","L","OT","7-5",FALSE,"Detroit Lions",16,19,22,293,208,85,2,13,283,213,70,2,1998-11-26,0,0,"pit",-3
"14","Sun","December 6","L","","7-6",TRUE,"New England Patriots",9,23,13,249,195,54,3,19,377,304,73,3,1998-12-06,0,0,"pit",-14
"15","Sun","December 13","L","","7-7",FALSE,"Tampa Bay Buccaneers",3,16,10,166,78,88,5,14,253,109,144,1,1998-12-13,-4,0,"pit",-13
"16","Sun","December 20","L","","7-8",TRUE,"Cincinnati Bengals",24,25,11,211,86,125,2,23,483,359,124,2,1998-12-20,0,0,"pit",-1
"17","Mon","December 28","L","","7-9",FALSE,"Jacksonville Jaguars",3,21,20,361,156,205,3,16,297,168,129,0,1998-12-28,-3,0,"pit",-18
"1","Sun","September 12","W","","1-0",FALSE,"Cleveland Browns",43,0,33,464,247,217,0,2,40,31,9,4,1999-09-12,4,1,"pit",43
"2","Sun","September 19","W","","2-0",FALSE,"Baltimore Ravens",23,20,19,270,121,149,0,16,292,167,125,3,1999-09-19,3,1,"pit",3
"3","Sun","September 26","L","","2-1",TRUE,"Seattle Seahawks",10,29,15,272,207,65,5,16,341,251,90,2,1999-09-26,-3,0,"pit",-19
"4","Sun","October 3","L","","2-2",TRUE,"Jacksonville Jaguars",3,17,14,216,99,117,2,13,204,80,124,1,1999-10-03,-1,0,"pit",-14
"5","Sun","October 10","L","","2-3",FALSE,"Buffalo Bills",21,24,17,255,207,48,1,24,365,254,111,1,1999-10-10,0,0,"pit",-3
"6","Sun","October 17","W","","3-3",FALSE,"Cincinnati Bengals",17,3,18,255,125,130,0,14,261,177,84,3,1999-10-17,3,1,"pit",14
"7","Mon","October 25","W","","4-3",TRUE,"Atlanta Falcons",13,9,14,226,115,111,1,20,236,187,49,1,1999-10-25,0,1,"pit",4
"9","Sun","November 7","W","","5-3",FALSE,"San Francisco 49ers",27,6,14,271,130,141,0,16,313,90,223,2,1999-11-07,2,1,"pit",21
"10","Sun","November 14","L","","5-4",TRUE,"Cleveland Browns",15,16,17,298,130,168,2,14,235,161,74,2,1999-11-14,0,0,"pit",-1
"11","Sun","November 21","L","","5-5",FALSE,"Tennessee Titans",10,16,14,267,161,106,1,17,261,149,112,1,1999-11-21,0,0,"pit",-6
"12","Sun","November 28","L","","5-6",TRUE,"Cincinnati Bengals",20,27,20,391,280,111,3,18,415,235,180,1,1999-11-28,-2,0,"pit",-7
"13","Thu","December 2","L","","5-7",FALSE,"Jacksonville Jaguars",6,20,15,235,172,63,0,24,466,298,168,1,1999-12-02,1,0,"pit",-14
"14","Sun","December 12","L","","5-8",TRUE,"Baltimore Ravens",24,31,21,352,243,109,1,12,374,242,132,0,1999-12-12,-1,0,"pit",-7
"15","Sat","December 18","L","","5-9",FALSE,"Kansas City Chiefs",19,35,21,376,269,107,4,16,363,145,218,0,1999-12-18,-4,0,"pit",-16
"16","Sun","December 26","W","","6-9",TRUE,"Carolina Panthers",30,20,21,293,82,211,1,17,375,256,119,3,1999-12-26,2,1,"pit",10
"17","Sun","January 2","L","","6-10",TRUE,"Tennessee Titans",36,47,22,433,295,138,4,21,343,203,140,3,2000-01-02,-1,0,"pit",-11
"1","Sun","September 3","L","","0-1",TRUE,"Baltimore Ravens",0,16,12,223,193,30,1,18,336,196,140,0,2000-09-03,-1,0,"pit",-16
"3","Sun","September 17","L","","0-2",FALSE,"Cleveland Browns",20,23,19,336,166,170,1,14,377,316,61,1,2000-09-17,0,0,"pit",-3
"4","Sun","September 24","L","","0-3",TRUE,"Tennessee Titans",20,23,20,364,249,115,1,15,372,287,85,3,2000-09-24,2,0,"pit",-3
"5","Sun","October 1","W","","1-3",FALSE,"Jacksonville Jaguars",24,13,22,332,123,209,3,17,206,180,26,2,2000-10-01,-1,1,"pit",11
"6","Sun","October 8","W","","2-3",FALSE,"New York Jets",20,3,21,330,137,193,0,12,206,94,112,4,2000-10-08,4,1,"pit",17
"7","Sun","October 15","W","","3-3",TRUE,"Cincinnati Bengals",15,0,13,274,171,103,0,12,232,112,120,3,2000-10-15,3,1,"pit",15
"8","Sun","October 22","W","","4-3",TRUE,"Cleveland Browns",22,0,17,248,105,143,0,5,104,55,49,3,2000-10-22,3,1,"pit",22
"9","Sun","October 29","W","","5-3",FALSE,"Baltimore Ravens",9,6,14,231,111,120,1,14,274,139,135,3,2000-10-29,2,1,"pit",3
"10","Sun","November 5","L","","5-4",FALSE,"Tennessee Titans",7,9,10,167,93,74,3,21,364,216,148,1,2000-11-05,-2,0,"pit",-2
"11","Sun","November 12","L","OT","5-5",TRUE,"Philadelphia Eagles",23,26,21,322,140,182,1,21,290,202,88,1,2000-11-12,0,0,"pit",-3
"12","Sun","November 19","L","","5-6",TRUE,"Jacksonville Jaguars",24,34,15,302,155,147,5,20,417,177,240,2,2000-11-19,-3,0,"pit",-10
"13","Sun","November 26","W","","6-6",FALSE,"Cincinnati Bengals",48,28,21,372,187,185,0,23,309,100,209,3,2000-11-26,3,1,"pit",20
"14","Sun","December 3","W","","7-6",TRUE,"Oakland Raiders",21,20,19,311,112,199,1,20,390,273,117,2,2000-12-03,1,1,"pit",1
"15","Sun","December 10","L","","7-7",FALSE,"New York Giants",10,30,17,264,217,47,1,20,394,326,68,0,2000-12-10,-1,0,"pit",-20
"16","Sat","December 16","W","","8-7",TRUE,"Washington Redskins",24,3,21,374,174,200,1,14,271,207,64,5,2000-12-16,4,1,"pit",21
"17","Sun","December 24","W","","9-7",FALSE,"San Diego Chargers",34,21,21,316,185,131,2,6,171,140,31,2,2000-12-24,0,1,"pit",13
"1","Sun","September 9","L","","0-1",FALSE,"Jacksonville Jaguars",3,21,15,281,161,120,4,16,299,198,101,0,2001-09-09,-4,0,"pit",-18
"3","Sun","September 30","W","","1-1",FALSE,"Buffalo Bills",20,3,16,270,100,170,0,14,172,120,52,2,2001-09-30,2,1,"pit",17
"4","Sun","October 7","W","","2-1",TRUE,"Cincinnati Bengals",16,7,19,413,138,275,2,15,214,149,65,1,2001-10-07,-1,1,"pit",9
"5","Sun","October 14","W","","3-1",FALSE,"Kansas City Chiefs",20,17,16,316,113,203,0,19,271,106,165,1,2001-10-14,1,1,"pit",3
"6","Sun","October 21","W","","4-1",FALSE,"Tampa Bay Buccaneers",17,10,17,344,124,220,3,19,278,214,64,1,2001-10-21,-2,1,"pit",7
"7","Mon","October 29","W","","5-1",TRUE,"Tennessee Titans",34,7,24,405,272,133,0,15,214,157,57,4,2001-10-29,4,1,"pit",27
"8","Sun","November 4","L","","5-2",TRUE,"Baltimore Ravens",10,13,21,348,225,123,1,10,183,142,41,1,2001-11-04,0,0,"pit",-3
"9","Sun","November 11","W","OT","6-2",FALSE,"Cleveland Browns",15,12,20,428,181,247,1,15,187,113,74,0,2001-11-11,-1,1,"pit",3
"10","Sun","November 18","W","","7-2",TRUE,"Jacksonville Jaguars",20,7,20,402,257,145,0,14,234,186,48,3,2001-11-18,3,1,"pit",13
"11","Sun","November 25","W","","8-2",FALSE,"Tennessee Titans",34,24,20,377,247,130,0,21,405,324,81,2,2001-11-25,2,1,"pit",10
"12","Sun","December 2","W","","9-2",TRUE,"Minnesota Vikings",21,16,21,364,157,207,2,12,385,340,45,3,2001-12-02,1,1,"pit",5
"13","Sun","December 9","W","","10-2",TRUE,"New York Jets",18,7,23,345,211,134,0,14,220,159,61,0,2001-12-09,0,1,"pit",11
"14","Sun","December 16","W","","11-2",FALSE,"Baltimore Ravens",26,21,22,476,318,158,0,15,207,149,58,1,2001-12-16,1,1,"pit",5
"15","Sun","December 23","W","","12-2",TRUE,"Detroit Lions",47,14,25,429,214,215,0,11,151,77,74,3,2001-12-23,3,1,"pit",33
"16","Sun","December 30","L","OT","12-3",FALSE,"Cincinnati Bengals",23,26,16,313,240,73,5,32,544,403,141,3,2001-12-30,-2,0,"pit",-3
"17","Sun","January 6","W","","13-3",TRUE,"Cleveland Browns",28,7,19,376,155,221,3,12,173,105,68,3,2002-01-06,0,1,"pit",21
"Division","Sun","January 20","W","","14-3",TRUE,"Baltimore Ravens",27,10,21,297,143,154,1,7,150,128,22,4,2002-01-20,3,1,"pit",17
"ConfChamp","Sun","January 27","L","","14-4",TRUE,"New England Patriots",17,24,23,306,248,58,4,15,259,192,67,0,2002-01-27,-4,0,"pit",-7
"1","Mon","September 9","L","","0-1",FALSE,"New England Patriots",14,30,20,283,209,74,5,20,343,280,63,1,2002-09-09,-4,0,"pit",-16
"2","Sun","September 15","L","","0-2",TRUE,"Oakland Raiders",17,30,14,273,201,72,5,27,464,369,95,2,2002-09-15,-3,0,"pit",-13
"4","Sun","September 29","W","OT","1-2",TRUE,"Cleveland Browns",16,13,21,358,265,93,2,13,245,122,123,2,2002-09-29,0,1,"pit",3
"5","Sun","October 6","L","","1-3",FALSE,"New Orleans Saints",29,32,23,364,244,120,2,17,315,194,121,0,2002-10-06,-2,0,"pit",-3
"6","Sun","October 13","W","","2-3",FALSE,"Cincinnati Bengals",34,7,21,408,197,211,2,18,268,190,78,4,2002-10-13,2,1,"pit",27
"7","Mon","October 21","W","","3-3",TRUE,"Indianapolis Colts",28,10,22,364,182,182,1,23,367,295,72,3,2002-10-21,2,1,"pit",18
"8","Sun","October 27","W","","4-3",FALSE,"Baltimore Ravens",31,18,16,283,179,104,1,26,360,293,67,5,2002-10-27,4,1,"pit",13
"9","Sun","November 3","W","","5-3",FALSE,"Cleveland Browns",23,20,25,391,255,136,1,9,193,157,36,3,2002-11-03,2,1,"pit",3
"10","Sun","November 10","T","OT","5-3-1",TRUE,"Atlanta Falcons",34,34,30,645,463,182,3,21,447,279,168,2,2002-11-10,-1,0,"pit",0
"11","Sun","November 17","L","","5-4-1",FALSE,"Tennessee Titans",23,31,20,357,312,45,3,22,378,257,121,1,2002-11-17,-2,0,"pit",-8
"12","Sun","November 24","W","","6-4-1",TRUE,"Cincinnati Bengals",29,21,21,391,235,156,0,17,352,298,54,1,2002-11-24,1,1,"pit",8
"13","Sun","December 1","W","","7-4-1",FALSE,"Jacksonville Jaguars",25,23,23,403,184,219,1,13,226,124,102,0,2002-12-01,-1,1,"pit",2
"14","Sun","December 8","L","","7-5-1",TRUE,"Houston Texans",6,24,24,422,294,128,5,3,47,10,37,1,2002-12-08,-4,0,"pit",-18
"15","Sun","December 15","W","","8-5-1",TRUE,"Carolina Panthers",30,14,19,332,203,129,2,11,131,81,50,4,2002-12-15,2,1,"pit",16
"16","Mon","December 23","W","","9-5-1",FALSE,"Tampa Bay Buccaneers",17,7,19,327,233,94,1,18,277,203,74,3,2002-12-23,2,1,"pit",10
"17","Sun","December 29","W","","10-5-1",TRUE,"Baltimore Ravens",34,31,25,351,176,175,2,21,422,308,114,4,2002-12-29,2,1,"pit",3
"WildCard","Sun","January 5","W","","11-5-1",TRUE,"Cleveland Browns",36,33,30,432,343,89,3,21,447,409,38,1,2003-01-05,-2,1,"pit",3
"Division","Sat","January 11","L","OT","11-6-1",FALSE,"Tennessee Titans",31,34,21,324,257,67,1,29,430,331,99,4,2003-01-11,3,0,"pit",-3
"1","Sun","September 7","W","","1-0",TRUE,"Baltimore Ravens",34,15,21,339,251,88,1,17,231,143,88,2,2003-09-07,1,1,"pit",19
"2","Sun","September 14","L","","1-1",FALSE,"Kansas City Chiefs",20,41,16,380,320,60,4,19,282,123,159,2,2003-09-14,-2,0,"pit",-21
"3","Sun","September 21","W","","2-1",FALSE,"Cincinnati Bengals",17,10,22,376,238,138,1,11,182,125,57,1,2003-09-21,0,1,"pit",7
"4","Sun","September 28","L","","2-2",TRUE,"Tennessee Titans",13,30,25,376,307,69,2,9,198,158,40,0,2003-09-28,-2,0,"pit",-17
"5","Sun","October 5","L","","2-3",TRUE,"Cleveland Browns",13,33,11,209,149,60,3,22,324,200,124,2,2003-10-05,-1,0,"pit",-20
"6","Sun","October 12","L","","2-4",FALSE,"Denver Broncos",14,17,17,215,130,85,1,15,242,165,77,3,2003-10-12,2,0,"pit",-3
"8","Sun","October 26","L","","2-5",TRUE,"St. Louis Rams",21,33,11,245,151,94,4,26,448,359,89,0,2003-10-26,-4,0,"pit",-12
"9","Sun","November 2","L","","2-6",FALSE,"Seattle Seahawks",16,23,19,320,215,105,0,19,289,191,98,0,2003-11-02,0,0,"pit",-7
"10","Sun","November 9","W","","3-6",TRUE,"Arizona Cardinals",28,15,11,246,159,87,1,19,379,283,96,1,2003-11-09,0,1,"pit",13
"11","Mon","November 17","L","","3-7",FALSE,"San Francisco 49ers",14,30,21,349,305,44,2,17,423,254,169,0,2003-11-17,-2,0,"pit",-16
"12","Sun","November 23","W","","4-7",FALSE,"Cleveland Browns",13,6,11,168,59,109,0,19,303,213,90,5,2003-11-23,5,1,"pit",7
"13","Sun","November 30","L","","4-8",TRUE,"Cincinnati Bengals",20,24,23,384,299,85,2,18,379,266,113,0,2003-11-30,-2,0,"pit",-4
"14","Sun","December 7","W","","5-8",TRUE,"Oakland Raiders",27,7,21,399,266,133,2,9,161,39,122,3,2003-12-07,1,1,"pit",20
"15","Sun","December 14","L","","5-9",FALSE,"New York Jets",0,6,16,231,137,94,0,15,319,144,175,1,2003-12-14,1,0,"pit",-6
"16","Sun","December 21","W","","6-9",TRUE,"San Diego Chargers",40,24,21,341,160,181,0,21,344,228,116,3,2003-12-21,3,1,"pit",16
"17","Sun","December 28","L","OT","6-10",FALSE,"Baltimore Ravens",10,13,9,214,158,56,5,14,279,151,128,2,2003-12-28,-3,0,"pit",-3
"1","Sun","September 12","W","","1-0",TRUE,"Oakland Raiders",24,21,17,237,130,107,1,18,358,297,61,4,2004-09-12,3,1,"pit",3
"2","Sun","September 19","L","","1-1",FALSE,"Baltimore Ravens",13,30,16,310,217,93,3,15,259,87,172,0,2004-09-19,-3,0,"pit",-17
"3","Sun","September 26","W","","2-1",FALSE,"Miami Dolphins",13,3,15,314,161,153,1,13,169,117,52,4,2004-09-26,3,1,"pit",10
"4","Sun","October 3","W","","3-1",TRUE,"Cincinnati Bengals",28,17,23,333,168,165,2,22,293,156,137,3,2004-10-03,1,1,"pit",11
"5","Sun","October 10","W","","4-1",TRUE,"Cleveland Browns",34,23,21,401,231,170,1,17,305,207,98,1,2004-10-10,0,1,"pit",11
"6","Sun","October 17","W","","5-1",FALSE,"Dallas Cowboys",24,20,21,297,172,125,0,20,348,248,100,1,2004-10-17,1,1,"pit",4
"8","Sun","October 31","W","","6-1",TRUE,"New England Patriots",34,20,25,417,196,221,0,19,248,243,5,4,2004-10-31,4,1,"pit",14
"9","Sun","November 7","W","","7-1",TRUE,"Philadelphia Eagles",27,3,25,420,168,252,2,7,113,90,23,1,2004-11-07,-1,1,"pit",24
"10","Sun","November 14","W","","8-1",FALSE,"Cleveland Browns",24,10,18,300,120,180,1,12,228,160,68,4,2004-11-14,3,1,"pit",14
"11","Sun","November 21","W","","9-1",FALSE,"Cincinnati Bengals",19,14,21,235,84,151,1,10,209,147,62,1,2004-11-21,0,1,"pit",5
"12","Sun","November 28","W","","10-1",TRUE,"Washington Redskins",16,7,15,207,100,107,0,10,156,105,51,1,2004-11-28,1,1,"pit",9
"13","Sun","December 5","W","","11-1",FALSE,"Jacksonville Jaguars",17,16,15,316,196,120,0,20,359,259,100,0,2004-12-05,0,1,"pit",1
"14","Sun","December 12","W","","12-1",TRUE,"New York Jets",17,6,15,262,142,120,2,15,296,189,107,3,2004-12-12,1,1,"pit",11
"15","Sat","December 18","W","","13-1",FALSE,"New York Giants",33,30,27,469,309,160,2,18,278,182,96,1,2004-12-18,-1,1,"pit",3
"16","Sun","December 26","W","","14-1",TRUE,"Baltimore Ravens",20,7,20,404,221,183,2,16,248,177,71,1,2004-12-26,-1,1,"pit",13
"17","Sun","January 2","W","","15-1",FALSE,"Buffalo Bills",29,24,15,262,105,157,3,16,267,171,96,3,2005-01-02,0,1,"pit",5
"Division","Sat","January 15","W","OT","16-1",TRUE,"New York Jets",20,17,23,364,171,193,3,17,275,165,110,1,2005-01-15,-2,1,"pit",3
"ConfChamp","Sun","January 23","L","","16-2",TRUE,"New England Patriots",27,41,19,388,225,163,4,18,322,196,126,0,2005-01-23,-4,0,"pit",-14
"1","Sun","September 11","W","","1-0",TRUE,"Tennessee Titans",34,7,18,424,218,206,0,16,303,206,97,4,2005-09-11,4,1,"pit",27
"2","Sun","September 18","W","","2-0",FALSE,"Houston Texans",27,7,18,388,253,135,0,16,221,108,113,1,2005-09-18,1,1,"pit",20
"3","Sun","September 25","L","","2-1",TRUE,"New England Patriots",20,23,14,269,190,79,1,24,426,346,80,3,2005-09-25,2,0,"pit",-3
"5","Mon","October 10","W","","3-1",FALSE,"San Diego Chargers",24,22,25,311,207,104,1,20,279,213,66,2,2005-10-10,1,1,"pit",2
"6","Sun","October 16","L","OT","3-2",TRUE,"Jacksonville Jaguars",17,23,16,218,145,73,4,17,246,153,93,1,2005-10-16,-3,0,"pit",-6
"7","Sun","October 23","W","","4-2",FALSE,"Cincinnati Bengals",27,13,20,304,83,221,2,20,302,211,91,2,2005-10-23,0,1,"pit",14
"8","Mon","October 31","W","","5-2",TRUE,"Baltimore Ravens",20,19,19,261,160,101,2,20,318,246,72,3,2005-10-31,1,1,"pit",1
"9","Sun","November 6","W","","6-2",FALSE,"Green Bay Packers",20,10,13,213,59,154,1,16,268,203,65,3,2005-11-06,2,1,"pit",10
"10","Sun","November 13","W","","7-2",TRUE,"Cleveland Browns",34,21,25,382,223,159,0,16,303,242,61,2,2005-11-13,2,1,"pit",13
"11","Sun","November 20","L","OT","7-3",FALSE,"Baltimore Ravens",13,16,17,282,212,70,2,18,241,137,104,2,2005-11-20,0,0,"pit",-3
"12","Mon","November 28","L","","7-4",FALSE,"Indianapolis Colts",7,26,10,197,111,86,2,17,366,239,127,1,2005-11-28,-1,0,"pit",-19
"13","Sun","December 4","L","","7-5",TRUE,"Cincinnati Bengals",31,38,28,474,379,95,4,21,324,222,102,0,2005-12-04,-4,0,"pit",-7
"14","Sun","December 11","W","","8-5",TRUE,"Chicago Bears",21,9,20,363,173,190,0,15,268,185,83,0,2005-12-11,0,1,"pit",12
"15","Sun","December 18","W","","9-5",FALSE,"Minnesota Vikings",18,3,14,275,133,142,1,11,185,131,54,3,2005-12-18,2,1,"pit",15
"16","Sat","December 24","W","","10-5",FALSE,"Cleveland Browns",41,0,20,457,248,209,1,12,186,123,63,1,2005-12-24,0,1,"pit",41
"17","Sun","January 1","W","","11-5",TRUE,"Detroit Lions",35,21,20,331,132,199,2,16,308,203,105,2,2006-01-01,0,1,"pit",14
"WildCard","Sun","January 8","W","","12-5",FALSE,"Cincinnati Bengals",31,17,19,346,202,144,0,19,327,243,84,2,2006-01-08,2,1,"pit",14
"Division","Sun","January 15","W","","13-5",FALSE,"Indianapolis Colts",21,18,21,295,183,112,2,15,305,247,58,0,2006-01-15,-2,1,"pit",3
"ConfChamp","Sun","January 22","W","","14-5",FALSE,"Denver Broncos",34,17,20,358,268,90,0,16,308,211,97,4,2006-01-22,4,1,"pit",17
"SuperBowl","Sun","February 5","W","","15-5",TRUE,"Seattle Seahawks",21,10,14,339,158,181,2,20,396,259,137,1,2006-02-05,-1,1,"pit",11
"1","Thu","September 7","W","","1-0",TRUE,"Miami Dolphins",28,17,20,342,196,146,1,15,278,240,38,2,2006-09-07,1,1,"pit",11
"2","Mon","September 18","L","","1-1",FALSE,"Jacksonville Jaguars",0,9,9,153,127,26,2,17,362,252,110,1,2006-09-18,-1,0,"pit",-9
"3","Sun","September 24","L","","1-2",TRUE,"Cincinnati Bengals",20,28,27,365,195,170,5,15,246,159,87,3,2006-09-24,-2,0,"pit",-8
"5","Sun","October 8","L","","1-3",FALSE,"San Diego Chargers",13,23,16,265,197,68,2,22,341,222,119,1,2006-10-08,-1,0,"pit",-10
"6","Sun","October 15","W","","2-3",TRUE,"Kansas City Chiefs",45,7,23,457,238,219,1,14,213,175,38,3,2006-10-15,2,1,"pit",38
"7","Sun","October 22","L","OT","2-4",FALSE,"Atlanta Falcons",38,41,27,473,418,55,3,24,399,226,173,2,2006-10-22,-1,0,"pit",-3
"8","Sun","October 29","L","","2-5",FALSE,"Oakland Raiders",13,20,15,360,271,89,4,9,98,17,81,1,2006-10-29,-3,0,"pit",-7
"9","Sun","November 5","L","","2-6",TRUE,"Denver Broncos",20,31,27,499,403,96,6,13,336,221,115,0,2006-11-05,-6,0,"pit",-11
"10","Sun","November 12","W","","3-6",TRUE,"New Orleans Saints",38,31,19,467,250,217,0,29,513,393,120,3,2006-11-12,3,1,"pit",7
"11","Sun","November 19","W","","4-6",FALSE,"Cleveland Browns",24,20,23,338,261,77,3,15,302,203,99,2,2006-11-19,-1,1,"pit",4
"12","Sun","November 26","L","","4-7",FALSE,"Baltimore Ravens",0,27,17,172,151,21,3,19,275,161,114,0,2006-11-26,-3,0,"pit",-27
"13","Sun","December 3","W","","5-7",TRUE,"Tampa Bay Buccaneers",20,3,13,267,191,76,1,16,254,144,110,4,2006-12-03,3,1,"pit",17
"14","Thu","December 7","W","","6-7",TRUE,"Cleveland Browns",27,7,26,528,225,303,1,11,294,276,18,2,2006-12-07,1,1,"pit",20
"15","Sun","December 17","W","","7-7",FALSE,"Carolina Panthers",37,3,20,306,147,159,0,12,240,197,43,2,2006-12-17,2,1,"pit",34
"16","Sun","December 24","L","","7-8",TRUE,"Baltimore Ravens",7,31,16,251,188,63,3,23,359,256,103,3,2006-12-24,0,0,"pit",-24
"17","Sun","December 31","W","OT","8-8",FALSE,"Cincinnati Bengals",23,17,29,482,275,207,2,15,295,251,44,0,2006-12-31,-2,1,"pit",6
"1","Sun","September 9","W","","1-0",FALSE,"Cleveland Browns",34,7,17,365,159,206,1,13,221,175,46,5,2007-09-09,4,1,"pit",27
"2","Sun","September 16","W","","2-0",TRUE,"Buffalo Bills",26,3,24,420,236,184,1,10,223,121,102,0,2007-09-16,-1,1,"pit",23
"3","Sun","September 23","W","","3-0",TRUE,"San Francisco 49ers",37,16,19,350,145,205,1,17,289,198,91,1,2007-09-23,0,1,"pit",21
"4","Sun","September 30","L","","3-1",FALSE,"Arizona Cardinals",14,21,17,282,205,77,2,19,301,215,86,2,2007-09-30,0,0,"pit",-7
"5","Sun","October 7","W","","4-1",TRUE,"Seattle Seahawks",21,0,19,342,179,163,0,8,144,106,38,1,2007-10-07,1,1,"pit",21
"7","Sun","October 21","L","","4-2",FALSE,"Denver Broncos",28,31,24,379,260,119,3,21,324,234,90,2,2007-10-21,-1,0,"pit",-3
"8","Sun","October 28","W","","5-2",FALSE,"Cincinnati Bengals",24,13,23,390,230,160,1,15,296,205,91,1,2007-10-28,0,1,"pit",11
"9","Mon","November 5","W","","6-2",TRUE,"Baltimore Ravens",38,7,14,291,201,90,1,5,104,40,64,4,2007-11-05,3,1,"pit",31
"10","Sun","November 11","W","","7-2",TRUE,"Cleveland Browns",31,28,22,401,242,159,1,13,163,123,40,1,2007-11-11,0,1,"pit",3
"11","Sun","November 18","L","OT","7-3",FALSE,"New York Jets",16,19,16,263,151,112,2,20,297,146,151,1,2007-11-18,-1,0,"pit",-3
"12","Mon","November 26","W","","8-3",TRUE,"Miami Dolphins",3,0,13,216,132,84,1,9,159,110,49,2,2007-11-26,1,1,"pit",3
"13","Sun","December 2","W","","9-3",TRUE,"Cincinnati Bengals",24,10,20,285,184,101,4,15,249,175,74,1,2007-12-02,-3,1,"pit",14
"14","Sun","December 9","L","","9-4",FALSE,"New England Patriots",13,34,19,349,168,181,1,21,421,399,22,0,2007-12-09,-1,0,"pit",-21
"15","Sun","December 16","L","","9-5",TRUE,"Jacksonville Jaguars",22,29,13,217,102,115,0,25,421,197,224,1,2007-12-16,1,0,"pit",-7
"16","Thu","December 20","W","","10-5",FALSE,"St. Louis Rams",41,24,24,425,259,166,0,17,316,226,90,2,2007-12-20,2,1,"pit",17
"17","Sun","December 30","L","","10-6",FALSE,"Baltimore Ravens",21,27,14,264,218,46,3,21,334,154,180,1,2007-12-30,-2,0,"pit",-6
"WildCard","Sat","January 5","L","","10-7",TRUE,"Jacksonville Jaguars",29,31,24,340,297,43,4,14,239,104,135,2,2008-01-05,-2,0,"pit",-2
"1","Sun","September 7","W","","1-0",TRUE,"Houston Texans",38,17,21,305,122,183,1,20,234,159,75,3,2008-09-07,2,1,"pit",21
"2","Sun","September 14","W","","2-0",FALSE,"Cleveland Browns",10,6,14,281,164,117,0,17,208,155,53,2,2008-09-14,2,1,"pit",4
"3","Sun","September 21","L","","2-1",FALSE,"Philadelphia Eagles",6,15,14,181,147,34,3,16,260,195,65,3,2008-09-21,0,0,"pit",-9
"4","Mon","September 29","W","OT","3-1",TRUE,"Baltimore Ravens",23,20,11,237,168,69,1,16,243,140,103,1,2008-09-29,0,1,"pit",3
"5","Sun","October 5","W","","4-1",FALSE,"Jacksonville Jaguars",26,21,28,415,286,129,1,14,213,175,38,0,2008-10-05,-1,1,"pit",5
"7","Sun","October 19","W","","5-1",FALSE,"Cincinnati Bengals",38,10,20,375,250,125,0,16,212,128,84,1,2008-10-19,1,1,"pit",28
"8","Sun","October 26","L","","5-2",TRUE,"New York Giants",14,21,12,249,154,95,4,14,282,199,83,0,2008-10-26,-4,0,"pit",-7
"9","Mon","November 3","W","","6-2",FALSE,"Washington Redskins",23,6,15,229,165,64,1,13,221,161,60,2,2008-11-03,1,1,"pit",17
"10","Sun","November 9","L","","6-3",TRUE,"Indianapolis Colts",20,24,18,326,271,55,3,17,290,228,62,0,2008-11-09,-3,0,"pit",-4
"11","Sun","November 16","W","","7-3",TRUE,"San Diego Chargers",11,10,24,410,286,124,0,16,218,152,66,2,2008-11-16,2,1,"pit",1
"12","Thu","November 20","W","","8-3",TRUE,"Cincinnati Bengals",27,10,20,364,243,121,1,11,208,165,43,1,2008-11-20,0,1,"pit",17
"13","Sun","November 30","W","","9-3",FALSE,"New England Patriots",33,10,19,333,172,161,1,19,267,145,122,5,2008-11-30,4,1,"pit",23
"14","Sun","December 7","W","","10-3",TRUE,"Dallas Cowboys",20,13,13,238,168,70,2,15,289,194,95,5,2008-12-07,3,1,"pit",7
"15","Sun","December 14","W","","11-3",FALSE,"Baltimore Ravens",13,9,18,311,220,91,2,12,202,90,112,2,2008-12-14,0,1,"pit",4
"16","Sun","December 21","L","","11-4",FALSE,"Tennessee Titans",14,31,23,374,301,73,4,16,322,205,117,0,2008-12-21,-4,0,"pit",-17
"17","Sun","December 28","W","","12-4",TRUE,"Cleveland Browns",31,0,20,369,193,176,1,8,126,20,106,2,2008-12-28,1,1,"pit",31
"Division","Sun","January 11","W","","13-4",TRUE,"San Diego Chargers",35,24,22,342,177,165,0,15,290,275,15,2,2009-01-11,2,1,"pit",11
"ConfChamp","Sun","January 18","W","","14-4",TRUE,"Baltimore Ravens",23,14,11,275,223,52,1,13,198,125,73,4,2009-01-18,3,1,"pit",9
"SuperBowl","Sun","February 1","W","","15-4",TRUE,"Arizona Cardinals",27,23,20,292,234,58,1,23,407,374,33,2,2009-02-01,1,1,"pit",4
"1","Thu","September 10","W","OT","1-0",TRUE,"Tennessee Titans",13,10,19,357,321,36,3,18,320,234,86,2,2009-09-10,-1,1,"pit",3
"2","Sun","September 20","L","","1-1",FALSE,"Chicago Bears",14,17,21,308,203,105,2,17,275,231,44,0,2009-09-20,-2,0,"pit",-3
"3","Sun","September 27","L","","1-2",FALSE,"Cincinnati Bengals",20,23,17,373,271,102,1,19,273,173,100,0,2009-09-27,-1,0,"pit",-3
"4","Sun","October 4","W","","2-2",TRUE,"San Diego Chargers",38,28,32,497,320,177,1,17,251,235,16,1,2009-10-04,0,1,"pit",10
"5","Sun","October 11","W","","3-2",FALSE,"Detroit Lions",28,20,18,344,262,82,1,21,335,225,110,1,2009-10-11,0,1,"pit",8
"6","Sun","October 18","W","","4-2",TRUE,"Cleveland Browns",27,14,28,543,403,140,4,12,197,106,91,4,2009-10-18,0,1,"pit",13
"7","Sun","October 25","W","","5-2",TRUE,"Minnesota Vikings",27,17,14,259,152,107,1,21,386,297,89,2,2009-10-25,1,1,"pit",10
"9","Mon","November 9","W","","6-2",FALSE,"Denver Broncos",28,10,21,375,202,173,2,12,242,215,27,3,2009-11-09,1,1,"pit",18
"10","Sun","November 15","L","","6-3",TRUE,"Cincinnati Bengals",12,18,16,226,146,80,1,14,218,157,61,0,2009-11-15,-1,0,"pit",-6
"11","Sun","November 22","L","OT","6-4",FALSE,"Kansas City Chiefs",24,27,27,516,402,114,3,13,282,214,68,1,2009-11-22,-2,0,"pit",-3
"12","Sun","November 29","L","OT","6-5",FALSE,"Baltimore Ravens",17,20,16,298,145,153,1,21,393,261,132,2,2009-11-29,1,0,"pit",-3
"13","Sun","December 6","L","","6-6",TRUE,"Oakland Raiders",24,27,19,401,269,132,1,19,396,287,109,0,2009-12-06,-1,0,"pit",-3
"14","Thu","December 10","L","","6-7",FALSE,"Cleveland Browns",6,13,16,218,141,77,0,12,255,84,171,0,2009-12-10,0,0,"pit",-7
"15","Sun","December 20","W","","7-7",TRUE,"Green Bay Packers",37,36,28,537,472,65,0,18,436,376,60,0,2009-12-20,0,1,"pit",1
"16","Sun","December 27","W","","8-7",TRUE,"Baltimore Ravens",23,20,17,286,238,48,2,20,323,148,175,3,2009-12-27,1,1,"pit",3
"17","Sun","January 3","W","","9-7",FALSE,"Miami Dolphins",30,24,22,403,201,202,2,20,303,204,99,3,2010-01-03,1,1,"pit",6
"1","Sun","September 12","W","OT","1-0",TRUE,"Atlanta Falcons",15,9,14,354,211,143,1,18,295,237,58,1,2010-09-12,0,1,"pit",6
"2","Sun","September 19","W","","2-0",FALSE,"Tennessee Titans",19,11,7,127,21,106,1,14,238,192,46,7,2010-09-19,6,1,"pit",8
"3","Sun","September 26","W","","3-0",FALSE,"Tampa Bay Buccaneers",38,13,17,387,186,201,2,18,303,228,75,2,2010-09-26,0,1,"pit",25
"4","Sun","October 3","L","","3-1",TRUE,"Baltimore Ravens",14,17,14,210,126,84,1,22,320,250,70,2,2010-10-03,1,0,"pit",-3
"6","Sun","October 17","W","","4-1",TRUE,"Cleveland Browns",28,10,22,378,257,121,1,17,327,258,69,3,2010-10-17,2,1,"pit",18
"7","Sun","October 24","W","","5-1",FALSE,"Miami Dolphins",23,22,15,348,290,58,2,15,313,249,64,2,2010-10-24,0,1,"pit",1
"8","Sun","October 31","L","","5-2",FALSE,"New Orleans Saints",10,20,13,279,171,108,2,19,318,288,30,2,2010-10-31,0,0,"pit",-10
"9","Mon","November 8","W","","6-2",FALSE,"Cincinnati Bengals",27,21,14,314,193,121,2,18,272,218,54,2,2010-11-08,0,1,"pit",6
"10","Sun","November 14","L","","6-3",TRUE,"New England Patriots",26,39,27,425,349,76,1,26,453,350,103,0,2010-11-14,-1,0,"pit",-13
"11","Sun","November 21","W","","7-3",TRUE,"Oakland Raiders",35,3,18,431,269,162,1,17,182,121,61,3,2010-11-21,2,1,"pit",32
"12","Sun","November 28","W","OT","8-3",FALSE,"Buffalo Bills",19,16,28,426,220,206,1,19,329,255,74,2,2010-11-28,1,1,"pit",3
"13","Sun","December 5","W","","9-3",FALSE,"Baltimore Ravens",13,10,17,288,234,54,1,14,269,226,43,1,2010-12-05,0,1,"pit",3
"14","Sun","December 12","W","","10-3",TRUE,"Cincinnati Bengals",23,7,18,354,231,123,0,14,190,156,34,3,2010-12-12,3,1,"pit",16
"15","Sun","December 19","L","","10-4",TRUE,"New York Jets",17,22,25,377,231,146,0,17,276,170,106,0,2010-12-19,0,0,"pit",-5
"16","Thu","December 23","W","","11-4",TRUE,"Carolina Panthers",27,3,22,408,293,115,2,7,119,45,74,2,2010-12-23,0,1,"pit",24
"17","Sun","January 2","W","","12-4",FALSE,"Cleveland Browns",41,9,24,418,318,100,0,17,225,182,43,3,2011-01-02,3,1,"pit",32
"Division","Sat","January 15","W","","13-4",TRUE,"Baltimore Ravens",31,24,21,263,192,71,2,12,126,91,35,3,2011-01-15,1,1,"pit",7
"ConfChamp","Sun","January 23","W","","14-4",TRUE,"New York Jets",24,19,23,287,121,166,2,17,289,219,70,1,2011-01-23,-1,1,"pit",5
"SuperBowl","Sun","February 6","L","","14-5",TRUE,"Green Bay Packers",25,31,19,387,261,126,3,15,338,288,50,0,2011-02-06,-3,0,"pit",-6
"1","Sun","September 11","L","","0-1",FALSE,"Baltimore Ravens",7,35,20,312,246,66,7,17,385,215,170,0,2011-09-11,-7,0,"pit",-28
"2","Sun","September 18","W","","1-1",TRUE,"Seattle Seahawks",24,0,23,421,297,124,0,8,164,133,31,0,2011-09-18,0,1,"pit",24
"3","Sun","September 25","W","","2-1",FALSE,"Indianapolis Colts",23,20,19,408,341,67,3,14,241,144,97,1,2011-09-25,-2,1,"pit",3
"4","Sun","October 2","L","","2-2",FALSE,"Houston Texans",10,17,20,296,178,118,1,17,318,138,180,0,2011-10-02,-1,0,"pit",-7
"5","Sun","October 9","W","","3-2",TRUE,"Tennessee Titans",38,17,26,431,257,174,1,20,306,240,66,1,2011-10-09,0,1,"pit",21
"6","Sun","October 16","W","","4-2",TRUE,"Jacksonville Jaguars",17,13,15,370,185,185,0,16,209,76,133,0,2011-10-16,0,1,"pit",4
"7","Sun","October 23","W","","5-2",FALSE,"Arizona Cardinals",32,20,26,445,354,91,0,23,330,257,73,1,2011-10-23,1,1,"pit",12
"8","Sun","October 30","W","","6-2",TRUE,"New England Patriots",25,17,29,427,329,98,1,19,213,170,43,0,2011-10-30,-1,1,"pit",8
"9","Sun","November 6","L","","6-3",TRUE,"Baltimore Ravens",20,23,20,392,322,70,2,23,356,289,67,1,2011-11-06,-1,0,"pit",-3
"10","Sun","November 13","W","","7-3",FALSE,"Cincinnati Bengals",24,17,24,328,223,105,1,14,279,170,109,2,2011-11-13,1,1,"pit",7
"12","Sun","November 27","W","","8-3",FALSE,"Kansas City Chiefs",13,9,18,290,182,108,2,15,252,162,90,4,2011-11-27,2,1,"pit",4
"13","Sun","December 4","W","","9-3",TRUE,"Cincinnati Bengals",35,7,22,295,159,136,0,13,232,128,104,2,2011-12-04,2,1,"pit",28
"14","Thu","December 8","W","","10-3",TRUE,"Cleveland Browns",14,3,20,416,269,147,3,19,304,206,98,2,2011-12-08,-1,1,"pit",11
"15","Mon","December 19","L","","10-4",FALSE,"San Francisco 49ers",3,20,20,389,305,84,4,17,287,187,100,0,2011-12-19,-4,0,"pit",-17
"16","Sat","December 24","W","","11-4",TRUE,"St. Louis Rams",27,0,17,377,208,169,1,15,232,68,164,0,2011-12-24,-1,1,"pit",27
"17","Sun","January 1","W","","12-4",FALSE,"Cleveland Browns",13,9,22,360,199,161,2,14,240,168,72,1,2012-01-01,-1,1,"pit",4
"WildCard","Sun","January 8","L","OT","12-5",FALSE,"Denver Broncos",23,29,21,400,244,156,1,18,447,316,131,1,2012-01-08,0,0,"pit",-6
"1","Sun","September 8","L","OT","0-1",TRUE,"St. Louis Cardinals",24,27,19,357,181,176,3,15,286,186,100,0,1985-09-08,-3,0,"cle",-3
"2","Mon","September 16","W","","1-1",TRUE,"Pittsburgh Steelers",17,7,21,293,148,145,1,15,216,162,54,2,1985-09-16,1,1,"cle",10
"3","Sun","September 22","L","","1-2",FALSE,"Dallas Cowboys",7,20,15,297,169,128,3,20,343,212,131,2,1985-09-22,-1,0,"cle",-13
"4","Sun","September 29","W","","2-2",FALSE,"San Diego Chargers",21,7,23,440,165,275,1,16,275,219,56,2,1985-09-29,1,1,"cle",14
"5","Sun","October 6","W","","3-2",TRUE,"New England Patriots",24,20,28,447,301,146,5,18,400,291,109,3,1985-10-06,-2,1,"cle",4
"6","Sun","October 13","W","","4-2",FALSE,"Houston Oilers",21,6,13,360,208,152,4,14,190,67,123,2,1985-10-13,-2,1,"cle",15
"7","Sun","October 20","L","","4-3",TRUE,"Los Angeles Raiders",20,21,18,232,123,109,0,20,319,199,120,2,1985-10-20,2,0,"cle",-1
"8","Sun","October 27","L","","4-4",TRUE,"Washington Redskins",7,14,17,264,167,97,4,19,284,142,142,1,1985-10-27,-3,0,"cle",-7
"9","Sun","November 3","L","","4-5",FALSE,"Pittsburgh Steelers",9,10,9,153,87,66,0,17,238,83,155,0,1985-11-03,0,0,"cle",-1
"10","Sun","November 10","L","","4-6",FALSE,"Cincinnati Bengals",10,27,13,325,213,112,3,23,370,252,118,0,1985-11-10,-3,0,"cle",-17
"11","Sun","November 17","W","","5-6",TRUE,"Buffalo Bills",17,7,17,294,93,201,1,13,217,162,55,3,1985-11-17,2,1,"cle",10
"12","Sun","November 24","W","","6-6",TRUE,"Cincinnati Bengals",24,6,14,283,102,181,0,14,226,90,136,1,1985-11-24,1,1,"cle",18
"13","Sun","December 1","W","","7-6",FALSE,"New York Giants",35,33,17,314,205,109,3,28,496,267,229,3,1985-12-01,0,1,"cle",2
"14","Sun","December 8","L","","7-7",FALSE,"Seattle Seahawks",13,31,16,306,214,92,4,21,338,246,92,1,1985-12-08,-3,0,"cle",-18
"15","Sun","December 15","W","","8-7",TRUE,"Houston Oilers",28,21,19,314,156,158,1,21,399,303,96,3,1985-12-15,2,1,"cle",7
"16","Sun","December 22","L","","8-8",FALSE,"New York Jets",10,37,12,242,104,138,3,23,361,226,135,2,1985-12-22,-1,0,"cle",-27
"Division","Sat","January 4","L","","8-9",FALSE,"Miami Dolphins",21,24,17,313,62,251,1,20,330,238,92,1,1986-01-04,0,0,"cle",-3
"1","Sun","September 7","L","","0-1",FALSE,"Chicago Bears",31,41,21,349,280,69,1,26,367,174,193,1,1986-09-07,0,0,"cle",-10
"2","Sun","September 14","W","","1-1",FALSE,"Houston Oilers",23,20,9,243,156,87,1,20,404,264,140,5,1986-09-14,4,1,"cle",3
"3","Thu","September 18","L","","1-2",TRUE,"Cincinnati Bengals",13,30,24,338,255,83,1,20,399,142,257,1,1986-09-18,0,0,"cle",-17
"4","Sun","September 28","W","","2-2",TRUE,"Detroit Lions",24,21,15,254,170,84,1,25,333,228,105,0,1986-09-28,-1,1,"cle",3
"5","Sun","October 5","W","","3-2",FALSE,"Pittsburgh Steelers",27,24,16,270,162,108,3,19,308,132,176,4,1986-10-05,1,1,"cle",3
"6","Sun","October 12","W","","4-2",TRUE,"Kansas City Chiefs",20,7,20,356,285,71,1,10,126,83,43,2,1986-10-12,1,1,"cle",13
"7","Sun","October 19","L","","4-3",TRUE,"Green Bay Packers",14,17,14,265,233,32,2,19,360,264,96,1,1986-10-19,-1,0,"cle",-3
"8","Sun","October 26","W","","5-3",FALSE,"Minnesota Vikings",23,20,14,199,50,149,2,20,396,238,158,2,1986-10-26,0,1,"cle",3
"9","Sun","November 2","W","","6-3",FALSE,"Indianapolis Colts",24,9,15,259,213,46,0,20,264,159,105,1,1986-11-02,1,1,"cle",15
"10","Mon","November 10","W","","7-3",TRUE,"Miami Dolphins",26,16,29,558,390,168,2,20,353,295,58,2,1986-11-10,0,1,"cle",10
"11","Sun","November 16","L","","7-4",FALSE,"Los Angeles Raiders",14,27,8,217,145,72,2,16,323,202,121,1,1986-11-16,-1,0,"cle",-13
"12","Sun","November 23","W","OT","8-4",TRUE,"Pittsburgh Steelers",37,31,35,536,414,122,1,20,339,197,142,1,1986-11-23,0,1,"cle",6
"13","Sun","November 30","W","OT","9-4",TRUE,"Houston Oilers",13,10,18,345,170,175,4,18,290,162,128,6,1986-11-30,2,1,"cle",3
"14","Sun","December 7","W","","10-4",FALSE,"Buffalo Bills",21,17,21,371,230,141,1,17,391,308,83,3,1986-12-07,2,1,"cle",4
"15","Sun","December 14","W","","11-4",FALSE,"Cincinnati Bengals",34,3,19,372,246,126,0,15,283,148,135,3,1986-12-14,3,1,"cle",31
"16","Sun","December 21","W","","12-4",TRUE,"San Diego Chargers",47,17,24,462,345,117,2,17,333,292,41,4,1986-12-21,2,1,"cle",30
"Division","Sat","January 3","W","OT","13-4",TRUE,"New York Jets",23,20,33,558,483,75,2,14,287,183,104,0,1987-01-03,-2,1,"cle",3
"ConfChamp","Sun","January 11","L","OT","13-5",TRUE,"Denver Broncos",20,23,17,356,256,100,3,22,374,225,149,1,1987-01-11,-2,0,"cle",-3
"1","Sun","September 13","L","","0-1",FALSE,"New Orleans Saints",21,28,25,387,294,93,2,21,338,147,191,0,1987-09-13,-2,0,"cle",-7
"2","Sun","September 20","W","","1-1",TRUE,"Pittsburgh Steelers",34,10,18,304,180,124,2,17,185,127,58,6,1987-09-20,4,1,"cle",24
"3","Sun","October 4","W","","2-1",FALSE,"New England Patriots",20,10,22,348,131,217,3,10,141,110,31,1,1987-10-04,-2,1,"cle",10
"4","Sun","October 11","L","","2-2",TRUE,"Houston Oilers",10,15,9,169,119,50,4,17,317,143,174,2,1987-10-11,-2,0,"cle",-5
"5","Sun","October 18","W","","3-2",FALSE,"Cincinnati Bengals",34,0,29,410,287,123,4,6,95,30,65,3,1987-10-18,-1,1,"cle",34
"6","Mon","October 26","W","","4-2",TRUE,"Los Angeles Rams",30,17,15,267,202,65,1,22,328,227,101,4,1987-10-26,3,1,"cle",13
"7","Sun","November 1","L","OT","4-3",FALSE,"San Diego Chargers",24,27,19,339,267,72,3,22,414,286,128,2,1987-11-01,-1,0,"cle",-3
"8","Sun","November 8","W","","5-3",TRUE,"Atlanta Falcons",38,3,24,365,192,173,1,13,243,126,117,2,1987-11-08,1,1,"cle",35
"9","Sun","November 15","W","","6-3",TRUE,"Buffalo Bills",27,21,24,421,337,84,3,17,267,206,61,2,1987-11-15,-1,1,"cle",6
"10","Sun","November 22","W","","7-3",FALSE,"Houston Oilers",40,7,27,457,257,200,0,11,247,204,43,6,1987-11-22,6,1,"cle",33
"11","Sun","November 29","L","","7-4",FALSE,"San Francisco 49ers",24,38,18,360,268,92,1,23,455,336,119,2,1987-11-29,1,0,"cle",-14
"12","Sun","December 6","L","","7-5",TRUE,"Indianapolis Colts",7,9,15,247,160,87,1,18,297,183,114,1,1987-12-06,0,0,"cle",-2
"13","Sun","December 13","W","","8-5",TRUE,"Cincinnati Bengals",38,24,19,390,237,153,1,24,417,352,65,2,1987-12-13,1,1,"cle",14
"14","Sun","December 20","W","","9-5",FALSE,"Los Angeles Raiders",24,17,24,421,294,127,2,20,299,228,71,1,1987-12-20,-1,1,"cle",7
"15","Sat","December 26","W","","10-5",FALSE,"Pittsburgh Steelers",19,13,22,315,230,85,1,10,221,126,95,2,1987-12-26,1,1,"cle",6
"Division","Sat","January 9","W","","11-5",TRUE,"Indianapolis Colts",38,21,25,404,229,175,1,23,315,252,63,2,1988-01-09,1,1,"cle",17
"ConfChamp","Sun","January 17","L","","11-6",FALSE,"Denver Broncos",33,38,25,464,336,128,4,24,412,256,156,1,1988-01-17,-3,0,"cle",-5
"1","Sun","September 4","W","","1-0",FALSE,"Kansas City Chiefs",6,3,20,337,195,142,1,9,149,89,60,2,1988-09-04,1,1,"cle",3
"2","Sun","September 11","L","","1-1",TRUE,"New York Jets",3,23,12,222,186,36,3,22,402,248,154,1,1988-09-11,-2,0,"cle",-20
"3","Mon","September 19","W","","2-1",TRUE,"Indianapolis Colts",23,17,22,356,255,101,2,15,282,154,128,3,1988-09-19,1,1,"cle",6
"4","Sun","September 25","L","","2-2",FALSE,"Cincinnati Bengals",17,24,20,322,254,68,1,22,393,180,213,0,1988-09-25,-1,0,"cle",-7
"5","Sun","October 2","W","","3-2",FALSE,"Pittsburgh Steelers",23,9,15,299,131,168,1,13,183,94,89,5,1988-10-02,4,1,"cle",14
"6","Sun","October 9","L","","3-3",TRUE,"Seattle Seahawks",10,16,21,334,174,160,4,14,227,101,126,1,1988-10-09,-3,0,"cle",-6
"7","Sun","October 16","W","","4-3",TRUE,"Philadelphia Eagles",19,3,17,361,179,182,1,12,119,48,71,2,1988-10-16,1,1,"cle",16
"8","Sun","October 23","W","","5-3",FALSE,"Phoenix Cardinals",29,21,21,369,301,68,4,27,330,161,169,4,1988-10-23,0,1,"cle",8
"9","Sun","October 30","W","","6-3",TRUE,"Cincinnati Bengals",23,16,17,302,203,99,2,18,281,153,128,0,1988-10-30,-2,1,"cle",7
"10","Mon","November 7","L","","6-4",FALSE,"Houston Oilers",17,24,15,253,209,44,1,18,330,182,148,1,1988-11-07,0,0,"cle",-7
"11","Sun","November 13","L","","6-5",FALSE,"Denver Broncos",7,30,15,227,140,87,4,27,335,215,120,0,1988-11-13,-4,0,"cle",-23
"12","Sun","November 20","W","","7-5",TRUE,"Pittsburgh Steelers",27,7,11,262,192,70,0,18,285,167,118,4,1988-11-20,4,1,"cle",20
"13","Sun","November 27","W","","8-5",FALSE,"Washington Redskins",17,13,25,324,166,158,1,11,227,124,103,2,1988-11-27,1,1,"cle",4
"14","Sun","December 4","W","","9-5",TRUE,"Dallas Cowboys",24,21,16,302,275,27,1,22,410,247,163,1,1988-12-04,0,1,"cle",3
"15","Mon","December 12","L","","9-6",FALSE,"Miami Dolphins",31,38,22,353,266,87,3,35,497,404,93,4,1988-12-12,1,0,"cle",-7
"16","Sun","December 18","W","","10-6",TRUE,"Houston Oilers",28,23,25,388,310,78,4,18,317,280,37,1,1988-12-18,-3,1,"cle",5
"WildCard","Sat","December 24","L","","10-7",TRUE,"Houston Oilers",23,24,19,260,192,68,2,19,334,205,129,3,1988-12-24,1,0,"cle",-1
"1","Sun","September 10","W","","1-0",FALSE,"Pittsburgh Steelers",51,0,19,357,205,152,0,5,53,17,36,8,1989-09-10,8,1,"cle",51
"2","Sun","September 17","W","","2-0",TRUE,"New York Jets",38,24,18,277,192,85,1,21,382,246,136,4,1989-09-17,3,1,"cle",14
"3","Mon","September 25","L","","2-1",FALSE,"Cincinnati Bengals",14,21,16,267,175,92,0,21,371,184,187,1,1989-09-25,1,0,"cle",-7
"4","Sun","October 1","W","","3-1",TRUE,"Denver Broncos",16,13,16,296,201,95,1,10,241,161,80,3,1989-10-01,2,1,"cle",3
"5","Sun","October 8","L","OT","3-2",FALSE,"Miami Dolphins",10,13,19,330,189,141,2,18,304,234,70,1,1989-10-08,-1,0,"cle",-3
"6","Sun","October 15","L","","3-3",TRUE,"Pittsburgh Steelers",7,17,17,260,153,107,7,16,231,138,93,2,1989-10-15,-5,0,"cle",-10
"7","Mon","October 23","W","","4-3",TRUE,"Chicago Bears",27,7,17,326,273,53,0,16,301,152,149,1,1989-10-23,1,1,"cle",20
"8","Sun","October 29","W","","5-3",TRUE,"Houston Oilers",28,17,18,383,280,103,2,17,299,210,89,0,1989-10-29,-2,1,"cle",11
"9","Sun","November 5","W","","6-3",FALSE,"Tampa Bay Buccaneers",42,31,18,271,157,114,0,24,398,349,49,4,1989-11-05,4,1,"cle",11
"10","Sun","November 12","W","","7-3",FALSE,"Seattle Seahawks",17,7,20,277,138,139,0,14,180,134,46,3,1989-11-12,3,1,"cle",10
"11","Sun","November 19","T","OT","7-3-1",TRUE,"Kansas City Chiefs",10,10,17,261,183,78,5,17,307,188,119,3,1989-11-19,-2,0,"cle",0
"12","Thu","November 23","L","","7-4-1",FALSE,"Detroit Lions",10,13,14,359,289,70,2,15,271,125,146,1,1989-11-23,-1,0,"cle",-3
"13","Sun","December 3","L","","7-5-1",TRUE,"Cincinnati Bengals",0,21,15,264,176,88,3,16,298,197,101,3,1989-12-03,0,0,"cle",-21
"14","Sun","December 10","L","OT","7-6-1",FALSE,"Indianapolis Colts",17,23,24,470,347,123,4,19,396,251,145,1,1989-12-10,-3,0,"cle",-6
"15","Sun","December 17","W","OT","8-6-1",TRUE,"Minnesota Vikings",23,17,16,320,256,64,2,19,316,194,122,1,1989-12-17,-1,1,"cle",6
"16","Sat","December 23","W","","9-6-1",FALSE,"Houston Oilers",24,20,21,324,219,105,1,28,483,381,102,2,1989-12-23,1,1,"cle",4
"Division","Sat","January 6","W","","10-6-1",TRUE,"Buffalo Bills",34,30,18,325,235,90,1,24,453,404,49,3,1990-01-06,2,1,"cle",4
"ConfChamp","Sun","January 14","L","","10-7-1",FALSE,"Denver Broncos",21,37,14,256,190,66,3,22,497,377,120,2,1990-01-14,-1,0,"cle",-16
"1","Sun","September 9","W","","1-0",TRUE,"Pittsburgh Steelers",13,3,11,158,78,80,1,14,210,161,49,3,1990-09-09,2,1,"cle",10
"2","Sun","September 16","L","","1-1",FALSE,"New York Jets",21,24,13,259,215,44,2,21,362,192,170,0,1990-09-16,-2,0,"cle",-3
"3","Sun","September 23","L","","1-2",TRUE,"San Diego Chargers",14,24,14,262,218,44,4,16,266,129,137,2,1990-09-23,-2,0,"cle",-10
"4","Sun","September 30","L","","1-3",FALSE,"Kansas City Chiefs",0,34,13,270,202,68,3,14,259,182,77,1,1990-09-30,-2,0,"cle",-34
"5","Mon","October 8","W","","2-3",FALSE,"Denver Broncos",30,29,23,415,318,97,3,19,316,175,141,2,1990-10-08,-1,1,"cle",1
"6","Sun","October 14","L","","2-4",FALSE,"New Orleans Saints",20,25,20,238,157,81,1,19,348,259,89,1,1990-10-14,0,0,"cle",-5
"7","Mon","October 22","L","","2-5",TRUE,"Cincinnati Bengals",13,34,17,253,157,96,2,15,312,79,233,2,1990-10-22,0,0,"cle",-21
"8","Sun","October 28","L","","2-6",FALSE,"San Francisco 49ers",17,20,18,274,236,38,3,20,294,177,117,2,1990-10-28,-1,0,"cle",-3
"9","Sun","November 4","L","","2-7",TRUE,"Buffalo Bills",0,42,10,234,191,43,2,24,310,208,102,0,1990-11-04,-2,0,"cle",-42
"11","Sun","November 18","L","","2-8",TRUE,"Houston Oilers",23,35,21,361,263,98,4,21,378,284,94,2,1990-11-18,-2,0,"cle",-12
"12","Sun","November 25","L","","2-9",TRUE,"Miami Dolphins",13,30,20,294,185,109,2,20,356,245,111,0,1990-11-25,-2,0,"cle",-17
"13","Sun","December 2","L","","2-10",TRUE,"Los Angeles Rams",23,38,18,303,266,37,1,27,411,261,150,1,1990-12-02,0,0,"cle",-15
"14","Sun","December 9","L","","2-11",FALSE,"Houston Oilers",14,58,12,195,138,57,4,34,477,271,206,1,1990-12-09,-3,0,"cle",-44
"15","Sun","December 16","W","","3-11",TRUE,"Atlanta Falcons",13,10,20,348,206,142,2,16,260,179,81,0,1990-12-16,-2,1,"cle",3
"16","Sun","December 23","L","","3-12",FALSE,"Pittsburgh Steelers",0,35,10,158,133,25,9,20,329,132,197,2,1990-12-23,-7,0,"cle",-35
"17","Sun","December 30","L","","3-13",FALSE,"Cincinnati Bengals",14,21,19,345,184,161,3,14,302,151,151,3,1990-12-30,0,0,"cle",-7
"1","Sun","September 1","L","","0-1",TRUE,"Dallas Cowboys",14,26,15,275,243,32,0,25,395,265,130,0,1991-09-01,0,0,"cle",-12
"2","Sun","September 8","W","","1-1",FALSE,"New England Patriots",20,0,16,279,166,113,0,8,143,71,72,4,1991-09-08,4,1,"cle",20
"3","Sun","September 15","W","","2-1",TRUE,"Cincinnati Bengals",14,13,17,263,179,84,2,16,268,134,134,3,1991-09-15,1,1,"cle",1
"4","Sun","September 22","L","","2-2",FALSE,"New York Giants",10,13,10,145,67,78,0,12,264,52,212,2,1991-09-22,2,0,"cle",-3
"6","Sun","October 6","L","","2-3",TRUE,"New York Jets",14,17,14,237,131,106,1,18,287,211,76,1,1991-10-06,0,0,"cle",-3
"7","Sun","October 13","L","","2-4",FALSE,"Washington Redskins",17,42,17,389,301,88,2,23,398,190,208,1,1991-10-13,-1,0,"cle",-25
"8","Sun","October 20","W","OT","3-4",FALSE,"San Diego Chargers",30,24,17,364,294,70,0,29,437,305,132,3,1991-10-20,3,1,"cle",6
"9","Sun","October 27","W","","4-4",TRUE,"Pittsburgh Steelers",17,14,19,262,179,83,0,18,282,207,75,2,1991-10-27,2,1,"cle",3
"10","Sun","November 3","L","","4-5",FALSE,"Cincinnati Bengals",21,23,22,363,280,83,1,19,347,185,162,1,1991-11-03,0,0,"cle",-2
"11","Sun","November 10","L","","4-6",TRUE,"Philadelphia Eagles",30,32,16,258,233,25,2,24,418,321,97,1,1991-11-10,-1,0,"cle",-2
"12","Sun","November 17","L","","4-7",FALSE,"Houston Oilers",24,28,17,311,262,49,1,25,440,395,45,4,1991-11-17,3,0,"cle",-4
"13","Sun","November 24","W","","5-7",TRUE,"Kansas City Chiefs",20,15,9,281,158,123,2,21,389,311,78,5,1991-11-24,3,1,"cle",5
"14","Sun","December 1","W","","6-7",FALSE,"Indianapolis Colts",31,0,19,315,177,138,0,11,171,28,143,4,1991-12-01,4,1,"cle",31
"15","Sun","December 8","L","","6-8",TRUE,"Denver Broncos",7,17,9,181,80,101,1,17,290,200,90,1,1991-12-08,0,0,"cle",-10
"16","Sun","December 15","L","","6-9",TRUE,"Houston Oilers",14,17,22,340,239,101,1,20,330,247,83,1,1991-12-15,0,0,"cle",-3
"17","Sun","December 22","L","","6-10",FALSE,"Pittsburgh Steelers",10,17,26,401,315,86,5,12,225,87,138,0,1991-12-22,-5,0,"cle",-7
"1","Sun","September 6","L","","0-1",FALSE,"Indianapolis Colts",3,14,13,145,103,42,2,15,236,172,64,2,1992-09-06,0,0,"cle",-11
"2","Mon","September 14","L","","0-2",TRUE,"Miami Dolphins",23,27,17,322,211,111,0,24,401,300,101,1,1992-09-14,1,0,"cle",-4
"3","Sun","September 20","W","","1-2",FALSE,"Los Angeles Raiders",28,16,7,231,200,31,0,27,464,354,110,5,1992-09-20,5,1,"cle",12
"4","Sun","September 27","L","","1-3",TRUE,"Denver Broncos",0,12,10,216,75,141,3,15,300,112,188,1,1992-09-27,-2,0,"cle",-12
"6","Sun","October 11","W","","2-3",TRUE,"Pittsburgh Steelers",17,9,12,253,168,85,1,20,348,228,120,1,1992-10-11,0,1,"cle",8
"7","Sun","October 18","W","","3-3",TRUE,"Green Bay Packers",17,6,20,300,158,142,1,16,280,208,72,2,1992-10-18,1,1,"cle",11
"8","Sun","October 25","W","","4-3",FALSE,"New England Patriots",19,17,18,288,165,123,0,14,253,176,77,4,1992-10-25,4,1,"cle",2
"9","Sun","November 1","L","","4-4",FALSE,"Cincinnati Bengals",10,30,16,328,270,58,2,20,300,195,105,1,1992-11-01,-1,0,"cle",-20
"10","Sun","November 8","W","","5-4",FALSE,"Houston Oilers",24,14,17,291,205,86,1,13,273,181,92,2,1992-11-08,1,1,"cle",10
"11","Sun","November 15","L","","5-5",TRUE,"San Diego Chargers",13,14,19,385,298,87,3,16,312,224,88,3,1992-11-15,0,0,"cle",-1
"12","Sun","November 22","L","","5-6",FALSE,"Minnesota Vikings",13,17,14,275,180,95,4,10,141,52,89,3,1992-11-22,-1,0,"cle",-4
"13","Sun","November 29","W","","6-6",TRUE,"Chicago Bears",27,14,12,178,47,131,0,16,320,247,73,4,1992-11-29,4,1,"cle",13
"14","Sun","December 6","W","","7-6",TRUE,"Cincinnati Bengals",37,21,17,381,232,149,2,15,227,165,62,1,1992-12-06,-1,1,"cle",16
"15","Sun","December 13","L","","7-7",FALSE,"Detroit Lions",14,24,14,321,260,61,3,19,276,121,155,0,1992-12-13,-3,0,"cle",-10
"16","Sun","December 20","L","","7-8",TRUE,"Houston Oilers",14,17,19,285,140,145,3,21,318,214,104,3,1992-12-20,0,0,"cle",-3
"17","Sun","December 27","L","","7-9",FALSE,"Pittsburgh Steelers",13,23,17,293,173,120,3,20,308,203,105,0,1992-12-27,-3,0,"cle",-10
"1","Sun","September 5","W","","1-0",TRUE,"Cincinnati Bengals",27,14,18,263,167,96,0,12,227,172,55,3,1993-09-05,3,1,"cle",13
"2","Mon","September 13","W","","2-0",TRUE,"San Francisco 49ers",23,13,18,304,176,128,0,22,396,266,130,4,1993-09-13,4,1,"cle",10
"3","Sun","September 19","W","","3-0",FALSE,"Los Angeles Raiders",19,16,20,316,203,113,4,11,156,85,71,0,1993-09-19,-4,1,"cle",3
"4","Sun","September 26","L","","3-1",FALSE,"Indianapolis Colts",10,23,13,253,153,100,2,21,357,260,97,0,1993-09-26,-2,0,"cle",-13
"6","Sun","October 10","L","","3-2",TRUE,"Miami Dolphins",14,24,16,202,112,90,2,20,338,268,70,1,1993-10-10,-1,0,"cle",-10
"7","Sun","October 17","W","","4-2",FALSE,"Cincinnati Bengals",28,17,17,293,110,183,2,14,194,160,34,1,1993-10-17,-1,1,"cle",11
"8","Sun","October 24","W","","5-2",TRUE,"Pittsburgh Steelers",28,23,12,245,147,98,1,26,440,348,92,2,1993-10-24,1,1,"cle",5
"10","Sun","November 7","L","","5-3",TRUE,"Denver Broncos",14,29,14,266,191,75,0,21,393,233,160,1,1993-11-07,1,0,"cle",-15
"11","Sun","November 14","L","","5-4",FALSE,"Seattle Seahawks",5,22,13,232,57,175,7,12,223,104,119,0,1993-11-14,-7,0,"cle",-17
"12","Sun","November 21","L","","5-5",TRUE,"Houston Oilers",20,27,20,349,300,49,5,25,384,182,202,4,1993-11-21,-1,0,"cle",-7
"13","Sun","November 28","L","","5-6",FALSE,"Atlanta Falcons",14,17,16,306,191,115,1,13,261,194,67,1,1993-11-28,0,0,"cle",-3
"14","Sun","December 5","W","","6-6",TRUE,"New Orleans Saints",17,13,15,314,183,131,4,12,127,48,79,0,1993-12-05,-4,1,"cle",4
"15","Sun","December 12","L","","6-7",FALSE,"Houston Oilers",17,19,19,410,305,105,3,18,257,129,128,1,1993-12-12,-2,0,"cle",-2
"16","Sun","December 19","L","","6-8",TRUE,"New England Patriots",17,20,18,377,297,80,3,23,323,203,120,1,1993-12-19,-2,0,"cle",-3
"17","Sun","December 26","W","","7-8",FALSE,"Los Angeles Rams",42,14,23,315,213,102,0,20,382,287,95,3,1993-12-26,3,1,"cle",28
"18","Sun","January 2","L","","7-9",FALSE,"Pittsburgh Steelers",9,16,12,295,234,61,2,20,320,185,135,0,1994-01-02,-2,0,"cle",-7
"1","Sun","September 4","W","","1-0",FALSE,"Cincinnati Bengals",28,20,16,256,149,107,2,23,331,213,118,2,1994-09-04,0,1,"cle",8
"2","Sun","September 11","L","","1-1",TRUE,"Pittsburgh Steelers",10,17,18,278,197,81,5,17,315,199,116,0,1994-09-11,-5,0,"cle",-7
"3","Sun","September 18","W","","2-1",TRUE,"Arizona Cardinals",32,0,17,322,243,79,2,21,318,255,63,3,1994-09-18,1,1,"cle",32
"4","Sun","September 25","W","","3-1",FALSE,"Indianapolis Colts",21,14,17,376,257,119,1,18,335,189,146,1,1994-09-25,0,1,"cle",7
"5","Sun","October 2","W","","4-1",TRUE,"New York Jets",27,7,18,363,246,117,0,19,346,274,72,3,1994-10-02,3,1,"cle",20
"7","Thu","October 13","W","","5-1",FALSE,"Houston Oilers",11,8,12,260,196,64,2,20,305,199,106,2,1994-10-13,0,1,"cle",3
"8","Sun","October 23","W","","6-1",TRUE,"Cincinnati Bengals",37,13,13,240,120,120,1,15,221,146,75,1,1994-10-23,0,1,"cle",24
"9","Sun","October 30","L","","6-2",FALSE,"Denver Broncos",14,26,17,317,276,41,1,29,457,343,114,2,1994-10-30,1,0,"cle",-12
"10","Sun","November 6","W","","7-2",TRUE,"New England Patriots",13,6,16,308,160,148,2,20,277,159,118,4,1994-11-06,2,1,"cle",7
"11","Sun","November 13","W","","8-2",FALSE,"Philadelphia Eagles",26,7,18,298,158,140,1,15,288,176,112,2,1994-11-13,1,1,"cle",19
"12","Sun","November 20","L","","8-3",FALSE,"Kansas City Chiefs",13,20,15,239,145,94,4,23,287,153,134,1,1994-11-20,-3,0,"cle",-7
"13","Sun","November 27","W","","9-3",TRUE,"Houston Oilers",34,10,23,343,199,144,3,11,182,102,80,2,1994-11-27,-1,1,"cle",24
"14","Sun","December 4","L","","9-4",TRUE,"New York Giants",13,16,13,306,229,77,5,18,298,202,96,1,1994-12-04,-4,0,"cle",-3
"15","Sat","December 10","W","","10-4",FALSE,"Dallas Cowboys",19,14,16,244,110,134,2,19,289,177,112,4,1994-12-10,2,1,"cle",5
"16","Sun","December 18","L","","10-5",FALSE,"Pittsburgh Steelers",7,17,21,331,245,86,3,18,276,153,123,0,1994-12-18,-3,0,"cle",-10
"17","Sat","December 24","W","","11-5",TRUE,"Seattle Seahawks",35,9,23,351,245,106,1,18,301,217,84,3,1994-12-24,2,1,"cle",26
"WildCard","Sun","January 1","W","","12-5",TRUE,"New England Patriots",20,13,22,379,254,125,1,20,303,246,57,3,1995-01-01,2,1,"cle",7
"Division","Sat","January 7","L","","12-6",FALSE,"Pittsburgh Steelers",9,29,10,186,131,55,2,23,424,186,238,1,1995-01-07,-1,0,"cle",-20
"1","Sun","September 3","L","","0-1",FALSE,"New England Patriots",14,17,13,301,241,60,1,27,427,302,125,0,1995-09-03,-1,0,"cle",-3
"2","Sun","September 10","W","","1-1",TRUE,"Tampa Bay Buccaneers",22,6,19,323,253,70,1,24,311,210,101,4,1995-09-10,3,1,"cle",16
"3","Sun","September 17","W","","2-1",FALSE,"Houston Oilers",14,7,14,270,138,132,0,20,327,256,71,4,1995-09-17,4,1,"cle",7
"4","Sun","September 24","W","","3-1",TRUE,"Kansas City Chiefs",35,17,23,345,221,124,1,14,322,263,59,2,1995-09-24,1,1,"cle",18
"5","Mon","October 2","L","","3-2",TRUE,"Buffalo Bills",19,22,16,294,204,90,1,23,406,246,160,2,1995-10-02,1,0,"cle",-3
"6","Sun","October 8","L","","3-3",FALSE,"Detroit Lions",20,38,15,255,196,59,1,22,429,268,161,1,1995-10-08,0,0,"cle",-18
"8","Sun","October 22","L","","3-4",TRUE,"Jacksonville Jaguars",15,23,20,387,298,89,4,23,315,156,159,2,1995-10-22,-2,0,"cle",-8
"9","Sun","October 29","W","OT","4-4",FALSE,"Cincinnati Bengals",29,26,26,480,301,179,2,27,384,292,92,4,1995-10-29,2,1,"cle",3
"10","Sun","November 5","L","","4-5",TRUE,"Houston Oilers",10,37,25,367,265,102,5,16,277,141,136,1,1995-11-05,-4,0,"cle",-27
"11","Mon","November 13","L","","4-6",FALSE,"Pittsburgh Steelers",3,20,7,120,43,77,1,22,310,157,153,0,1995-11-13,-1,0,"cle",-17
"12","Sun","November 19","L","","4-7",TRUE,"Green Bay Packers",20,31,18,317,240,77,1,20,285,203,82,1,1995-11-19,0,0,"cle",-11
"13","Sun","November 26","L","","4-8",TRUE,"Pittsburgh Steelers",17,20,19,253,178,75,3,19,318,258,60,0,1995-11-26,-3,0,"cle",-3
"14","Sun","December 3","L","","4-9",FALSE,"San Diego Chargers",13,31,19,313,287,26,2,25,416,230,186,0,1995-12-03,-2,0,"cle",-18
"15","Sat","December 9","L","","4-10",FALSE,"Minnesota Vikings",11,27,10,201,172,29,4,26,436,325,111,2,1995-12-09,-2,0,"cle",-16
"16","Sun","December 17","W","","5-10",TRUE,"Cincinnati Bengals",26,10,23,400,241,159,1,16,312,247,65,1,1995-12-17,0,1,"cle",16
"17","Sun","December 24","L","","5-11",FALSE,"Jacksonville Jaguars",21,24,26,450,316,134,3,18,373,268,105,0,1995-12-24,-3,0,"cle",-3
"1","Sun","September 12","L","","0-1",TRUE,"Pittsburgh Steelers",0,43,2,40,31,9,4,33,464,247,217,0,1999-09-12,-4,0,"cle",-43
"2","Sun","September 19","L","","0-2",FALSE,"Tennessee Titans",9,26,12,173,90,83,1,24,412,310,102,0,1999-09-19,-1,0,"cle",-17
"3","Sun","September 26","L","","0-3",FALSE,"Baltimore Ravens",10,17,11,189,89,100,3,16,334,150,184,3,1999-09-26,0,0,"cle",-7
"4","Sun","October 3","L","","0-4",TRUE,"New England Patriots",7,19,12,250,180,70,1,23,451,361,90,2,1999-10-03,1,0,"cle",-12
"5","Sun","October 10","L","","0-5",TRUE,"Cincinnati Bengals",17,18,13,224,144,80,1,25,419,204,215,1,1999-10-10,0,0,"cle",-1
"6","Sun","October 17","L","","0-6",FALSE,"Jacksonville Jaguars",7,24,16,243,130,113,1,21,325,222,103,0,1999-10-17,-1,0,"cle",-17
"7","Sun","October 24","L","","0-7",FALSE,"St. Louis Rams",3,34,13,272,178,94,3,27,436,225,211,0,1999-10-24,-3,0,"cle",-31
"8","Sun","October 31","W","","1-7",FALSE,"New Orleans Saints",21,16,9,243,181,62,1,25,351,120,231,5,1999-10-31,4,1,"cle",5
"9","Sun","November 7","L","","1-8",TRUE,"Baltimore Ravens",9,41,10,170,114,56,2,20,315,112,203,1,1999-11-07,-1,0,"cle",-32
"10","Sun","November 14","W","","2-8",FALSE,"Pittsburgh Steelers",16,15,14,235,161,74,2,17,298,130,168,2,1999-11-14,0,1,"cle",1
"11","Sun","November 21","L","","2-9",TRUE,"Carolina Panthers",17,31,22,306,257,49,2,22,330,201,129,1,1999-11-21,-1,0,"cle",-14
"12","Sun","November 28","L","","2-10",TRUE,"Tennessee Titans",21,33,18,309,228,81,2,22,337,179,158,1,1999-11-28,-1,0,"cle",-12
"13","Sun","December 5","L","","2-11",FALSE,"San Diego Chargers",10,23,13,202,147,55,2,20,277,132,145,1,1999-12-05,-1,0,"cle",-13
"14","Sun","December 12","L","","2-12",FALSE,"Cincinnati Bengals",28,44,19,323,312,11,4,25,459,180,279,1,1999-12-12,-3,0,"cle",-16
"15","Sun","December 19","L","","2-13",TRUE,"Jacksonville Jaguars",14,24,19,269,197,72,1,20,442,261,181,2,1999-12-19,1,0,"cle",-10
"16","Sun","December 26","L","","2-14",TRUE,"Indianapolis Colts",28,29,17,314,173,141,1,28,396,276,120,0,1999-12-26,-1,0,"cle",-1
"1","Sun","September 3","L","","0-1",TRUE,"Jacksonville Jaguars",7,27,9,249,153,96,1,28,398,279,119,0,2000-09-03,-1,0,"cle",-20
"2","Sun","September 10","W","","1-1",FALSE,"Cincinnati Bengals",24,7,17,354,249,105,1,17,318,207,111,3,2000-09-10,2,1,"cle",17
"3","Sun","September 17","W","","2-1",TRUE,"Pittsburgh Steelers",23,20,14,377,316,61,1,19,336,166,170,1,2000-09-17,0,1,"cle",3
"4","Sun","September 24","L","","2-2",FALSE,"Oakland Raiders",10,36,14,230,141,89,2,18,292,179,113,0,2000-09-24,-2,0,"cle",-26
"5","Sun","October 1","L","","2-3",TRUE,"Baltimore Ravens",0,12,11,230,207,23,4,22,348,160,188,1,2000-10-01,-3,0,"cle",-12
"6","Sun","October 8","L","","2-4",FALSE,"Arizona Cardinals",21,29,12,240,136,104,0,20,315,169,146,2,2000-10-08,2,0,"cle",-8
"7","Sun","October 15","L","","2-5",FALSE,"Denver Broncos",10,44,12,278,240,38,3,24,499,353,146,0,2000-10-15,-3,0,"cle",-34
"8","Sun","October 22","L","","2-6",FALSE,"Pittsburgh Steelers",0,22,5,104,55,49,3,17,248,105,143,0,2000-10-22,-3,0,"cle",-22
"9","Sun","October 29","L","","2-7",TRUE,"Cincinnati Bengals",3,12,10,182,128,54,1,18,253,61,192,1,2000-10-29,0,0,"cle",-9
"10","Sun","November 5","L","","2-8",TRUE,"New York Giants",3,24,11,193,152,41,1,24,370,221,149,1,2000-11-05,0,0,"cle",-21
"11","Sun","November 12","W","","3-8",TRUE,"New England Patriots",19,11,18,272,133,139,0,18,286,184,102,4,2000-11-12,4,1,"cle",8
"12","Sun","November 19","L","","3-9",FALSE,"Tennessee Titans",10,24,5,125,80,45,1,23,374,192,182,7,2000-11-19,6,0,"cle",-14
"13","Sun","November 26","L","","3-10",FALSE,"Baltimore Ravens",7,44,5,112,84,28,3,25,461,214,247,2,2000-11-26,-1,0,"cle",-37
"14","Sun","December 3","L","","3-11",FALSE,"Jacksonville Jaguars",0,48,2,53,-9,62,1,28,449,205,244,0,2000-12-03,-1,0,"cle",-48
"15","Sun","December 10","L","","3-12",TRUE,"Philadelphia Eagles",24,35,25,418,317,101,4,23,391,350,41,2,2000-12-10,-2,0,"cle",-11
"16","Sun","December 17","L","","3-13",TRUE,"Tennessee Titans",0,24,6,113,63,50,2,19,305,93,212,1,2000-12-17,-1,0,"cle",-24
"1","Sun","September 9","L","","0-1",TRUE,"Seattle Seahawks",6,9,13,239,149,90,1,16,251,150,101,2,2001-09-09,1,0,"cle",-3
"2","Sun","September 23","W","","1-1",TRUE,"Detroit Lions",24,14,17,257,118,139,2,18,271,189,82,7,2001-09-23,5,1,"cle",10
"3","Sun","September 30","W","","2-1",FALSE,"Jacksonville Jaguars",23,14,19,321,226,95,3,14,259,161,98,2,2001-09-30,-1,1,"cle",9
"4","Sun","October 7","W","","3-1",TRUE,"San Diego Chargers",20,16,16,278,181,97,1,15,269,143,126,0,2001-10-07,-1,1,"cle",4
"5","Sun","October 14","L","","3-2",FALSE,"Cincinnati Bengals",14,24,15,211,171,40,1,23,400,201,199,0,2001-10-14,-1,0,"cle",-10
"6","Sun","October 21","W","","4-2",TRUE,"Baltimore Ravens",24,14,10,219,131,88,0,21,321,208,113,3,2001-10-21,3,1,"cle",10
"8","Sun","November 4","L","OT","4-3",FALSE,"Chicago Bears",21,27,12,261,191,70,1,29,413,314,99,4,2001-11-04,3,0,"cle",-6
"9","Sun","November 11","L","OT","4-4",TRUE,"Pittsburgh Steelers",12,15,15,187,113,74,0,20,428,181,247,1,2001-11-11,1,0,"cle",-3
"10","Sun","November 18","W","","5-4",FALSE,"Baltimore Ravens",27,17,17,232,137,95,3,19,350,242,108,5,2001-11-18,2,1,"cle",10
"11","Sun","November 25","W","","6-4",TRUE,"Cincinnati Bengals",18,0,14,249,171,78,3,12,191,107,84,7,2001-11-25,4,1,"cle",18
"12","Sun","December 2","L","","6-5",TRUE,"Tennessee Titans",15,31,16,282,217,65,3,14,383,272,111,0,2001-12-02,-3,0,"cle",-16
"13","Sun","December 9","L","","6-6",FALSE,"New England Patriots",16,27,17,277,227,50,4,18,290,209,81,2,2001-12-09,-2,0,"cle",-11
"14","Sun","December 16","L","","6-7",TRUE,"Jacksonville Jaguars",10,15,11,220,173,47,2,19,282,154,128,3,2001-12-16,1,0,"cle",-5
"15","Sun","December 23","L","","6-8",FALSE,"Green Bay Packers",7,30,16,337,169,168,5,17,361,139,222,1,2001-12-23,-4,0,"cle",-23
"16","Sun","December 30","W","","7-8",FALSE,"Tennessee Titans",41,38,18,409,322,87,1,21,452,264,188,2,2001-12-30,1,1,"cle",3
"17","Sun","January 6","L","","7-9",FALSE,"Pittsburgh Steelers",7,28,12,173,105,68,3,19,376,155,221,3,2002-01-06,0,0,"cle",-21
"1","Sun","September 8","L","","0-1",TRUE,"Kansas City Chiefs",39,40,24,411,352,59,1,24,470,276,194,1,2002-09-08,0,0,"cle",-1
"2","Sun","September 15","W","","1-1",TRUE,"Cincinnati Bengals",20,7,15,265,190,75,0,28,357,201,156,3,2002-09-15,3,1,"cle",13
"3","Sun","September 22","W","OT","2-1",FALSE,"Tennessee Titans",31,28,26,403,311,92,4,13,187,101,86,0,2002-09-22,-4,1,"cle",3
"4","Sun","September 29","L","OT","2-2",FALSE,"Pittsburgh Steelers",13,16,13,245,122,123,2,21,358,265,93,2,2002-09-29,0,0,"cle",-3
"5","Sun","October 6","L","","2-3",TRUE,"Baltimore Ravens",21,26,21,433,371,62,5,18,409,208,201,1,2002-10-06,-4,0,"cle",-5
"6","Sun","October 13","L","","2-4",FALSE,"Tampa Bay Buccaneers",3,17,11,194,134,60,1,22,380,194,186,1,2002-10-13,0,0,"cle",-14
"7","Sun","October 20","W","","3-4",TRUE,"Houston Texans",34,17,14,230,141,89,0,17,354,265,89,2,2002-10-20,2,1,"cle",17
"8","Sun","October 27","W","","4-4",FALSE,"New York Jets",24,21,18,334,279,55,0,14,241,175,66,3,2002-10-27,3,1,"cle",3
"9","Sun","November 3","L","","4-5",TRUE,"Pittsburgh Steelers",20,23,9,193,157,36,3,25,391,255,136,1,2002-11-03,-2,0,"cle",-3
"11","Sun","November 17","W","","5-5",FALSE,"Cincinnati Bengals",27,20,22,382,242,140,1,14,350,248,102,1,2002-11-17,0,1,"cle",7
"12","Sun","November 24","W","","6-5",FALSE,"New Orleans Saints",24,15,17,339,176,163,2,19,383,309,74,6,2002-11-24,4,1,"cle",9
"13","Sun","December 1","L","","6-6",TRUE,"Carolina Panthers",6,13,14,258,118,140,5,11,234,89,145,2,2002-12-01,-3,0,"cle",-7
"14","Sun","December 8","W","","7-6",FALSE,"Jacksonville Jaguars",21,20,21,417,244,173,2,13,211,54,157,0,2002-12-08,-2,1,"cle",1
"15","Sun","December 15","L","","7-7",TRUE,"Indianapolis Colts",23,28,18,349,253,96,0,20,417,274,143,2,2002-12-15,2,0,"cle",-5
"16","Sun","December 22","W","","8-7",FALSE,"Baltimore Ravens",14,13,19,256,193,63,1,16,275,129,146,1,2002-12-22,0,1,"cle",1
"17","Sun","December 29","W","","9-7",TRUE,"Atlanta Falcons",24,16,17,318,129,189,4,16,331,226,105,3,2002-12-29,-1,1,"cle",8
"WildCard","Sun","January 5","L","","9-8",FALSE,"Pittsburgh Steelers",33,36,21,447,409,38,1,30,432,343,89,3,2003-01-05,2,0,"cle",-3
"1","Sun","September 7","L","","0-1",TRUE,"Indianapolis Colts",6,9,18,280,182,98,2,18,271,204,67,2,2003-09-07,0,0,"cle",-3
"2","Sun","September 14","L","","0-2",FALSE,"Baltimore Ravens",13,33,9,175,115,60,3,14,393,50,343,3,2003-09-14,0,0,"cle",-20
"3","Sun","September 21","W","","1-2",FALSE,"San Francisco 49ers",13,12,20,251,200,51,2,15,265,190,75,1,2003-09-21,-1,1,"cle",1
"4","Sun","September 28","L","","1-3",TRUE,"Cincinnati Bengals",14,21,18,339,270,69,1,17,295,215,80,0,2003-09-28,-1,0,"cle",-7
"5","Sun","October 5","W","","2-3",FALSE,"Pittsburgh Steelers",33,13,22,324,200,124,2,11,209,149,60,3,2003-10-05,1,1,"cle",20
"6","Sun","October 12","W","","3-3",TRUE,"Oakland Raiders",13,7,20,284,113,171,1,12,254,164,90,0,2003-10-12,-1,1,"cle",6
"7","Sun","October 19","L","","3-4",TRUE,"San Diego Chargers",20,26,20,277,176,101,2,15,289,61,228,2,2003-10-19,0,0,"cle",-6
"8","Sun","October 26","L","","3-5",FALSE,"New England Patriots",3,9,13,203,119,84,1,19,347,253,94,0,2003-10-26,-1,0,"cle",-6
"10","Sun","November 9","L","","3-6",FALSE,"Kansas City Chiefs",20,41,16,199,119,80,2,30,443,348,95,2,2003-11-09,0,0,"cle",-21
"11","Sun","November 16","W","","4-6",TRUE,"Arizona Cardinals",44,6,27,481,392,89,0,10,187,146,41,4,2003-11-16,4,1,"cle",38
"12","Sun","November 23","L","","4-7",TRUE,"Pittsburgh Steelers",6,13,19,303,213,90,5,11,168,59,109,0,2003-11-23,-5,0,"cle",-7
"13","Sun","November 30","L","","4-8",FALSE,"Seattle Seahawks",7,34,11,214,167,47,3,26,463,306,157,1,2003-11-30,-2,0,"cle",-27
"14","Mon","December 8","L","","4-9",TRUE,"St. Louis Rams",20,26,18,309,147,162,4,18,328,210,118,1,2003-12-08,-3,0,"cle",-6
"15","Sun","December 14","L","OT","4-10",FALSE,"Denver Broncos",20,23,12,275,173,102,1,28,417,252,165,1,2003-12-14,0,0,"cle",-3
"16","Sun","December 21","L","","4-11",TRUE,"Baltimore Ravens",0,35,14,211,133,78,4,18,359,83,276,1,2003-12-21,-3,0,"cle",-35
"17","Sun","December 28","W","","5-11",FALSE,"Cincinnati Bengals",22,14,19,379,115,264,0,21,271,156,115,1,2003-12-28,1,1,"cle",8
"1","Sun","September 12","W","","1-0",TRUE,"Baltimore Ravens",20,3,10,250,165,85,0,16,254,166,88,3,2004-09-12,3,1,"cle",17
"2","Sun","September 19","L","","1-1",FALSE,"Dallas Cowboys",12,19,12,202,66,136,3,20,441,315,126,4,2004-09-19,1,0,"cle",-7
"3","Sun","September 26","L","","1-2",FALSE,"New York Giants",10,27,18,285,161,124,3,25,390,274,116,0,2004-09-26,-3,0,"cle",-17
"4","Sun","October 3","W","","2-2",TRUE,"Washington Redskins",17,13,14,280,184,96,1,13,265,192,73,2,2004-10-03,1,1,"cle",4
"5","Sun","October 10","L","","2-3",FALSE,"Pittsburgh Steelers",23,34,17,305,207,98,1,21,401,231,170,1,2004-10-10,0,0,"cle",-11
"6","Sun","October 17","W","","3-3",TRUE,"Cincinnati Bengals",34,17,21,449,310,139,4,11,189,131,58,1,2004-10-17,-3,1,"cle",17
"7","Sun","October 24","L","OT","3-4",TRUE,"Philadelphia Eagles",31,34,27,394,229,165,3,23,488,367,121,1,2004-10-24,-2,0,"cle",-3
"9","Sun","November 7","L","","3-5",FALSE,"Baltimore Ravens",13,27,13,217,126,91,2,15,240,134,106,1,2004-11-07,-1,0,"cle",-14
"10","Sun","November 14","L","","3-6",TRUE,"Pittsburgh Steelers",10,24,12,228,160,68,4,18,300,120,180,1,2004-11-14,-3,0,"cle",-14
"11","Sun","November 21","L","","3-7",TRUE,"New York Jets",7,10,13,216,117,99,1,17,235,78,157,1,2004-11-21,0,0,"cle",-3
"12","Sun","November 28","L","","3-8",FALSE,"Cincinnati Bengals",48,58,23,462,386,76,2,26,504,251,253,3,2004-11-28,1,0,"cle",-10
"13","Sun","December 5","L","","3-9",TRUE,"New England Patriots",15,42,16,287,241,46,4,27,412,187,225,3,2004-12-05,-1,0,"cle",-27
"14","Sun","December 12","L","","3-10",FALSE,"Buffalo Bills",7,37,6,26,-3,29,5,22,321,106,215,3,2004-12-12,-2,0,"cle",-30
"15","Sun","December 19","L","","3-11",TRUE,"San Diego Chargers",0,21,11,231,105,126,1,16,257,83,174,1,2004-12-19,0,0,"cle",-21
"16","Sun","December 26","L","","3-12",FALSE,"Miami Dolphins",7,10,14,285,143,142,4,19,280,164,116,2,2004-12-26,-2,0,"cle",-3
"17","Sun","January 2","W","","4-12",FALSE,"Houston Texans",22,14,18,364,227,137,2,18,238,102,136,1,2005-01-02,-1,1,"cle",8
"1","Sun","September 11","L","","0-1",TRUE,"Cincinnati Bengals",13,27,16,373,278,95,3,26,420,272,148,2,2005-09-11,-1,0,"cle",-14
"2","Sun","September 18","W","","1-1",FALSE,"Green Bay Packers",26,24,19,391,336,55,0,27,452,336,116,2,2005-09-18,2,1,"cle",2
"3","Sun","September 25","L","","1-2",FALSE,"Indianapolis Colts",6,13,14,263,188,75,0,20,339,228,111,1,2005-09-25,1,0,"cle",-7
"5","Sun","October 9","W","","2-2",TRUE,"Chicago Bears",20,10,15,278,202,76,2,16,266,90,176,3,2005-10-09,1,1,"cle",10
"6","Sun","October 16","L","","2-3",FALSE,"Baltimore Ravens",3,16,12,186,116,70,3,16,351,201,150,1,2005-10-16,-2,0,"cle",-13
"7","Sun","October 23","L","","2-4",TRUE,"Detroit Lions",10,13,11,174,56,118,3,19,329,210,119,1,2005-10-23,-2,0,"cle",-3
"8","Sun","October 30","L","","2-5",FALSE,"Houston Texans",16,19,16,325,169,156,2,11,237,120,117,1,2005-10-30,-1,0,"cle",-3
"9","Sun","November 6","W","","3-5",TRUE,"Tennessee Titans",20,14,16,441,272,169,2,19,323,225,98,1,2005-11-06,-1,1,"cle",6
"10","Sun","November 13","L","","3-6",FALSE,"Pittsburgh Steelers",21,34,16,303,242,61,2,25,382,223,159,0,2005-11-13,-2,0,"cle",-13
"11","Sun","November 20","W","","4-6",TRUE,"Miami Dolphins",22,0,19,376,195,181,1,12,194,55,139,2,2005-11-20,1,1,"cle",22
"12","Sun","November 27","L","","4-7",FALSE,"Minnesota Vikings",12,24,20,262,184,78,5,18,281,200,81,2,2005-11-27,-3,0,"cle",-12
"13","Sun","December 4","L","","4-8",TRUE,"Jacksonville Jaguars",14,20,15,303,205,98,0,17,237,115,122,1,2005-12-04,1,0,"cle",-6
"14","Sun","December 11","L","","4-9",FALSE,"Cincinnati Bengals",20,23,15,208,124,84,1,18,278,93,185,1,2005-12-11,0,0,"cle",-3
"15","Sun","December 18","W","","5-9",FALSE,"Oakland Raiders",9,7,13,255,185,70,2,16,256,113,143,1,2005-12-18,-1,1,"cle",2
"16","Sat","December 24","L","","5-10",TRUE,"Pittsburgh Steelers",0,41,12,186,123,63,1,20,457,248,209,1,2005-12-24,0,0,"cle",-41
"17","Sun","January 1","W","","6-10",TRUE,"Baltimore Ravens",20,16,12,226,172,54,3,12,267,138,129,3,2006-01-01,0,1,"cle",4
"1","Sun","September 10","L","","0-1",TRUE,"New Orleans Saints",14,19,15,186,101,85,3,17,326,170,156,2,2006-09-10,-1,0,"cle",-5
"2","Sun","September 17","L","","0-2",FALSE,"Cincinnati Bengals",17,34,17,301,244,57,3,27,481,321,160,2,2006-09-17,-1,0,"cle",-17
"3","Sun","September 24","L","","0-3",TRUE,"Baltimore Ravens",14,15,17,288,250,38,2,18,340,254,86,0,2006-09-24,-2,0,"cle",-1
"4","Sun","October 1","W","","1-3",FALSE,"Oakland Raiders",24,21,21,283,179,104,3,14,240,46,194,1,2006-10-01,-2,1,"cle",3
"5","Sun","October 8","L","","1-4",FALSE,"Carolina Panthers",12,20,17,248,157,91,3,15,288,169,119,0,2006-10-08,-3,0,"cle",-8
"7","Sun","October 22","L","","1-5",TRUE,"Denver Broncos",7,17,10,165,131,34,3,22,347,197,150,2,2006-10-22,-1,0,"cle",-10
"8","Sun","October 29","W","","2-5",TRUE,"New York Jets",20,13,16,267,120,147,1,12,193,105,88,3,2006-10-29,2,1,"cle",7
"9","Sun","November 5","L","","2-6",FALSE,"San Diego Chargers",25,32,23,293,209,84,2,19,381,191,190,1,2006-11-05,-1,0,"cle",-7
"10","Sun","November 12","W","","3-6",FALSE,"Atlanta Falcons",17,13,9,236,145,91,2,16,343,194,149,3,2006-11-12,1,1,"cle",4
"11","Sun","November 19","L","","3-7",TRUE,"Pittsburgh Steelers",20,24,15,302,203,99,2,23,338,261,77,3,2006-11-19,1,0,"cle",-4
"12","Sun","November 26","L","","3-8",TRUE,"Cincinnati Bengals",0,30,9,203,152,51,5,24,388,300,88,1,2006-11-26,-4,0,"cle",-30
"13","Sun","December 3","W","OT","4-8",TRUE,"Kansas City Chiefs",31,28,26,438,288,150,2,24,417,293,124,2,2006-12-03,0,1,"cle",3
"14","Thu","December 7","L","","4-9",FALSE,"Pittsburgh Steelers",7,27,11,294,276,18,2,26,528,225,303,1,2006-12-07,-1,0,"cle",-20
"15","Sun","December 17","L","","4-10",FALSE,"Baltimore Ravens",17,27,13,236,168,68,2,14,373,231,142,3,2006-12-17,1,0,"cle",-10
"16","Sun","December 24","L","","4-11",TRUE,"Tampa Bay Buccaneers",7,22,12,187,96,91,4,21,355,202,153,2,2006-12-24,-2,0,"cle",-15
"17","Sun","December 31","L","","4-12",FALSE,"Houston Texans",6,14,19,306,179,127,3,11,177,83,94,1,2006-12-31,-2,0,"cle",-8
"1","Sun","September 9","L","","0-1",TRUE,"Pittsburgh Steelers",7,34,13,221,175,46,5,17,365,159,206,1,2007-09-09,-4,0,"cle",-27
"2","Sun","September 16","W","","1-1",TRUE,"Cincinnati Bengals",51,45,23,554,328,226,1,33,531,394,137,3,2007-09-16,2,1,"cle",6
"3","Sun","September 23","L","","1-2",FALSE,"Oakland Raiders",24,26,17,312,224,88,2,19,396,210,186,2,2007-09-23,0,0,"cle",-2
"4","Sun","September 30","W","","2-2",TRUE,"Baltimore Ravens",27,13,12,303,204,99,1,26,418,307,111,2,2007-09-30,1,1,"cle",14
"5","Sun","October 7","L","","2-3",FALSE,"New England Patriots",17,34,22,353,261,92,4,23,412,265,147,0,2007-10-07,-4,0,"cle",-17
"6","Sun","October 14","W","","3-3",TRUE,"Miami Dolphins",41,31,24,384,244,140,1,24,356,246,110,2,2007-10-14,1,1,"cle",10
"8","Sun","October 28","W","","4-3",FALSE,"St. Louis Rams",27,20,20,368,236,132,0,24,393,314,79,1,2007-10-28,1,1,"cle",7
"9","Sun","November 4","W","OT","5-3",TRUE,"Seattle Seahawks",33,30,30,428,364,64,1,28,423,318,105,2,2007-11-04,1,1,"cle",3
"10","Sun","November 11","L","","5-4",FALSE,"Pittsburgh Steelers",28,31,13,163,123,40,1,22,401,242,159,1,2007-11-11,0,0,"cle",-3
"11","Sun","November 18","W","OT","6-4",FALSE,"Baltimore Ravens",33,30,22,380,269,111,2,23,368,240,128,4,2007-11-18,2,1,"cle",3
"12","Sun","November 25","W","","7-4",TRUE,"Houston Texans",27,17,21,397,249,148,1,17,314,237,77,3,2007-11-25,2,1,"cle",10
"13","Sun","December 2","L","","7-5",FALSE,"Arizona Cardinals",21,27,21,379,295,84,4,18,302,169,133,1,2007-12-02,-3,0,"cle",-6
"14","Sun","December 9","W","","8-5",FALSE,"New York Jets",24,18,18,337,185,152,1,26,387,268,119,2,2007-12-09,1,1,"cle",6
"15","Sun","December 16","W","","9-5",TRUE,"Buffalo Bills",8,0,16,304,130,174,0,11,232,124,108,0,2007-12-16,0,1,"cle",8
"16","Sun","December 23","L","","9-6",FALSE,"Cincinnati Bengals",14,19,25,380,244,136,4,15,270,115,155,3,2007-12-23,-1,0,"cle",-5
"17","Sun","December 30","W","","10-6",TRUE,"San Francisco 49ers",20,7,18,358,195,163,1,9,185,73,112,0,2007-12-30,-1,1,"cle",13
"1","Sun","September 7","L","","0-1",TRUE,"Dallas Cowboys",10,28,11,205,114,91,0,30,487,320,167,1,2008-09-07,1,0,"cle",-18
"2","Sun","September 14","L","","0-2",TRUE,"Pittsburgh Steelers",6,10,17,208,155,53,2,14,281,164,117,0,2008-09-14,-2,0,"cle",-4
"3","Sun","September 21","L","","0-3",FALSE,"Baltimore Ravens",10,28,11,169,99,70,3,21,273,122,151,2,2008-09-21,-1,0,"cle",-18
"4","Sun","September 28","W","","1-3",FALSE,"Cincinnati Bengals",20,12,19,261,127,134,2,14,211,142,69,5,2008-09-28,3,1,"cle",8
"6","Mon","October 13","W","","2-3",TRUE,"New York Giants",35,14,20,454,310,144,0,23,373,192,181,3,2008-10-13,3,1,"cle",21
"7","Sun","October 19","L","","2-4",FALSE,"Washington Redskins",11,14,16,236,134,102,0,17,351,158,193,1,2008-10-19,1,0,"cle",-3
"8","Sun","October 26","W","","3-4",FALSE,"Jacksonville Jaguars",23,17,15,327,236,91,0,23,380,267,113,1,2008-10-26,1,1,"cle",6
"9","Sun","November 2","L","","3-5",TRUE,"Baltimore Ravens",27,37,14,274,210,64,2,21,429,236,193,0,2008-11-02,-2,0,"cle",-10
"10","Thu","November 6","L","","3-6",TRUE,"Denver Broncos",30,34,20,399,239,160,1,26,564,441,123,1,2008-11-06,0,0,"cle",-4
"11","Mon","November 17","W","","4-6",FALSE,"Buffalo Bills",29,27,18,337,176,161,0,19,334,148,186,4,2008-11-17,4,1,"cle",2
"12","Sun","November 23","L","","4-7",TRUE,"Houston Texans",6,16,15,240,145,95,5,19,383,271,112,2,2008-11-23,-3,0,"cle",-10
"13","Sun","November 30","L","","4-8",TRUE,"Indianapolis Colts",6,10,13,193,92,101,2,14,215,125,90,3,2008-11-30,1,0,"cle",-4
"14","Sun","December 7","L","","4-9",FALSE,"Tennessee Titans",9,28,12,178,143,35,1,21,390,155,235,3,2008-12-07,2,0,"cle",-19
"15","Mon","December 15","L","","4-10",FALSE,"Philadelphia Eagles",10,30,11,196,139,57,2,21,418,284,134,3,2008-12-15,1,0,"cle",-20
"16","Sun","December 21","L","","4-11",TRUE,"Cincinnati Bengals",0,14,13,182,41,141,4,12,246,55,191,1,2008-12-21,-3,0,"cle",-14
"17","Sun","December 28","L","","4-12",FALSE,"Pittsburgh Steelers",0,31,8,126,20,106,2,20,369,193,176,1,2008-12-28,-1,0,"cle",-31
"1","Sun","September 13","L","","0-1",TRUE,"Minnesota Vikings",20,34,17,268,179,89,2,19,310,85,225,0,2009-09-13,-2,0,"cle",-14
"2","Sun","September 20","L","","0-2",FALSE,"Denver Broncos",6,27,11,200,146,54,3,25,449,263,186,1,2009-09-20,-2,0,"cle",-21
"3","Sun","September 27","L","","0-3",FALSE,"Baltimore Ravens",3,34,11,186,115,71,4,28,479,337,142,1,2009-09-27,-3,0,"cle",-31
"4","Sun","October 4","L","OT","0-4",TRUE,"Cincinnati Bengals",20,23,22,395,249,146,2,21,375,221,154,2,2009-10-04,0,0,"cle",-3
"5","Sun","October 11","W","","1-4",FALSE,"Buffalo Bills",6,3,9,193,22,171,1,13,288,143,145,3,2009-10-11,2,1,"cle",3
"6","Sun","October 18","L","","1-5",FALSE,"Pittsburgh Steelers",14,27,12,197,106,91,4,28,543,403,140,4,2009-10-18,0,0,"cle",-13
"7","Sun","October 25","L","","1-6",TRUE,"Green Bay Packers",3,31,12,139,81,58,2,25,460,258,202,0,2009-10-25,-2,0,"cle",-28
"8","Sun","November 1","L","","1-7",FALSE,"Chicago Bears",6,30,9,191,74,117,5,20,369,199,170,1,2009-11-01,-4,0,"cle",-24
"10","Mon","November 16","L","","1-8",TRUE,"Baltimore Ravens",0,16,11,160,74,86,2,14,274,146,128,0,2009-11-16,-2,0,"cle",-16
"11","Sun","November 22","L","","1-9",FALSE,"Detroit Lions",37,38,22,439,308,131,0,26,473,416,57,2,2009-11-22,2,0,"cle",-1
"12","Sun","November 29","L","","1-10",FALSE,"Cincinnati Bengals",7,16,11,169,111,58,0,21,306,96,210,0,2009-11-29,0,0,"cle",-9
"13","Sun","December 6","L","","1-11",TRUE,"San Diego Chargers",23,30,24,372,257,115,1,21,477,386,91,0,2009-12-06,-1,0,"cle",-7
"14","Thu","December 10","W","","2-11",TRUE,"Pittsburgh Steelers",13,6,12,255,84,171,0,16,218,141,77,0,2009-12-10,0,1,"cle",7
"15","Sun","December 20","W","","3-11",FALSE,"Kansas City Chiefs",41,34,20,417,66,351,3,22,491,323,168,1,2009-12-20,-2,1,"cle",7
"16","Sun","December 27","W","","4-11",TRUE,"Oakland Raiders",23,9,16,282,118,164,1,19,389,301,88,3,2009-12-27,2,1,"cle",14
"17","Sun","January 3","W","","5-11",TRUE,"Jacksonville Jaguars",23,17,18,300,86,214,1,18,328,197,131,1,2010-01-03,0,1,"cle",6
"1","Sun","September 12","L","","0-1",FALSE,"Tampa Bay Buccaneers",14,17,15,340,236,104,3,13,288,169,119,2,2010-09-12,-1,0,"cle",-3
"2","Sun","September 19","L","","0-2",TRUE,"Kansas City Chiefs",14,16,13,299,226,73,2,16,312,172,140,2,2010-09-19,0,0,"cle",-2
"3","Sun","September 26","L","","0-3",FALSE,"Baltimore Ravens",17,24,18,304,131,173,0,19,365,256,109,0,2010-09-26,0,0,"cle",-7
"4","Sun","October 3","W","","1-3",TRUE,"Cincinnati Bengals",23,20,21,295,179,116,1,21,413,346,67,2,2010-10-03,1,1,"cle",3
"5","Sun","October 10","L","","1-4",TRUE,"Atlanta Falcons",10,20,18,269,221,48,3,17,338,173,165,1,2010-10-10,-2,0,"cle",-10
"6","Sun","October 17","L","","1-5",FALSE,"Pittsburgh Steelers",10,28,17,327,258,69,3,22,378,257,121,1,2010-10-17,-2,0,"cle",-18
"7","Sun","October 24","W","","2-5",FALSE,"New Orleans Saints",30,17,12,210,85,125,0,25,394,336,58,4,2010-10-24,4,1,"cle",13
"9","Sun","November 7","W","","3-5",TRUE,"New England Patriots",34,14,22,404,174,230,1,19,283,215,68,3,2010-11-07,2,1,"cle",20
"10","Sun","November 14","L","OT","3-6",TRUE,"New York Jets",20,26,19,303,196,107,2,28,456,284,172,1,2010-11-14,-1,0,"cle",-6
"11","Sun","November 21","L","","3-7",FALSE,"Jacksonville Jaguars",20,24,15,283,195,88,1,24,371,226,145,6,2010-11-21,5,0,"cle",-4
"12","Sun","November 28","W","","4-7",TRUE,"Carolina Panthers",24,23,26,379,227,152,3,16,326,175,151,1,2010-11-28,-2,1,"cle",1
"13","Sun","December 5","W","","5-7",FALSE,"Miami Dolphins",13,10,12,252,200,52,0,17,281,167,114,3,2010-12-05,3,1,"cle",3
"14","Sun","December 12","L","","5-8",FALSE,"Buffalo Bills",6,13,9,187,82,105,3,19,323,131,192,1,2010-12-12,-2,0,"cle",-7
"15","Sun","December 19","L","","5-9",FALSE,"Cincinnati Bengals",17,19,14,278,219,59,0,22,397,209,188,0,2010-12-19,0,0,"cle",-2
"16","Sun","December 26","L","","5-10",TRUE,"Baltimore Ravens",10,20,17,280,178,102,4,15,258,97,161,1,2010-12-26,-3,0,"cle",-10
"17","Sun","January 2","L","","5-11",TRUE,"Pittsburgh Steelers",9,41,17,225,182,43,3,24,418,318,100,0,2011-01-02,-3,0,"cle",-32
"1","Sun","September 11","L","","0-1",TRUE,"Cincinnati Bengals",17,27,17,285,202,83,1,17,294,155,139,0,2011-09-11,-1,0,"cle",-10
"2","Sun","September 18","W","","1-1",FALSE,"Indianapolis Colts",27,19,18,303,197,106,1,19,285,176,109,2,2011-09-18,1,1,"cle",8
"3","Sun","September 25","W","","2-1",TRUE,"Miami Dolphins",17,16,19,280,210,70,1,22,369,231,138,2,2011-09-25,1,1,"cle",1
"4","Sun","October 2","L","","2-2",TRUE,"Tennessee Titans",13,31,25,416,332,84,1,13,332,220,112,1,2011-10-02,0,0,"cle",-18
"6","Sun","October 16","L","","2-3",FALSE,"Oakland Raiders",17,24,18,268,203,65,1,18,329,178,151,1,2011-10-16,0,0,"cle",-7
"7","Sun","October 23","W","","3-3",TRUE,"Seattle Seahawks",6,3,20,300,159,141,1,9,137,69,68,2,2011-10-23,1,1,"cle",3
"8","Sun","October 30","L","","3-4",FALSE,"San Francisco 49ers",10,20,18,290,224,66,2,19,348,174,174,0,2011-10-30,-2,0,"cle",-10
"9","Sun","November 6","L","","3-5",FALSE,"Houston Texans",12,30,10,172,128,44,2,21,380,119,261,1,2011-11-06,-1,0,"cle",-18
"10","Sun","November 13","L","","3-6",TRUE,"St. Louis Rams",12,13,16,335,209,126,1,17,281,148,133,2,2011-11-13,1,0,"cle",-1
"11","Sun","November 20","W","","4-6",TRUE,"Jacksonville Jaguars",14,10,20,334,186,148,1,23,303,195,108,0,2011-11-20,-1,1,"cle",4
"12","Sun","November 27","L","","4-7",FALSE,"Cincinnati Bengals",20,23,17,274,140,134,1,18,389,257,132,1,2011-11-27,0,0,"cle",-3
"13","Sun","December 4","L","","4-8",TRUE,"Baltimore Ravens",10,24,13,233,174,59,1,24,448,158,290,1,2011-12-04,0,0,"cle",-14
"14","Thu","December 8","L","","4-9",FALSE,"Pittsburgh Steelers",3,14,19,304,206,98,2,20,416,269,147,3,2011-12-08,1,0,"cle",-11
"15","Sun","December 18","L","OT","4-10",FALSE,"Arizona Cardinals",17,20,16,333,213,120,1,24,363,289,74,1,2011-12-18,0,0,"cle",-3
"16","Sat","December 24","L","","4-11",FALSE,"Baltimore Ravens",14,20,18,256,139,117,1,15,284,122,162,1,2011-12-24,0,0,"cle",-6
"17","Sun","January 1","L","","4-12",TRUE,"Pittsburgh Steelers",9,13,14,240,168,72,1,22,360,199,161,2,2012-01-01,1,0,"cle",-4
"1","Sun","September 8","W","","1-0",TRUE,"Dallas Cowboys",19,10,13,210,123,87,1,11,267,112,155,2,2002-09-08,1,1,"htx",9
"2","Sun","September 15","L","","1-1",FALSE,"San Diego Chargers",3,24,7,118,29,89,3,16,267,143,124,1,2002-09-15,-2,0,"htx",-21
"3","Sun","September 22","L","","1-2",TRUE,"Indianapolis Colts",3,23,10,204,78,126,2,16,339,251,88,2,2002-09-22,0,0,"htx",-20
"4","Sun","September 29","L","","1-3",FALSE,"Philadelphia Eagles",17,35,12,242,151,91,3,21,391,289,102,3,2002-09-29,0,0,"htx",-18
"6","Sun","October 13","L","","1-4",TRUE,"Buffalo Bills",24,31,18,338,197,141,0,25,403,230,173,1,2002-10-13,1,0,"htx",-7
"7","Sun","October 20","L","","1-5",FALSE,"Cleveland Browns",17,34,17,354,265,89,2,14,230,141,89,0,2002-10-20,-2,0,"htx",-17
"8","Sun","October 27","W","","2-5",FALSE,"Jacksonville Jaguars",21,19,12,242,161,81,1,18,290,164,126,0,2002-10-27,-1,1,"htx",2
"9","Sun","November 3","L","","2-6",TRUE,"Cincinnati Bengals",3,38,22,268,186,82,2,25,390,263,127,0,2002-11-03,-2,0,"htx",-35
"10","Sun","November 10","L","","2-7",FALSE,"Tennessee Titans",10,17,13,233,165,68,3,15,251,109,142,2,2002-11-10,-1,0,"htx",-7
"11","Sun","November 17","L","","2-8",TRUE,"Jacksonville Jaguars",21,24,18,272,194,78,2,16,321,199,122,1,2002-11-17,-1,0,"htx",-3
"12","Sun","November 24","W","","3-8",TRUE,"New York Giants",16,14,12,212,89,123,1,19,369,201,168,3,2002-11-24,2,1,"htx",2
"13","Sun","December 1","L","","3-9",FALSE,"Indianapolis Colts",3,19,10,165,100,65,2,13,278,190,88,1,2002-12-01,-1,0,"htx",-16
"14","Sun","December 8","W","","4-9",FALSE,"Pittsburgh Steelers",24,6,3,47,10,37,1,24,422,294,128,5,2002-12-08,4,1,"htx",18
"15","Sun","December 15","L","","4-10",TRUE,"Baltimore Ravens",19,23,15,277,182,95,2,16,298,228,70,0,2002-12-15,-2,0,"htx",-4
"16","Sun","December 22","L","","4-11",FALSE,"Washington Redskins",10,26,10,166,99,67,3,27,437,190,247,0,2002-12-22,-3,0,"htx",-16
"17","Sun","December 29","L","","4-12",TRUE,"Tennessee Titans",3,13,16,224,196,28,1,15,277,137,140,0,2002-12-29,-1,0,"htx",-10
"1","Sun","September 7","W","","1-0",FALSE,"Miami Dolphins",21,20,16,393,266,127,0,14,301,215,86,3,2003-09-07,3,1,"htx",1
"2","Sun","September 14","L","","1-1",FALSE,"New Orleans Saints",10,31,16,258,183,75,2,12,292,182,110,0,2003-09-14,-2,0,"htx",-21
"3","Sun","September 21","L","","1-2",TRUE,"Kansas City Chiefs",14,42,20,316,209,107,4,27,426,258,168,2,2003-09-21,-2,0,"htx",-28
"4","Sun","September 28","W","","2-2",TRUE,"Jacksonville Jaguars",24,20,21,339,229,110,4,15,342,263,79,5,2003-09-28,1,1,"htx",4
"6","Sun","October 12","L","","2-3",FALSE,"Tennessee Titans",17,38,24,458,367,91,3,22,535,421,114,1,2003-10-12,-2,0,"htx",-21
"7","Sun","October 19","L","","2-4",TRUE,"New York Jets",14,19,17,325,156,169,0,18,300,160,140,0,2003-10-19,0,0,"htx",-5
"8","Sun","October 26","L","","2-5",FALSE,"Indianapolis Colts",21,30,18,270,139,131,2,23,391,269,122,1,2003-10-26,-1,0,"htx",-9
"9","Sun","November 2","W","","3-5",TRUE,"Carolina Panthers",14,10,14,267,149,118,0,21,367,193,174,1,2003-11-02,1,1,"htx",4
"10","Sun","November 9","L","","3-6",FALSE,"Cincinnati Bengals",27,34,13,269,129,140,1,27,422,182,240,1,2003-11-09,0,0,"htx",-7
"11","Sun","November 16","W","","4-6",FALSE,"Buffalo Bills",12,10,12,245,211,34,1,17,335,153,182,1,2003-11-16,0,1,"htx",2
"12","Sun","November 23","L","OT","4-7",TRUE,"New England Patriots",20,23,11,169,80,89,2,29,472,344,128,3,2003-11-23,1,0,"htx",-3
"13","Sun","November 30","W","","5-7",TRUE,"Atlanta Falcons",17,13,17,236,101,135,1,16,243,174,69,1,2003-11-30,0,1,"htx",4
"14","Sun","December 7","L","","5-8",FALSE,"Jacksonville Jaguars",0,27,7,124,54,70,3,23,390,182,208,0,2003-12-07,-3,0,"htx",-27
"15","Sun","December 14","L","","5-9",FALSE,"Tampa Bay Buccaneers",3,16,7,107,42,65,0,24,398,237,161,0,2003-12-14,0,0,"htx",-13
"16","Sun","December 21","L","","5-10",TRUE,"Tennessee Titans",24,27,14,326,235,91,3,21,450,268,182,1,2003-12-21,-2,0,"htx",-3
"17","Sun","December 28","L","","5-11",TRUE,"Indianapolis Colts",17,20,10,204,105,99,1,27,418,211,207,2,2003-12-28,1,0,"htx",-3
"1","Sun","September 12","L","","0-1",TRUE,"San Diego Chargers",20,27,20,336,226,110,4,17,324,202,122,0,2004-09-12,-4,0,"htx",-7
"2","Sun","September 19","L","","0-2",FALSE,"Detroit Lions",16,28,24,386,274,112,3,18,266,172,94,1,2004-09-19,-2,0,"htx",-12
"3","Sun","September 26","W","","1-2",FALSE,"Kansas City Chiefs",24,21,18,296,220,76,1,25,366,198,168,1,2004-09-26,0,1,"htx",3
"4","Sun","October 3","W","","2-2",TRUE,"Oakland Raiders",30,17,20,386,228,158,1,18,375,224,151,5,2004-10-03,4,1,"htx",13
"5","Sun","October 10","L","OT","2-3",TRUE,"Minnesota Vikings",28,34,19,410,358,52,0,27,510,388,122,0,2004-10-10,0,0,"htx",-6
"6","Sun","October 17","W","","3-3",FALSE,"Tennessee Titans",20,10,19,345,247,98,2,19,305,204,101,4,2004-10-17,2,1,"htx",10
"8","Sun","October 31","W","","4-3",TRUE,"Jacksonville Jaguars",20,6,24,369,276,93,2,14,287,248,39,2,2004-10-31,0,1,"htx",14
"9","Sun","November 7","L","","4-4",FALSE,"Denver Broncos",13,31,22,331,228,103,0,21,364,225,139,0,2004-11-07,0,0,"htx",-18
"10","Sun","November 14","L","","4-5",FALSE,"Indianapolis Colts",14,49,20,302,170,132,4,17,398,312,86,2,2004-11-14,-2,0,"htx",-35
"11","Sun","November 21","L","","4-6",TRUE,"Green Bay Packers",13,16,13,251,144,107,0,22,473,383,90,2,2004-11-21,2,0,"htx",-3
"12","Sun","November 28","W","","5-6",TRUE,"Tennessee Titans",31,21,19,328,179,149,1,23,355,221,134,3,2004-11-28,2,1,"htx",10
"13","Sun","December 5","L","","5-7",FALSE,"New York Jets",7,29,13,230,147,83,2,26,360,150,210,1,2004-12-05,-1,0,"htx",-22
"14","Sun","December 12","L","","5-8",TRUE,"Indianapolis Colts",14,23,17,273,125,148,2,22,382,281,101,0,2004-12-12,-2,0,"htx",-9
"15","Sun","December 19","W","","6-8",FALSE,"Chicago Bears",24,5,15,314,208,106,0,11,203,149,54,4,2004-12-19,4,1,"htx",19
"16","Sun","December 26","W","","7-8",FALSE,"Jacksonville Jaguars",21,0,19,333,114,219,2,6,126,31,95,3,2004-12-26,1,1,"htx",21
"17","Sun","January 2","L","","7-9",TRUE,"Cleveland Browns",14,22,18,238,102,136,1,18,364,227,137,2,2005-01-02,1,0,"htx",-8
"1","Sun","September 11","L","","0-1",FALSE,"Buffalo Bills",7,22,12,120,25,95,5,20,316,164,152,0,2005-09-11,-5,0,"htx",-15
"2","Sun","September 18","L","","0-2",TRUE,"Pittsburgh Steelers",7,27,16,221,108,113,1,18,388,253,135,0,2005-09-18,-1,0,"htx",-20
"4","Sun","October 2","L","","0-3",FALSE,"Cincinnati Bengals",10,16,18,254,128,126,1,22,371,273,98,0,2005-10-02,-1,0,"htx",-6
"5","Sun","October 9","L","","0-4",TRUE,"Tennessee Titans",20,34,14,257,96,161,1,22,310,220,90,0,2005-10-09,-1,0,"htx",-14
"6","Sun","October 16","L","","0-5",FALSE,"Seattle Seahawks",10,42,14,227,160,67,0,31,459,139,320,1,2005-10-16,1,0,"htx",-32
"7","Sun","October 23","L","","0-6",TRUE,"Indianapolis Colts",20,38,13,139,6,133,2,30,437,232,205,2,2005-10-23,0,0,"htx",-18
"8","Sun","October 30","W","","1-6",TRUE,"Cleveland Browns",19,16,11,237,120,117,1,16,325,169,156,2,2005-10-30,1,1,"htx",3
"9","Sun","November 6","L","","1-7",FALSE,"Jacksonville Jaguars",14,21,17,279,191,88,1,18,312,214,98,0,2005-11-06,-1,0,"htx",-7
"10","Sun","November 13","L","","1-8",FALSE,"Indianapolis Colts",17,31,11,209,126,83,0,26,419,293,126,2,2005-11-13,2,0,"htx",-14
"11","Sun","November 20","L","","1-9",TRUE,"Kansas City Chiefs",17,45,14,259,181,78,3,28,446,220,226,1,2005-11-20,-2,0,"htx",-28
"12","Sun","November 27","L","OT","1-10",TRUE,"St. Louis Rams",27,33,26,412,288,124,2,22,429,291,138,1,2005-11-27,-1,0,"htx",-6
"13","Sun","December 4","L","","1-11",FALSE,"Baltimore Ravens",15,16,16,298,133,165,2,15,238,165,73,2,2005-12-04,0,0,"htx",-1
"14","Sun","December 11","L","","1-12",FALSE,"Tennessee Titans",10,13,12,234,82,152,0,15,301,208,93,0,2005-12-11,0,0,"htx",-3
"15","Sun","December 18","W","","2-12",TRUE,"Arizona Cardinals",30,19,18,253,134,119,2,16,301,262,39,4,2005-12-18,2,1,"htx",11
"16","Sat","December 24","L","","2-13",TRUE,"Jacksonville Jaguars",20,38,18,370,263,107,1,30,448,276,172,0,2005-12-24,-1,0,"htx",-18
"17","Sun","January 1","L","OT","2-14",FALSE,"San Francisco 49ers",17,20,13,284,196,88,2,19,324,142,182,1,2006-01-01,-1,0,"htx",-3
"1","Sun","September 10","L","","0-1",TRUE,"Philadelphia Eagles",10,24,19,241,171,70,0,24,441,311,130,1,2006-09-10,1,0,"htx",-14
"2","Sun","September 17","L","","0-2",FALSE,"Indianapolis Colts",24,43,18,299,191,108,2,34,515,390,125,1,2006-09-17,-1,0,"htx",-19
"3","Sun","September 24","L","","0-3",TRUE,"Washington Redskins",15,31,17,261,200,61,2,25,495,261,234,1,2006-09-24,-1,0,"htx",-16
"4","Sun","October 1","W","","1-3",TRUE,"Miami Dolphins",17,15,19,276,211,65,2,15,289,219,70,0,2006-10-01,-2,1,"htx",2
"6","Sun","October 15","L","","1-4",FALSE,"Dallas Cowboys",6,34,12,232,198,34,3,21,354,184,170,0,2006-10-15,-3,0,"htx",-28
"7","Sun","October 22","W","","2-4",TRUE,"Jacksonville Jaguars",27,7,21,349,218,131,0,14,220,118,102,2,2006-10-22,2,1,"htx",20
"8","Sun","October 29","L","","2-5",FALSE,"Tennessee Titans",22,28,26,427,279,148,5,10,197,86,111,0,2006-10-29,-5,0,"htx",-6
"9","Sun","November 5","L","","2-6",FALSE,"New York Giants",10,14,17,251,170,81,1,23,285,163,122,1,2006-11-05,0,0,"htx",-4
"10","Sun","November 12","W","","3-6",FALSE,"Jacksonville Jaguars",13,10,21,306,158,148,0,16,322,204,118,4,2006-11-12,4,1,"htx",3
"11","Sun","November 19","L","","3-7",TRUE,"Buffalo Bills",21,24,20,394,206,188,2,17,403,333,70,1,2006-11-19,-1,0,"htx",-3
"12","Sun","November 26","L","","3-8",FALSE,"New York Jets",11,26,21,334,309,25,1,17,304,277,27,0,2006-11-26,-1,0,"htx",-15
"13","Sun","December 3","W","","4-8",FALSE,"Oakland Raiders",23,14,10,124,-5,129,2,21,302,189,113,5,2006-12-03,3,1,"htx",9
"14","Sun","December 10","L","OT","4-9",TRUE,"Tennessee Titans",20,26,15,240,133,107,0,22,418,200,218,2,2006-12-10,2,0,"htx",-6
"15","Sun","December 17","L","","4-10",FALSE,"New England Patriots",7,40,13,198,93,105,4,15,230,125,105,0,2006-12-17,-4,0,"htx",-33
"16","Sun","December 24","W","","5-10",TRUE,"Indianapolis Colts",27,24,22,354,163,191,0,19,319,205,114,1,2006-12-24,1,1,"htx",3
"17","Sun","December 31","W","","6-10",TRUE,"Cleveland Browns",14,6,11,177,83,94,1,19,306,179,127,3,2006-12-31,2,1,"htx",8
"1","Sun","September 9","W","","1-0",TRUE,"Kansas City Chiefs",20,3,13,315,206,109,2,14,219,147,72,4,2007-09-09,2,1,"htx",17
"2","Sun","September 16","W","","2-0",FALSE,"Carolina Panthers",34,21,19,346,227,119,1,17,353,287,66,3,2007-09-16,2,1,"htx",13
"3","Sun","September 23","L","","2-1",TRUE,"Indianapolis Colts",24,30,16,254,214,40,2,18,362,270,92,0,2007-09-23,-2,0,"htx",-6
"4","Sun","September 30","L","","2-2",FALSE,"Atlanta Falcons",16,26,18,398,311,87,2,20,304,214,90,0,2007-09-30,-2,0,"htx",-10
"5","Sun","October 7","W","","3-2",TRUE,"Miami Dolphins",22,19,20,352,278,74,2,17,285,148,137,1,2007-10-07,-1,1,"htx",3
"6","Sun","October 14","L","","3-3",FALSE,"Jacksonville Jaguars",17,37,23,390,329,61,3,25,457,213,244,3,2007-10-14,0,0,"htx",-20
"7","Sun","October 21","L","","3-4",TRUE,"Tennessee Titans",36,38,18,333,294,39,6,23,422,267,155,2,2007-10-21,-4,0,"htx",-2
"8","Sun","October 28","L","","3-5",FALSE,"San Diego Chargers",10,35,22,367,252,115,5,11,237,128,109,0,2007-10-28,-5,0,"htx",-25
"9","Sun","November 4","W","","4-5",FALSE,"Oakland Raiders",24,17,17,359,181,178,1,23,310,157,153,3,2007-11-04,2,1,"htx",7
"11","Sun","November 18","W","","5-5",TRUE,"New Orleans Saints",23,10,19,390,287,103,2,20,327,280,47,3,2007-11-18,1,1,"htx",13
"12","Sun","November 25","L","","5-6",FALSE,"Cleveland Browns",17,27,17,314,237,77,3,21,397,249,148,1,2007-11-25,-2,0,"htx",-10
"13","Sun","December 2","L","","5-7",FALSE,"Tennessee Titans",20,28,17,315,196,119,2,23,382,229,153,1,2007-12-02,-1,0,"htx",-8
"14","Sun","December 9","W","","6-7",TRUE,"Tampa Bay Buccaneers",28,14,18,257,186,71,2,16,305,234,71,2,2007-12-09,0,1,"htx",14
"15","Thu","December 13","W","","7-7",TRUE,"Denver Broncos",31,13,21,358,200,158,1,20,308,236,72,0,2007-12-13,-1,1,"htx",18
"16","Sun","December 23","L","","7-8",FALSE,"Indianapolis Colts",15,38,18,299,233,66,3,33,458,338,120,1,2007-12-23,-2,0,"htx",-23
"17","Sun","December 30","W","","8-8",TRUE,"Jacksonville Jaguars",42,28,19,290,120,170,1,24,381,285,96,1,2007-12-30,0,1,"htx",14
"1","Sun","September 7","L","","0-1",FALSE,"Pittsburgh Steelers",17,38,20,234,159,75,3,21,305,122,183,1,2008-09-07,-2,0,"htx",-21
"3","Sun","September 21","L","","0-2",FALSE,"Tennessee Titans",12,31,18,317,171,146,3,19,343,185,158,2,2008-09-21,-1,0,"htx",-19
"4","Sun","September 28","L","OT","0-3",FALSE,"Jacksonville Jaguars",27,30,23,386,307,79,0,21,375,236,139,0,2008-09-28,0,0,"htx",-3
"5","Sun","October 5","L","","0-4",TRUE,"Indianapolis Colts",27,31,23,391,235,156,3,18,314,235,79,1,2008-10-05,-2,0,"htx",-4
"6","Sun","October 12","W","","1-4",TRUE,"Miami Dolphins",29,28,23,485,371,114,4,14,370,274,96,1,2008-10-12,-3,1,"htx",1
"7","Sun","October 19","W","","2-4",TRUE,"Detroit Lions",28,21,29,404,254,150,1,15,326,249,77,0,2008-10-19,-1,1,"htx",7
"8","Sun","October 26","W","","3-4",TRUE,"Cincinnati Bengals",35,6,23,384,275,109,0,16,253,148,105,3,2008-10-26,3,1,"htx",29
"9","Sun","November 2","L","","3-5",FALSE,"Minnesota Vikings",21,28,20,389,327,62,3,15,345,168,177,1,2008-11-02,-2,0,"htx",-7
"10","Sun","November 9","L","","3-6",TRUE,"Baltimore Ravens",13,41,19,355,280,75,4,27,333,171,162,0,2008-11-09,-4,0,"htx",-28
"11","Sun","November 16","L","","3-7",FALSE,"Indianapolis Colts",27,33,16,356,179,177,1,30,474,320,154,0,2008-11-16,-1,0,"htx",-6
"12","Sun","November 23","W","","4-7",FALSE,"Cleveland Browns",16,6,19,383,271,112,2,15,240,145,95,5,2008-11-23,3,1,"htx",10
"13","Mon","December 1","W","","5-7",TRUE,"Jacksonville Jaguars",30,17,18,326,200,126,1,21,388,262,126,3,2008-12-01,2,1,"htx",13
"14","Sun","December 7","W","","6-7",FALSE,"Green Bay Packers",24,21,25,549,408,141,4,16,387,279,108,1,2008-12-07,-3,1,"htx",3
"15","Sun","December 14","W","","7-7",TRUE,"Tennessee Titans",13,12,22,375,268,107,1,14,281,181,100,2,2008-12-14,1,1,"htx",1
"16","Sun","December 21","L","","7-8",FALSE,"Oakland Raiders",16,27,17,324,234,90,1,17,362,223,139,1,2008-12-21,0,0,"htx",-11
"17","Sun","December 28","W","","8-8",TRUE,"Chicago Bears",31,24,25,455,328,127,1,21,294,225,69,1,2008-12-28,0,1,"htx",7
"1","Sun","September 13","L","","0-1",TRUE,"New York Jets",7,24,11,183,145,38,2,22,462,272,190,1,2009-09-13,-1,0,"htx",-17
"2","Sun","September 20","W","","1-1",FALSE,"Tennessee Titans",34,31,19,420,357,63,0,19,449,209,240,2,2009-09-20,2,1,"htx",3
"3","Sun","September 27","L","","1-2",TRUE,"Jacksonville Jaguars",24,31,23,397,286,111,2,24,399,214,185,1,2009-09-27,-1,0,"htx",-7
"4","Sun","October 4","W","","2-2",TRUE,"Oakland Raiders",29,6,16,329,209,120,2,8,165,120,45,3,2009-10-04,1,1,"htx",23
"5","Sun","October 11","L","","2-3",FALSE,"Arizona Cardinals",21,28,23,416,371,45,1,19,340,296,44,1,2009-10-11,0,0,"htx",-7
"6","Sun","October 18","W","","3-3",FALSE,"Cincinnati Bengals",28,17,26,472,385,87,2,14,296,250,46,3,2009-10-18,1,1,"htx",11
"7","Sun","October 25","W","","4-3",TRUE,"San Francisco 49ers",24,21,18,336,246,90,1,17,297,238,59,2,2009-10-25,1,1,"htx",3
"8","Sun","November 1","W","","5-3",FALSE,"Buffalo Bills",31,10,24,439,257,182,3,9,204,107,97,2,2009-11-01,-1,1,"htx",21
"9","Sun","November 8","L","","5-4",FALSE,"Indianapolis Colts",17,20,22,382,301,81,3,27,378,306,72,2,2009-11-08,-1,0,"htx",-3
"11","Mon","November 23","L","","5-5",TRUE,"Tennessee Titans",17,20,17,340,283,57,0,22,344,116,228,1,2009-11-23,1,0,"htx",-3
"12","Sun","November 29","L","","5-6",TRUE,"Indianapolis Colts",27,35,27,396,274,122,3,28,342,228,114,2,2009-11-29,-1,0,"htx",-8
"13","Sun","December 6","L","","5-7",FALSE,"Jacksonville Jaguars",18,23,19,305,233,72,3,19,323,216,107,1,2009-12-06,-2,0,"htx",-5
"14","Sun","December 13","W","","6-7",TRUE,"Seattle Seahawks",34,7,23,450,365,85,2,13,282,220,62,1,2009-12-13,-1,1,"htx",27
"15","Sun","December 20","W","","7-7",FALSE,"St. Louis Rams",16,13,22,419,367,52,2,15,237,149,88,2,2009-12-20,0,1,"htx",3
"16","Sun","December 27","W","","8-7",FALSE,"Miami Dolphins",27,20,21,406,280,126,1,23,363,303,60,1,2009-12-27,0,1,"htx",7
"17","Sun","January 3","W","","9-7",TRUE,"New England Patriots",34,27,29,439,295,144,1,21,317,243,74,2,2010-01-03,1,1,"htx",7
"1","Sun","September 12","W","","1-0",TRUE,"Indianapolis Colts",34,24,23,355,98,257,1,25,463,419,44,1,2010-09-12,0,1,"htx",10
"2","Sun","September 19","W","OT","2-0",FALSE,"Washington Redskins",30,27,29,526,468,58,1,21,421,403,18,0,2010-09-19,-1,1,"htx",3
"3","Sun","September 26","L","","2-1",TRUE,"Dallas Cowboys",13,27,24,340,216,124,3,21,385,284,101,0,2010-09-26,-3,0,"htx",-14
"4","Sun","October 3","W","","3-1",FALSE,"Oakland Raiders",31,24,21,441,192,249,0,24,363,245,118,3,2010-10-03,3,1,"htx",7
"5","Sun","October 10","L","","3-2",TRUE,"New York Giants",10,34,11,195,171,24,2,26,414,297,117,2,2010-10-10,0,0,"htx",-24
"6","Sun","October 17","W","","4-2",TRUE,"Kansas City Chiefs",35,31,23,421,289,132,0,25,417,189,228,0,2010-10-17,0,1,"htx",4
"8","Mon","November 1","L","","4-3",FALSE,"Indianapolis Colts",17,30,19,291,183,108,2,24,366,259,107,0,2010-11-01,-2,0,"htx",-13
"9","Sun","November 7","L","","4-4",TRUE,"San Diego Chargers",23,29,25,392,252,140,1,18,367,290,77,2,2010-11-07,1,0,"htx",-6
"10","Sun","November 14","L","","4-5",FALSE,"Jacksonville Jaguars",24,31,20,395,314,81,1,29,491,326,165,0,2010-11-14,-1,0,"htx",-7
"11","Sun","November 21","L","","4-6",FALSE,"New York Jets",27,30,17,343,246,97,1,22,401,298,103,2,2010-11-21,1,0,"htx",-3
"12","Sun","November 28","W","","5-6",TRUE,"Tennessee Titans",20,0,24,346,158,188,0,9,162,138,24,3,2010-11-28,3,1,"htx",20
"13","Thu","December 2","L","","5-7",FALSE,"Philadelphia Eagles",24,34,27,431,323,108,2,22,416,301,115,1,2010-12-02,-1,0,"htx",-10
"14","Mon","December 13","L","OT","5-8",TRUE,"Baltimore Ravens",28,34,28,489,378,111,2,19,253,190,63,0,2010-12-13,-2,0,"htx",-6
"15","Sun","December 19","L","","5-9",FALSE,"Tennessee Titans",17,31,26,323,293,30,1,19,359,212,147,1,2010-12-19,0,0,"htx",-14
"16","Sun","December 26","L","","5-10",FALSE,"Denver Broncos",23,24,21,401,310,91,1,25,431,305,126,1,2010-12-26,0,0,"htx",-1
"17","Sun","January 2","W","","6-10",TRUE,"Jacksonville Jaguars",34,17,22,497,253,244,0,23,322,124,198,2,2011-01-02,2,1,"htx",17
"1","Sun","September 11","W","","1-0",TRUE,"Indianapolis Colts",34,7,26,384,217,167,3,15,236,172,64,2,2011-09-11,-1,1,"htx",27
"2","Sun","September 18","W","","2-0",FALSE,"Miami Dolphins",23,13,19,345,207,138,0,18,306,153,153,2,2011-09-18,2,1,"htx",10
"3","Sun","September 25","L","","2-1",FALSE,"New Orleans Saints",33,40,21,473,364,109,1,27,454,354,100,2,2011-09-25,1,0,"htx",-7
"4","Sun","October 2","W","","3-1",TRUE,"Pittsburgh Steelers",17,10,17,318,138,180,0,20,296,178,118,1,2011-10-02,1,1,"htx",7
"5","Sun","October 9","L","","3-2",TRUE,"Oakland Raiders",20,25,21,473,403,70,2,11,278,184,94,1,2011-10-09,-1,0,"htx",-5
"6","Sun","October 16","L","","3-3",FALSE,"Baltimore Ravens",14,29,18,293,200,93,0,24,402,289,113,2,2011-10-16,2,0,"htx",-15
"7","Sun","October 23","W","","4-3",FALSE,"Tennessee Titans",41,7,29,518,296,222,0,11,148,95,53,2,2011-10-23,2,1,"htx",34
"8","Sun","October 30","W","","5-3",TRUE,"Jacksonville Jaguars",24,14,20,358,202,156,2,13,174,90,84,2,2011-10-30,0,1,"htx",10
"9","Sun","November 6","W","","6-3",TRUE,"Cleveland Browns",30,12,21,380,119,261,1,10,172,128,44,2,2011-11-06,1,1,"htx",18
"10","Sun","November 13","W","","7-3",FALSE,"Tampa Bay Buccaneers",37,9,21,420,235,185,0,12,231,141,90,4,2011-11-13,4,1,"htx",28
"12","Sun","November 27","W","","8-3",FALSE,"Jacksonville Jaguars",20,13,9,215,127,88,1,14,255,150,105,1,2011-11-27,0,1,"htx",7
"13","Sun","December 4","W","","9-3",TRUE,"Atlanta Falcons",17,10,20,337,175,162,1,18,337,267,70,2,2011-12-04,1,1,"htx",7
"14","Sun","December 11","W","","10-3",FALSE,"Cincinnati Bengals",20,19,25,412,268,144,4,16,285,184,101,2,2011-12-11,-2,1,"htx",1
"15","Sun","December 18","L","","10-4",TRUE,"Carolina Panthers",13,28,18,358,208,150,3,20,316,150,166,0,2011-12-18,-3,0,"htx",-15
"16","Thu","December 22","L","","10-5",FALSE,"Indianapolis Colts",16,19,14,283,112,171,1,24,320,225,95,1,2011-12-22,0,0,"htx",-3
"17","Sun","January 1","L","","10-6",TRUE,"Tennessee Titans",22,23,22,387,235,152,1,17,361,275,86,1,2012-01-01,0,0,"htx",-1
"WildCard","Sat","January 7","W","","11-6",TRUE,"Cincinnati Bengals",31,10,19,340,152,188,0,21,300,224,76,3,2012-01-07,3,1,"htx",21
"Division","Sun","January 15","L","","11-7",FALSE,"Baltimore Ravens",13,20,16,315,184,131,4,11,227,140,87,0,2012-01-15,-4,0,"htx",-7
"1","Sun","September 8","L","","0-1",FALSE,"Pittsburgh Steelers",3,45,9,159,112,47,2,30,445,282,163,1,1985-09-08,-1,0,"clt",-42
"2","Sun","September 15","L","","0-2",FALSE,"Miami Dolphins",13,30,17,298,202,96,1,33,486,329,157,1,1985-09-15,0,0,"clt",-17
"3","Sun","September 22","W","","1-2",TRUE,"Detroit Lions",14,6,24,355,127,228,3,10,204,99,105,2,1985-09-22,-1,1,"clt",8
"4","Sun","September 29","L","","1-3",FALSE,"New York Jets",20,25,17,320,217,103,1,23,392,227,165,1,1985-09-29,0,0,"clt",-5
"5","Sun","October 6","W","","2-3",TRUE,"Buffalo Bills",49,17,28,464,183,281,1,15,252,184,68,3,1985-10-06,2,1,"clt",32
"6","Sun","October 13","L","","2-4",TRUE,"Denver Broncos",10,15,12,237,117,120,3,20,351,223,128,1,1985-10-13,-2,0,"clt",-5
"7","Sun","October 20","L","","2-5",FALSE,"Buffalo Bills",9,21,14,191,65,126,3,13,182,61,121,3,1985-10-20,0,0,"clt",-12
"8","Sun","October 27","W","","3-5",TRUE,"Green Bay Packers",37,10,24,496,266,230,2,17,277,203,74,6,1985-10-27,4,1,"clt",27
"9","Sun","November 3","L","","3-6",TRUE,"New York Jets",17,35,15,258,205,53,5,19,349,148,201,3,1985-11-03,-2,0,"clt",-18
"10","Sun","November 10","L","","3-7",FALSE,"New England Patriots",15,34,16,282,179,103,5,17,297,156,141,1,1985-11-10,-4,0,"clt",-19
"11","Sun","November 17","L","","3-8",TRUE,"Miami Dolphins",20,34,17,352,210,142,4,25,458,323,135,2,1985-11-17,-2,0,"clt",-14
"12","Sun","November 24","L","","3-9",FALSE,"Kansas City Chiefs",7,20,11,211,86,125,1,21,358,231,127,1,1985-11-24,0,0,"clt",-13
"13","Sun","December 1","L","","3-10",TRUE,"New England Patriots",31,38,23,300,170,130,2,24,412,276,136,1,1985-12-01,-1,0,"clt",-7
"14","Sun","December 8","L","","3-11",FALSE,"Chicago Bears",10,17,10,232,133,99,0,22,328,137,191,0,1985-12-08,0,0,"clt",-7
"15","Sun","December 15","W","","4-11",FALSE,"Tampa Bay Buccaneers",31,23,23,384,127,257,1,23,387,230,157,4,1985-12-15,3,1,"clt",8
"16","Sun","December 22","W","","5-11",TRUE,"Houston Oilers",34,16,22,467,168,299,0,18,421,345,76,3,1985-12-22,3,1,"clt",18
"1","Sun","September 7","L","","0-1",FALSE,"New England Patriots",3,33,15,284,193,91,3,20,373,251,122,0,1986-09-07,-3,0,"clt",-30
"2","Sun","September 14","L","","0-2",FALSE,"Miami Dolphins",10,30,15,253,178,75,2,21,388,254,134,1,1986-09-14,-1,0,"clt",-20
"3","Sun","September 21","L","","0-3",TRUE,"Los Angeles Rams",7,24,14,177,122,55,2,21,316,162,154,2,1986-09-21,0,0,"clt",-17
"4","Sun","September 28","L","","0-4",TRUE,"New York Jets",7,26,16,282,230,52,4,17,251,166,85,5,1986-09-28,1,0,"clt",-19
"5","Sun","October 5","L","","0-5",FALSE,"San Francisco 49ers",14,35,17,323,228,95,5,16,358,248,110,1,1986-10-05,-4,0,"clt",-21
"6","Sun","October 12","L","","0-6",TRUE,"New Orleans Saints",14,17,22,382,287,95,4,19,305,144,161,3,1986-10-12,-1,0,"clt",-3
"7","Sun","October 19","L","","0-7",FALSE,"Buffalo Bills",13,24,20,297,167,130,2,21,364,243,121,3,1986-10-19,1,0,"clt",-11
"8","Sun","October 26","L","","0-8",TRUE,"Miami Dolphins",13,17,17,303,121,182,1,21,340,243,97,0,1986-10-26,-1,0,"clt",-4
"9","Sun","November 2","L","","0-9",TRUE,"Cleveland Browns",9,24,20,264,159,105,1,15,259,213,46,0,1986-11-02,-1,0,"clt",-15
"10","Sun","November 9","L","","0-10",TRUE,"New England Patriots",21,30,17,297,212,85,4,27,336,222,114,2,1986-11-09,-2,0,"clt",-9
"11","Sun","November 16","L","","0-11",FALSE,"New York Jets",16,31,23,408,350,58,6,19,360,218,142,4,1986-11-16,-2,0,"clt",-15
"12","Sun","November 23","L","","0-12",FALSE,"Houston Oilers",17,31,13,242,178,64,2,28,471,298,173,3,1986-11-23,1,0,"clt",-14
"13","Sun","November 30","L","","0-13",TRUE,"San Diego Chargers",3,17,11,177,122,55,3,21,391,290,101,2,1986-11-30,-1,0,"clt",-14
"14","Sun","December 7","W","","1-13",FALSE,"Atlanta Falcons",28,23,14,225,151,74,3,25,408,189,219,3,1986-12-07,0,1,"clt",5
"15","Sun","December 14","W","","2-13",TRUE,"Buffalo Bills",24,14,21,375,296,79,0,18,358,264,94,3,1986-12-14,3,1,"clt",10
"16","Sun","December 21","W","","3-13",FALSE,"Los Angeles Raiders",30,24,23,411,215,196,2,25,423,334,89,3,1986-12-21,1,1,"clt",6
"1","Sun","September 13","L","","0-1",TRUE,"Cincinnati Bengals",21,23,15,291,206,85,3,25,403,216,187,1,1987-09-13,-2,0,"clt",-2
"2","Sun","September 20","L","","0-2",TRUE,"Miami Dolphins",10,23,20,342,258,84,4,20,375,245,130,2,1987-09-20,-2,0,"clt",-13
"3","Sun","October 4","W","","1-2",FALSE,"Buffalo Bills",47,6,28,463,297,166,2,14,163,82,81,7,1987-10-04,5,1,"clt",41
"4","Sun","October 11","W","","2-2",TRUE,"New York Jets",6,0,14,270,96,174,2,16,211,145,66,5,1987-10-11,3,1,"clt",6
"5","Sun","October 18","L","","2-3",FALSE,"Pittsburgh Steelers",7,21,15,270,195,75,5,23,378,126,252,1,1987-10-18,-4,0,"clt",-14
"6","Sun","October 25","W","","3-3",TRUE,"New England Patriots",30,16,17,300,213,87,1,18,304,225,79,3,1987-10-25,2,1,"clt",14
"7","Sun","November 1","W","","4-3",FALSE,"New York Jets",19,14,21,377,191,186,0,15,230,129,101,3,1987-11-01,3,1,"clt",5
"8","Sun","November 8","L","","4-4",TRUE,"San Diego Chargers",13,16,18,303,112,191,3,15,296,214,82,4,1987-11-08,1,0,"clt",-3
"9","Sun","November 15","W","","5-4",FALSE,"Miami Dolphins",40,21,32,457,218,239,0,22,286,209,77,5,1987-11-15,5,1,"clt",19
"10","Sun","November 22","L","","5-5",FALSE,"New England Patriots",0,24,18,324,198,126,5,15,313,174,139,0,1987-11-22,-5,0,"clt",-24
"11","Sun","November 29","W","","6-5",TRUE,"Houston Oilers",51,27,18,359,148,211,1,26,454,318,136,5,1987-11-29,4,1,"clt",24
"12","Sun","December 6","W","","7-5",FALSE,"Cleveland Browns",9,7,18,297,183,114,1,15,247,160,87,1,1987-12-06,0,1,"clt",2
"13","Sun","December 13","L","","7-6",TRUE,"Buffalo Bills",3,27,9,130,97,33,6,25,385,167,218,4,1987-12-13,-2,0,"clt",-24
"14","Sun","December 20","W","","8-6",FALSE,"San Diego Chargers",20,7,19,340,194,146,0,17,273,214,59,3,1987-12-20,3,1,"clt",13
"15","Sun","December 27","W","","9-6",TRUE,"Tampa Bay Buccaneers",24,6,23,472,246,226,1,10,232,136,96,1,1987-12-27,0,1,"clt",18
"Division","Sat","January 9","L","","9-7",FALSE,"Cleveland Browns",21,38,23,315,252,63,2,25,404,229,175,1,1988-01-09,-1,0,"clt",-17
"1","Sun","September 4","L","OT","0-1",TRUE,"Houston Oilers",14,17,16,281,170,111,3,18,347,174,173,3,1988-09-04,0,0,"clt",-3
"2","Sun","September 11","L","","0-2",TRUE,"Chicago Bears",13,17,11,173,65,108,3,23,326,172,154,1,1988-09-11,-2,0,"clt",-4
"3","Mon","September 19","L","","0-3",FALSE,"Cleveland Browns",17,23,15,282,154,128,3,22,356,255,101,2,1988-09-19,-1,0,"clt",-6
"4","Sun","September 25","W","","1-3",TRUE,"Miami Dolphins",15,13,18,304,91,213,1,18,323,252,71,2,1988-09-25,1,1,"clt",2
"5","Sun","October 2","L","","1-4",FALSE,"New England Patriots",17,21,15,267,164,103,1,19,298,193,105,2,1988-10-02,1,0,"clt",-4
"6","Sun","October 9","L","","1-5",FALSE,"Buffalo Bills",23,34,25,308,241,67,3,25,456,315,141,3,1988-10-09,0,0,"clt",-11
"7","Sun","October 16","W","","2-5",TRUE,"Tampa Bay Buccaneers",35,31,25,349,246,103,2,24,483,444,39,2,1988-10-16,0,1,"clt",4
"8","Sun","October 23","W","","3-5",FALSE,"San Diego Chargers",16,0,28,453,255,198,3,14,239,121,118,1,1988-10-23,-2,1,"clt",16
"9","Mon","October 31","W","","4-5",TRUE,"Denver Broncos",55,23,23,464,220,244,0,22,397,266,131,4,1988-10-31,4,1,"clt",32
"10","Sun","November 6","W","","5-5",TRUE,"New York Jets",38,14,22,336,196,140,3,20,273,182,91,2,1988-11-06,-1,1,"clt",24
"11","Sun","November 13","W","","6-5",FALSE,"Green Bay Packers",20,13,14,247,111,136,1,22,297,199,98,4,1988-11-13,3,1,"clt",7
"12","Sun","November 20","L","","6-6",FALSE,"Minnesota Vikings",3,12,17,213,110,103,2,13,275,192,83,0,1988-11-20,-2,0,"clt",-9
"13","Sun","November 27","W","","7-6",TRUE,"New England Patriots",24,21,16,241,160,81,2,18,285,180,105,3,1988-11-27,1,1,"clt",3
"14","Sun","December 4","W","","8-6",FALSE,"Miami Dolphins",31,28,23,322,101,221,0,21,362,304,58,2,1988-12-04,2,1,"clt",3
"15","Sat","December 10","L","","8-7",FALSE,"New York Jets",16,34,18,329,220,109,3,22,331,158,173,3,1988-12-10,0,0,"clt",-18
"16","Sun","December 18","W","","9-7",TRUE,"Buffalo Bills",17,14,25,301,117,184,0,14,248,195,53,1,1988-12-18,1,1,"clt",3
"1","Sun","September 10","L","","0-1",TRUE,"San Francisco 49ers",24,30,22,344,190,154,1,24,404,204,200,0,1989-09-10,-1,0,"clt",-6
"2","Sun","September 17","L","","0-2",FALSE,"Los Angeles Rams",17,31,20,386,266,120,2,26,449,352,97,1,1989-09-17,-1,0,"clt",-14
"3","Sun","September 24","W","","1-2",TRUE,"Atlanta Falcons",13,9,15,214,84,130,1,11,208,103,105,3,1989-09-24,2,1,"clt",4
"4","Sun","October 1","W","","2-2",FALSE,"New York Jets",17,10,17,316,242,74,2,18,245,182,63,2,1989-10-01,0,1,"clt",7
"5","Sun","October 8","W","","3-2",TRUE,"Buffalo Bills",37,14,20,330,177,153,1,25,424,353,71,6,1989-10-08,5,1,"clt",23
"6","Sun","October 15","L","","3-3",FALSE,"Denver Broncos",3,14,7,128,84,44,1,20,319,150,169,2,1989-10-15,1,0,"clt",-11
"7","Sun","October 22","W","","4-3",FALSE,"Cincinnati Bengals",23,12,18,336,168,168,3,15,218,123,95,3,1989-10-22,0,1,"clt",11
"8","Sun","October 29","L","OT","4-4",TRUE,"New England Patriots",20,23,19,357,227,130,2,30,448,328,120,2,1989-10-29,0,0,"clt",-3
"9","Sun","November 5","L","","4-5",FALSE,"Miami Dolphins",13,19,17,299,214,85,2,19,308,149,159,3,1989-11-05,1,0,"clt",-6
"10","Sun","November 12","L","","4-6",FALSE,"Buffalo Bills",7,30,13,189,103,86,3,26,393,161,232,0,1989-11-12,-3,0,"clt",-23
"11","Sun","November 19","W","","5-6",TRUE,"New York Jets",27,10,23,424,239,185,0,22,354,244,110,3,1989-11-19,3,1,"clt",17
"12","Sun","November 26","W","","6-6",TRUE,"San Diego Chargers",10,6,11,264,205,59,2,14,314,137,177,1,1989-11-26,-1,1,"clt",4
"13","Sun","December 3","L","","6-7",FALSE,"New England Patriots",16,22,14,295,207,88,3,23,426,239,187,2,1989-12-03,-1,0,"clt",-6
"14","Sun","December 10","W","OT","7-7",TRUE,"Cleveland Browns",23,17,19,396,251,145,1,24,470,347,123,4,1989-12-10,3,1,"clt",6
"15","Sun","December 17","W","","8-7",TRUE,"Miami Dolphins",42,13,25,305,184,121,1,16,242,201,41,3,1989-12-17,2,1,"clt",29
"16","Sun","December 24","L","","8-8",FALSE,"New Orleans Saints",6,41,13,230,119,111,2,23,389,261,128,1,1989-12-24,-1,0,"clt",-35
"1","Sun","September 9","L","","0-1",FALSE,"Buffalo Bills",10,26,15,229,173,56,2,24,383,283,100,1,1990-09-09,-1,0,"clt",-16
"2","Sun","September 16","L","","0-2",TRUE,"New England Patriots",14,16,14,207,143,64,5,16,310,187,123,1,1990-09-16,-4,0,"clt",-2
"3","Sun","September 23","L","","0-3",FALSE,"Houston Oilers",10,24,18,252,195,57,4,22,372,303,69,3,1990-09-23,-1,0,"clt",-14
"4","Sun","September 30","W","","1-3",FALSE,"Philadelphia Eagles",24,23,17,357,305,52,2,21,409,266,143,1,1990-09-30,-1,1,"clt",1
"5","Sun","October 7","W","","2-3",TRUE,"Kansas City Chiefs",23,19,15,231,143,88,3,13,255,177,78,4,1990-10-07,1,1,"clt",4
"7","Sun","October 21","L","","2-4",TRUE,"Denver Broncos",17,27,23,363,304,59,1,23,444,293,151,1,1990-10-21,0,0,"clt",-10
"8","Sun","October 28","L","","2-5",TRUE,"Miami Dolphins",7,27,7,132,101,31,4,23,356,150,206,1,1990-10-28,-3,0,"clt",-20
"9","Mon","November 5","L","","2-6",TRUE,"New York Giants",7,24,11,181,126,55,1,17,274,158,116,2,1990-11-05,1,0,"clt",-17
"10","Sun","November 11","W","","3-6",FALSE,"New England Patriots",13,10,5,155,101,54,0,14,247,72,175,1,1990-11-11,1,1,"clt",3
"11","Sun","November 18","W","","4-6",TRUE,"New York Jets",17,14,15,313,225,88,1,22,425,304,121,1,1990-11-18,0,1,"clt",3
"12","Sun","November 25","W","","5-6",FALSE,"Cincinnati Bengals",34,20,21,419,237,182,0,20,381,236,145,3,1990-11-25,3,1,"clt",14
"13","Sun","December 2","L","","5-7",FALSE,"Phoenix Cardinals",17,20,14,251,142,109,2,17,276,144,132,1,1990-12-02,-1,0,"clt",-3
"14","Sun","December 9","L","","5-8",TRUE,"Buffalo Bills",7,31,12,127,52,75,3,23,408,247,161,1,1990-12-09,-2,0,"clt",-24
"15","Sun","December 16","W","","6-8",FALSE,"New York Jets",29,21,18,373,217,156,0,21,300,146,154,1,1990-12-16,1,1,"clt",8
"16","Sat","December 22","W","","7-8",TRUE,"Washington Redskins",35,28,20,249,216,33,0,28,467,244,223,2,1990-12-22,2,1,"clt",7
"17","Sun","December 30","L","","7-9",FALSE,"Miami Dolphins",17,23,20,316,193,123,3,16,307,192,115,0,1990-12-30,-3,0,"clt",-6
"1","Sun","September 1","L","","0-1",TRUE,"New England Patriots",7,16,19,337,271,66,2,14,206,125,81,1,1991-09-01,-1,0,"clt",-9
"2","Sun","September 8","L","","0-2",FALSE,"Miami Dolphins",6,17,11,150,81,69,0,20,277,129,148,2,1991-09-08,2,0,"clt",-11
"3","Sun","September 15","L","","0-3",FALSE,"Los Angeles Raiders",0,16,16,266,193,73,2,15,268,153,115,0,1991-09-15,-2,0,"clt",-16
"4","Sun","September 22","L","","0-4",TRUE,"Detroit Lions",24,33,20,328,324,4,1,25,402,194,208,3,1991-09-22,2,0,"clt",-9
"5","Sun","September 29","L","","0-5",FALSE,"Seattle Seahawks",3,31,9,137,95,42,3,16,251,83,168,3,1991-09-29,0,0,"clt",-28
"6","Sun","October 6","L","","0-6",TRUE,"Pittsburgh Steelers",3,21,15,189,147,42,2,17,292,172,120,3,1991-10-06,1,0,"clt",-18
"7","Sun","October 13","L","","0-7",FALSE,"Buffalo Bills",6,42,20,240,174,66,3,23,396,120,276,2,1991-10-13,-1,0,"clt",-36
"8","Sun","October 20","L","","0-8",TRUE,"New York Jets",6,17,11,170,79,91,1,19,331,193,138,1,1991-10-20,0,0,"clt",-11
"10","Sun","November 3","L","","0-9",TRUE,"Miami Dolphins",6,10,15,278,183,95,2,15,298,231,67,0,1991-11-03,-2,0,"clt",-4
"11","Sun","November 10","W","","1-9",FALSE,"New York Jets",28,27,16,282,239,43,3,24,436,318,118,1,1991-11-10,-2,1,"clt",1
"12","Sun","November 17","L","","1-10",TRUE,"Chicago Bears",17,31,14,251,140,111,0,25,448,273,175,2,1991-11-17,2,0,"clt",-14
"13","Sun","November 24","L","","1-11",FALSE,"Green Bay Packers",10,14,16,189,117,72,2,11,192,28,164,3,1991-11-24,1,0,"clt",-4
"14","Sun","December 1","L","","1-12",TRUE,"Cleveland Browns",0,31,11,171,28,143,4,19,315,177,138,0,1991-12-01,-4,0,"clt",-31
"15","Sun","December 8","L","OT","1-13",FALSE,"New England Patriots",17,23,13,202,147,55,0,22,400,277,123,3,1991-12-08,3,0,"clt",-6
"16","Sun","December 15","L","","1-14",TRUE,"Buffalo Bills",7,35,18,328,195,133,3,22,315,159,156,0,1991-12-15,-3,0,"clt",-28
"17","Sun","December 22","L","","1-15",FALSE,"Tampa Bay Buccaneers",3,17,12,230,166,64,3,18,300,168,132,4,1991-12-22,1,0,"clt",-14
"1","Sun","September 6","W","","1-0",TRUE,"Cleveland Browns",14,3,15,236,172,64,2,13,145,103,42,2,1992-09-06,0,1,"clt",11
"2","Sun","September 13","L","","1-1",TRUE,"Houston Oilers",10,20,14,162,106,56,1,23,419,350,69,0,1992-09-13,-1,0,"clt",-10
"3","Sun","September 20","L","","1-2",FALSE,"Buffalo Bills",0,38,9,140,103,37,3,24,380,211,169,2,1992-09-20,-1,0,"clt",-38
"5","Sun","October 4","W","","2-2",FALSE,"Tampa Bay Buccaneers",24,14,15,293,224,69,3,28,359,243,116,3,1992-10-04,0,1,"clt",10
"6","Sun","October 11","W","OT","3-2",TRUE,"New York Jets",6,3,22,282,183,99,1,8,147,73,74,1,1992-10-11,0,1,"clt",3
"7","Sun","October 18","L","","3-3",TRUE,"San Diego Chargers",14,34,22,330,293,37,5,26,392,180,212,3,1992-10-18,-2,0,"clt",-20
"8","Sun","October 25","W","","4-3",FALSE,"Miami Dolphins",31,20,20,262,153,109,2,24,413,348,65,5,1992-10-25,3,1,"clt",11
"9","Sun","November 1","L","","4-4",FALSE,"San Diego Chargers",0,26,8,99,69,30,2,26,398,247,151,3,1992-11-01,1,0,"clt",-26
"10","Sun","November 8","L","","4-5",TRUE,"Miami Dolphins",0,28,11,193,125,68,4,28,453,241,212,1,1992-11-08,-3,0,"clt",-28
"11","Sun","November 15","L","OT","4-6",TRUE,"New England Patriots",34,37,26,417,330,87,4,18,370,226,144,2,1992-11-15,-2,0,"clt",-3
"12","Sun","November 22","L","","4-7",FALSE,"Pittsburgh Steelers",14,30,16,329,258,71,3,20,362,109,253,2,1992-11-22,-1,0,"clt",-16
"13","Sun","November 29","W","OT","5-7",TRUE,"Buffalo Bills",16,13,22,412,305,107,1,16,312,176,136,2,1992-11-29,1,1,"clt",3
"14","Sun","December 6","W","","6-7",FALSE,"New England Patriots",6,0,13,265,200,65,2,9,94,23,71,0,1992-12-06,-2,1,"clt",6
"15","Sun","December 13","W","","7-7",FALSE,"New York Jets",10,6,15,284,220,64,2,15,246,142,104,5,1992-12-13,3,1,"clt",4
"16","Sun","December 20","W","","8-7",TRUE,"Phoenix Cardinals",16,13,21,366,319,47,2,18,290,131,159,3,1992-12-20,1,1,"clt",3
"17","Sun","December 27","W","","9-7",FALSE,"Cincinnati Bengals",21,17,18,298,206,92,0,18,294,97,197,1,1992-12-27,1,1,"clt",4
"1","Sun","September 5","L","","0-1",TRUE,"Miami Dolphins",20,24,16,274,232,42,3,19,355,236,119,2,1993-09-05,-1,0,"clt",-4
"2","Sun","September 12","W","","1-1",FALSE,"Cincinnati Bengals",9,6,17,332,212,120,3,16,269,141,128,1,1993-09-12,-2,1,"clt",3
"4","Sun","September 26","W","","2-1",TRUE,"Cleveland Browns",23,10,21,357,260,97,0,13,253,153,100,2,1993-09-26,2,1,"clt",13
"5","Sun","October 3","L","","2-2",FALSE,"Denver Broncos",13,35,16,271,160,111,2,26,454,258,196,2,1993-10-03,0,0,"clt",-22
"6","Sun","October 10","L","","2-3",TRUE,"Dallas Cowboys",3,27,19,361,235,126,5,24,374,231,143,1,1993-10-10,-4,0,"clt",-24
"8","Sun","October 24","L","","2-4",FALSE,"Miami Dolphins",27,41,24,322,234,88,4,18,366,195,171,2,1993-10-24,-2,0,"clt",-14
"9","Sun","October 31","W","","3-4",TRUE,"New England Patriots",9,6,14,268,179,89,0,23,363,276,87,3,1993-10-31,3,1,"clt",3
"10","Sun","November 7","L","","3-5",FALSE,"Washington Redskins",24,30,21,405,356,49,3,16,275,166,109,0,1993-11-07,-3,0,"clt",-6
"11","Sun","November 14","L","","3-6",TRUE,"New York Jets",17,31,15,215,123,92,1,27,458,256,202,1,1993-11-14,0,0,"clt",-14
"12","Sun","November 21","L","","3-7",FALSE,"Buffalo Bills",9,23,21,365,252,113,2,21,403,268,135,2,1993-11-21,0,0,"clt",-14
"13","Mon","November 29","L","","3-8",TRUE,"San Diego Chargers",0,31,16,262,207,55,3,31,474,227,247,0,1993-11-29,-3,0,"clt",-31
"14","Sun","December 5","W","","4-8",FALSE,"New York Jets",9,6,7,169,102,67,1,15,267,145,122,3,1993-12-05,2,1,"clt",3
"15","Sun","December 12","L","","4-9",FALSE,"New York Giants",6,20,14,305,250,55,0,19,290,85,205,0,1993-12-12,0,0,"clt",-14
"16","Sun","December 19","L","","4-10",TRUE,"Philadelphia Eagles",10,20,16,261,230,31,3,23,340,189,151,1,1993-12-19,-2,0,"clt",-10
"17","Sun","December 26","L","","4-11",FALSE,"New England Patriots",0,38,7,136,99,37,1,24,400,143,257,0,1993-12-26,-1,0,"clt",-38
"18","Sun","January 2","L","","4-12",TRUE,"Buffalo Bills",10,30,25,402,286,116,4,19,297,148,149,1,1994-01-02,-3,0,"clt",-20
"1","Sun","September 4","W","","1-0",TRUE,"Houston Oilers",45,21,19,288,106,182,2,26,374,295,79,3,1994-09-04,1,1,"clt",24
"2","Sun","September 11","L","","1-1",FALSE,"Tampa Bay Buccaneers",10,24,20,364,201,163,1,13,367,313,54,0,1994-09-11,-1,0,"clt",-14
"3","Sun","September 18","L","","1-2",FALSE,"Pittsburgh Steelers",21,31,10,175,102,73,1,32,500,239,261,2,1994-09-18,1,0,"clt",-10
"4","Sun","September 25","L","","1-3",TRUE,"Cleveland Browns",14,21,18,335,189,146,1,17,376,257,119,1,1994-09-25,0,0,"clt",-7
"5","Sun","October 2","W","","2-3",TRUE,"Seattle Seahawks",17,15,14,287,168,119,1,17,276,174,102,1,1994-10-02,0,1,"clt",2
"6","Sun","October 9","L","","2-4",FALSE,"New York Jets",6,16,10,231,90,141,4,14,250,100,150,1,1994-10-09,-3,0,"clt",-10
"7","Sun","October 16","W","","3-4",FALSE,"Buffalo Bills",27,17,20,325,231,94,0,22,329,250,79,2,1994-10-16,2,1,"clt",10
"8","Sun","October 23","L","","3-5",TRUE,"Washington Redskins",27,41,20,381,272,109,3,20,326,226,100,0,1994-10-23,-3,0,"clt",-14
"9","Sun","October 30","W","","4-5",TRUE,"New York Jets",28,25,22,330,151,179,5,14,256,199,57,1,1994-10-30,-4,1,"clt",3
"10","Sun","November 6","L","","4-6",FALSE,"Miami Dolphins",21,22,17,213,108,105,1,25,372,254,118,2,1994-11-06,1,0,"clt",-1
"12","Sun","November 20","W","","5-6",FALSE,"Cincinnati Bengals",17,13,15,237,165,72,0,16,353,250,103,2,1994-11-20,2,1,"clt",4
"13","Sun","November 27","L","","5-7",TRUE,"New England Patriots",10,12,15,290,158,132,2,19,336,257,79,1,1994-11-27,-1,0,"clt",-2
"14","Sun","December 4","W","","6-7",FALSE,"Seattle Seahawks",31,19,14,288,105,183,4,15,238,131,107,5,1994-12-04,1,1,"clt",12
"15","Sun","December 11","L","","6-8",FALSE,"New England Patriots",13,28,13,212,138,74,4,24,361,277,84,5,1994-12-11,1,0,"clt",-15
"16","Sun","December 18","W","","7-8",TRUE,"Miami Dolphins",10,6,12,212,69,143,0,17,311,214,97,0,1994-12-18,0,1,"clt",4
"17","Sat","December 24","W","","8-8",TRUE,"Buffalo Bills",10,9,13,245,100,145,2,20,300,243,57,2,1994-12-24,0,1,"clt",1
"1","Sun","September 3","L","OT","0-1",TRUE,"Cincinnati Bengals",21,24,24,390,246,144,3,18,336,249,87,1,1995-09-03,-2,0,"clt",-3
"2","Sun","September 10","W","OT","1-1",FALSE,"New York Jets",27,24,25,361,239,122,3,21,344,198,146,3,1995-09-10,0,1,"clt",3
"3","Sun","September 17","L","","1-2",FALSE,"Buffalo Bills",14,20,17,296,205,91,1,17,261,201,60,1,1995-09-17,0,0,"clt",-6
"5","Sun","October 1","W","","2-2",TRUE,"St. Louis Rams",21,18,16,381,146,235,2,16,342,305,37,3,1995-10-01,1,1,"clt",3
"6","Sun","October 8","W","OT","3-2",FALSE,"Miami Dolphins",27,24,22,419,310,109,1,26,343,195,148,0,1995-10-08,-1,1,"clt",3
"7","Sun","October 15","W","","4-2",TRUE,"San Francisco 49ers",18,17,14,257,169,88,1,21,269,207,62,2,1995-10-15,1,1,"clt",1
"8","Sun","October 22","L","","4-3",FALSE,"Oakland Raiders",17,30,13,254,163,91,2,18,396,322,74,2,1995-10-22,0,0,"clt",-13
"9","Sun","October 29","W","","5-3",TRUE,"New York Jets",17,10,10,114,62,52,0,19,241,140,101,1,1995-10-29,1,1,"clt",7
"10","Sun","November 5","L","","5-4",TRUE,"Buffalo Bills",10,16,16,319,219,100,3,12,324,244,80,0,1995-11-05,-3,0,"clt",-6
"11","Sun","November 12","L","","5-5",FALSE,"New Orleans Saints",14,17,15,300,180,120,1,18,294,225,69,1,1995-11-12,0,0,"clt",-3
"12","Sun","November 19","W","","6-5",FALSE,"New England Patriots",24,10,18,370,232,138,1,14,202,151,51,2,1995-11-19,1,1,"clt",14
"13","Sun","November 26","W","","7-5",TRUE,"Miami Dolphins",36,28,21,352,159,193,0,24,338,231,107,2,1995-11-26,2,1,"clt",8
"14","Sun","December 3","L","","7-6",FALSE,"Carolina Panthers",10,13,12,200,135,65,2,12,255,170,85,2,1995-12-03,0,0,"clt",-3
"15","Sun","December 10","W","","8-6",FALSE,"Jacksonville Jaguars",41,31,15,219,128,91,0,27,424,298,126,2,1995-12-10,2,1,"clt",10
"16","Sun","December 17","L","","8-7",TRUE,"San Diego Chargers",24,27,24,365,276,89,1,26,379,265,114,1,1995-12-17,0,0,"clt",-3
"17","Sat","December 23","W","","9-7",TRUE,"New England Patriots",10,7,19,322,195,127,1,15,279,169,110,3,1995-12-23,2,1,"clt",3
"WildCard","Sun","December 31","W","","10-7",FALSE,"San Diego Chargers",35,20,19,333,155,178,1,27,429,284,145,4,1995-12-31,3,1,"clt",15
"Division","Sun","January 7","W","","11-7",FALSE,"Kansas City Chiefs",10,7,16,249,102,147,1,15,281,152,129,4,1996-01-07,3,1,"clt",3
"ConfChamp","Sun","January 14","L","","11-8",FALSE,"Pittsburgh Steelers",16,20,16,328,245,83,0,21,285,205,80,1,1996-01-14,1,0,"clt",-4
"1","Sun","September 1","W","","1-0",TRUE,"Arizona Cardinals",20,13,19,312,238,74,1,20,310,226,84,0,1996-09-01,-1,1,"clt",7
"2","Sun","September 8","W","","2-0",FALSE,"New York Jets",21,7,17,291,225,66,1,21,359,290,69,2,1996-09-08,1,1,"clt",14
"3","Sun","September 15","W","","3-0",FALSE,"Dallas Cowboys",25,24,18,321,218,103,2,18,295,184,111,1,1996-09-15,-1,1,"clt",1
"4","Mon","September 23","W","","4-0",TRUE,"Miami Dolphins",10,6,20,277,106,171,1,12,190,162,28,0,1996-09-23,-1,1,"clt",4
"6","Sun","October 6","L","OT","4-1",FALSE,"Buffalo Bills",13,16,16,249,163,86,0,20,412,299,113,1,1996-10-06,1,0,"clt",-3
"7","Sun","October 13","W","","5-1",TRUE,"Baltimore Ravens",26,21,15,255,132,123,0,20,325,213,112,1,1996-10-13,1,1,"clt",5
"8","Sun","October 20","L","","5-2",TRUE,"New England Patriots",9,27,27,364,319,45,4,15,222,142,80,2,1996-10-20,-2,0,"clt",-18
"9","Sun","October 27","L","","5-3",FALSE,"Washington Redskins",16,31,18,298,198,100,1,25,388,173,215,1,1996-10-27,0,0,"clt",-15
"10","Sun","November 3","L","","5-4",TRUE,"San Diego Chargers",19,26,22,264,173,91,5,14,312,237,75,0,1996-11-03,-5,0,"clt",-7
"11","Sun","November 10","L","","5-5",FALSE,"Miami Dolphins",13,37,15,293,260,33,2,19,307,193,114,0,1996-11-10,-2,0,"clt",-24
"12","Sun","November 17","W","","6-5",TRUE,"New York Jets",34,29,14,303,151,152,3,21,419,332,87,5,1996-11-17,2,1,"clt",5
"13","Sun","November 24","L","","6-6",FALSE,"New England Patriots",13,27,15,291,247,44,2,25,429,234,195,0,1996-11-24,-2,0,"clt",-14
"14","Sun","December 1","W","OT","7-6",TRUE,"Buffalo Bills",13,10,18,288,203,85,0,11,307,183,124,3,1996-12-01,3,1,"clt",3
"15","Thu","December 5","W","","8-6",TRUE,"Philadelphia Eagles",37,10,19,361,210,151,0,18,330,254,76,3,1996-12-05,3,1,"clt",27
"16","Sun","December 15","W","","9-6",FALSE,"Kansas City Chiefs",24,19,19,311,222,89,0,20,357,237,120,1,1996-12-15,1,1,"clt",5
"17","Sun","December 22","L","","9-7",FALSE,"Cincinnati Bengals",24,31,16,266,231,35,2,26,441,284,157,3,1996-12-22,1,0,"clt",-7
"WildCard","Sun","December 29","L","","9-8",FALSE,"Pittsburgh Steelers",14,42,8,146,105,41,2,24,407,176,231,3,1996-12-29,1,0,"clt",-28
"1","Sun","August 31","L","","0-1",FALSE,"Miami Dolphins",10,16,18,298,168,130,3,11,202,105,97,1,1997-08-31,-2,0,"clt",-6
"2","Sun","September 7","L","","0-2",TRUE,"New England Patriots",6,31,19,255,214,41,1,15,382,260,122,0,1997-09-07,-1,0,"clt",-25
"3","Sun","September 14","L","","0-3",TRUE,"Seattle Seahawks",3,31,11,118,23,95,0,27,423,270,153,1,1997-09-14,1,0,"clt",-28
"4","Sun","September 21","L","","0-4",FALSE,"Buffalo Bills",35,37,17,322,198,124,1,25,393,230,163,5,1997-09-21,4,0,"clt",-2
"6","Sun","October 5","L","","0-5",TRUE,"New York Jets",12,16,20,310,265,45,3,13,206,128,78,1,1997-10-05,-2,0,"clt",-4
"7","Sun","October 12","L","","0-6",FALSE,"Pittsburgh Steelers",22,24,18,270,191,79,2,17,327,142,185,6,1997-10-12,4,0,"clt",-2
"8","Mon","October 20","L","","0-7",TRUE,"Buffalo Bills",6,9,15,238,144,94,0,16,246,156,90,0,1997-10-20,0,0,"clt",-3
"9","Sun","October 26","L","","0-8",FALSE,"San Diego Chargers",19,35,14,250,219,31,2,24,424,222,202,0,1997-10-26,-2,0,"clt",-16
"10","Sun","November 2","L","","0-9",TRUE,"Tampa Bay Buccaneers",28,31,23,359,212,147,3,18,234,150,84,1,1997-11-02,-2,0,"clt",-3
"11","Sun","November 9","L","","0-10",TRUE,"Cincinnati Bengals",13,28,22,341,191,150,4,17,273,129,144,1,1997-11-09,-3,0,"clt",-15
"12","Sun","November 16","W","","1-10",TRUE,"Green Bay Packers",41,38,26,467,320,147,1,20,441,334,107,3,1997-11-16,2,1,"clt",3
"13","Sun","November 23","L","","1-11",FALSE,"Detroit Lions",10,32,12,173,120,53,1,21,391,142,249,0,1997-11-23,-1,0,"clt",-22
"14","Sun","November 30","L","","1-12",FALSE,"New England Patriots",17,20,23,403,285,118,1,17,258,187,71,0,1997-11-30,-1,0,"clt",-3
"15","Sun","December 7","W","","2-12",FALSE,"New York Jets",22,14,19,366,173,193,0,12,126,93,33,1,1997-12-07,1,1,"clt",8
"16","Sun","December 14","W","","3-12",TRUE,"Miami Dolphins",41,0,23,401,253,148,1,10,183,107,76,2,1997-12-14,1,1,"clt",41
"17","Sun","December 21","L","","3-13",FALSE,"Minnesota Vikings",28,39,21,298,166,132,5,17,345,165,180,3,1997-12-21,-2,0,"clt",-11
"1","Sun","September 6","L","","0-1",TRUE,"Miami Dolphins",15,24,24,337,273,64,4,15,272,135,137,1,1998-09-06,-3,0,"clt",-9
"2","Sun","September 13","L","","0-2",FALSE,"New England Patriots",6,29,20,309,173,136,4,15,321,218,103,0,1998-09-13,-4,0,"clt",-23
"3","Sun","September 20","L","","0-3",FALSE,"New York Jets",6,44,21,310,190,120,2,28,505,203,302,2,1998-09-20,0,0,"clt",-38
"4","Sun","September 27","L","OT","0-4",TRUE,"New Orleans Saints",13,19,16,357,292,65,3,14,320,137,183,1,1998-09-27,-2,0,"clt",-6
"5","Sun","October 4","W","","1-4",TRUE,"San Diego Chargers",17,12,11,192,137,55,1,17,295,143,152,3,1998-10-04,2,1,"clt",5
"6","Sun","October 11","L","","1-5",TRUE,"Buffalo Bills",24,31,21,341,235,106,2,24,381,205,176,0,1998-10-11,-2,0,"clt",-7
"7","Sun","October 18","L","","1-6",FALSE,"San Francisco 49ers",31,34,15,336,231,105,0,36,448,321,127,2,1998-10-18,2,0,"clt",-3
"9","Sun","November 1","L","","1-7",TRUE,"New England Patriots",16,21,18,310,278,32,2,20,370,293,77,1,1998-11-01,-1,0,"clt",-5
"10","Sun","November 8","L","","1-8",FALSE,"Miami Dolphins",14,27,21,254,140,114,2,20,359,207,152,2,1998-11-08,0,0,"clt",-13
"11","Sun","November 15","W","","2-8",TRUE,"New York Jets",24,23,23,357,267,90,2,20,369,212,157,2,1998-11-15,0,1,"clt",1
"12","Sun","November 22","L","","2-9",FALSE,"Buffalo Bills",11,34,14,250,164,86,3,25,402,215,187,1,1998-11-22,-2,0,"clt",-23
"13","Sun","November 29","L","","2-10",FALSE,"Baltimore Ravens",31,38,26,540,344,196,1,18,314,198,116,0,1998-11-29,-1,0,"clt",-7
"14","Sun","December 6","L","","2-11",FALSE,"Atlanta Falcons",21,28,17,244,159,85,3,27,394,257,137,2,1998-12-06,-1,0,"clt",-7
"15","Sun","December 13","W","","3-11",TRUE,"Cincinnati Bengals",39,26,21,338,210,128,0,22,378,223,155,0,1998-12-13,0,1,"clt",13
"16","Sun","December 20","L","","3-12",FALSE,"Seattle Seahawks",23,27,18,362,330,32,2,23,376,150,226,0,1998-12-20,-2,0,"clt",-4
"17","Sun","December 27","L","","3-13",TRUE,"Carolina Panthers",19,27,12,279,207,72,2,17,332,149,183,2,1998-12-27,0,0,"clt",-8
"1","Sun","September 12","W","","1-0",TRUE,"Buffalo Bills",31,14,20,393,284,109,3,19,321,274,47,3,1999-09-12,0,1,"clt",17
"2","Sun","September 19","L","","1-1",FALSE,"New England Patriots",28,31,23,344,223,121,4,26,400,292,108,1,1999-09-19,-3,0,"clt",-3
"3","Sun","September 26","W","","2-1",FALSE,"San Diego Chargers",27,19,26,468,404,64,1,16,274,179,95,1,1999-09-26,0,1,"clt",8
"5","Sun","October 10","L","","2-2",TRUE,"Miami Dolphins",31,34,18,332,264,68,2,19,469,393,76,0,1999-10-10,-2,0,"clt",-3
"6","Sun","October 17","W","","3-2",FALSE,"New York Jets",16,13,19,318,210,108,1,16,281,125,156,2,1999-10-17,1,1,"clt",3
"7","Sun","October 24","W","","4-2",TRUE,"Cincinnati Bengals",31,10,18,335,278,57,1,12,254,149,105,0,1999-10-24,-1,1,"clt",21
"8","Sun","October 31","W","","5-2",TRUE,"Dallas Cowboys",34,24,23,419,300,119,0,18,232,129,103,1,1999-10-31,1,1,"clt",10
"9","Sun","November 7","W","","6-2",TRUE,"Kansas City Chiefs",25,17,21,375,256,119,2,19,319,211,108,1,1999-11-07,-1,1,"clt",8
"10","Sun","November 14","W","","7-2",FALSE,"New York Giants",27,19,13,342,237,105,1,26,384,237,147,4,1999-11-14,3,1,"clt",8
"11","Sun","November 21","W","","8-2",FALSE,"Philadelphia Eagles",44,17,22,455,255,200,3,13,212,118,94,5,1999-11-21,2,1,"clt",27
"12","Sun","November 28","W","","9-2",TRUE,"New York Jets",13,6,23,287,187,100,3,14,214,88,126,0,1999-11-28,-3,1,"clt",7
"13","Sun","December 5","W","","10-2",FALSE,"Miami Dolphins",37,34,21,370,241,129,2,22,368,299,69,3,1999-12-05,1,1,"clt",3
"14","Sun","December 12","W","","11-2",TRUE,"New England Patriots",20,15,15,287,178,109,1,23,401,344,57,1,1999-12-12,0,1,"clt",5
"15","Sun","December 19","W","","12-2",TRUE,"Washington Redskins",24,21,24,379,291,88,3,21,359,208,151,0,1999-12-19,-3,1,"clt",3
"16","Sun","December 26","W","","13-2",FALSE,"Cleveland Browns",29,28,28,396,276,120,0,17,314,173,141,1,1999-12-26,1,1,"clt",1
"17","Sun","January 2","L","","13-3",FALSE,"Buffalo Bills",6,31,13,226,182,44,1,23,419,287,132,0,2000-01-02,-1,0,"clt",-25
"Division","Sun","January 16","L","","13-4",TRUE,"Tennessee Titans",16,19,19,305,227,78,0,13,309,112,197,1,2000-01-16,1,0,"clt",-3
"1","Sun","September 3","W","","1-0",FALSE,"Kansas City Chiefs",27,14,20,386,267,119,2,17,280,206,74,1,2000-09-03,-1,1,"clt",13
"2","Sun","September 10","L","","1-1",TRUE,"Oakland Raiders",31,38,28,462,351,111,3,21,359,207,152,0,2000-09-10,-3,0,"clt",-7
"4","Mon","September 25","W","","2-1",TRUE,"Jacksonville Jaguars",43,14,21,533,440,93,1,18,286,189,97,2,2000-09-25,1,1,"clt",29
"5","Sun","October 1","W","","3-1",FALSE,"Buffalo Bills",18,16,14,265,184,81,1,21,385,215,170,0,2000-10-01,-1,1,"clt",2
"6","Sun","October 8","L","","3-2",FALSE,"New England Patriots",16,24,27,408,324,84,3,19,301,183,118,0,2000-10-08,-3,0,"clt",-8
"7","Sun","October 15","W","","4-2",FALSE,"Seattle Seahawks",37,24,28,499,280,219,1,21,317,252,65,3,2000-10-15,2,1,"clt",13
"8","Sun","October 22","W","","5-2",TRUE,"New England Patriots",30,23,20,398,268,130,1,24,386,231,155,1,2000-10-22,0,1,"clt",7
"9","Sun","October 29","W","","6-2",TRUE,"Detroit Lions",30,18,24,420,281,139,5,18,328,174,154,4,2000-10-29,-1,1,"clt",12
"10","Sun","November 5","L","","6-3",FALSE,"Chicago Bears",24,27,20,371,281,90,2,20,370,227,143,0,2000-11-05,-2,0,"clt",-3
"11","Sun","November 12","W","","7-3",TRUE,"New York Jets",23,15,25,358,210,148,1,22,367,271,96,2,2000-11-12,1,1,"clt",8
"12","Sun","November 19","L","","7-4",FALSE,"Green Bay Packers",24,26,25,338,267,71,2,25,432,287,145,1,2000-11-19,-1,0,"clt",-2
"13","Sun","November 26","L","","7-5",TRUE,"Miami Dolphins",14,17,19,353,209,144,1,17,253,171,82,0,2000-11-26,-1,0,"clt",-3
"14","Sun","December 3","L","","7-6",FALSE,"New York Jets",17,27,21,375,326,49,3,26,491,280,211,1,2000-12-03,-2,0,"clt",-10
"15","Mon","December 11","W","","8-6",TRUE,"Buffalo Bills",44,20,20,237,116,121,0,16,294,228,66,3,2000-12-11,3,1,"clt",24
"16","Sun","December 17","W","","9-6",FALSE,"Miami Dolphins",20,13,20,327,195,132,2,14,272,132,140,3,2000-12-17,1,1,"clt",7
"17","Sun","December 24","W","","10-6",TRUE,"Minnesota Vikings",31,10,25,411,283,128,1,11,236,169,67,1,2000-12-24,0,1,"clt",21
"WildCard","Sat","December 30","L","OT","10-7",FALSE,"Miami Dolphins",17,23,14,293,194,99,0,26,434,176,258,3,2000-12-30,3,0,"clt",-6
"1","Sun","September 9","W","","1-0",FALSE,"New York Jets",45,24,22,376,222,154,3,17,330,192,138,2,2001-09-09,-1,1,"clt",21
"2","Sun","September 23","W","","2-0",TRUE,"Buffalo Bills",42,26,28,555,418,137,3,21,374,229,145,1,2001-09-23,-2,1,"clt",16
"3","Sun","September 30","L","","2-1",FALSE,"New England Patriots",13,44,20,322,240,82,4,19,336,159,177,0,2001-09-30,-4,0,"clt",-31
"5","Sun","October 14","L","","2-2",TRUE,"Oakland Raiders",18,23,26,352,234,118,2,18,317,216,101,1,2001-10-14,-1,0,"clt",-5
"6","Sun","October 21","L","","2-3",TRUE,"New England Patriots",17,38,28,484,305,179,2,19,385,262,123,0,2001-10-21,-2,0,"clt",-21
"7","Thu","October 25","W","","3-3",FALSE,"Kansas City Chiefs",35,28,17,373,179,194,1,25,415,314,101,3,2001-10-25,2,1,"clt",7
"8","Sun","November 4","W","","4-3",FALSE,"Buffalo Bills",30,14,17,305,161,144,1,14,232,148,84,2,2001-11-04,1,1,"clt",16
"9","Sun","November 11","L","","4-4",TRUE,"Miami Dolphins",24,27,19,289,224,65,3,14,375,241,134,3,2001-11-11,0,0,"clt",-3
"10","Sun","November 18","L","","4-5",FALSE,"New Orleans Saints",20,34,18,339,262,77,1,25,378,221,157,0,2001-11-18,-1,0,"clt",-14
"11","Sun","November 25","L","","4-6",TRUE,"San Francisco 49ers",21,40,30,491,364,127,5,16,340,169,171,1,2001-11-25,-4,0,"clt",-19
"12","Sun","December 2","L","","4-7",FALSE,"Baltimore Ravens",27,39,16,314,263,51,4,20,398,268,130,4,2001-12-02,0,0,"clt",-12
"13","Mon","December 10","L","","4-8",FALSE,"Miami Dolphins",6,41,16,254,170,84,4,24,366,183,183,0,2001-12-10,-4,0,"clt",-35
"14","Sun","December 16","W","","5-8",TRUE,"Atlanta Falcons",41,27,29,512,325,187,1,21,316,250,66,1,2001-12-16,0,1,"clt",14
"15","Sun","December 23","L","","5-9",TRUE,"New York Jets",28,29,18,393,260,133,2,26,451,285,166,2,2001-12-23,0,0,"clt",-1
"16","Sun","December 30","L","","5-10",FALSE,"St. Louis Rams",17,42,17,261,178,83,1,27,483,359,124,1,2001-12-30,0,0,"clt",-25
"17","Sun","January 6","W","","6-10",TRUE,"Denver Broncos",29,10,22,335,184,151,1,17,219,104,115,4,2002-01-06,3,1,"clt",19
"1","Sun","September 8","W","","1-0",FALSE,"Jacksonville Jaguars",28,25,18,307,203,104,2,19,343,225,118,2,2002-09-08,0,1,"clt",3
"2","Sun","September 15","L","","1-1",TRUE,"Miami Dolphins",13,21,29,432,289,143,3,17,342,179,163,1,2002-09-15,-2,0,"clt",-8
"3","Sun","September 22","W","","2-1",FALSE,"Houston Texans",23,3,16,339,251,88,2,10,204,78,126,2,2002-09-22,0,1,"clt",20
"5","Sun","October 6","W","","3-1",TRUE,"Cincinnati Bengals",28,21,19,311,224,87,1,23,410,237,173,4,2002-10-06,3,1,"clt",7
"6","Sun","October 13","W","","4-1",TRUE,"Baltimore Ravens",22,20,19,317,257,60,1,15,244,139,105,3,2002-10-13,2,1,"clt",2
"7","Mon","October 21","L","","4-2",FALSE,"Pittsburgh Steelers",10,28,23,367,295,72,3,22,364,182,182,1,2002-10-21,-2,0,"clt",-18
"8","Sun","October 27","L","","4-3",FALSE,"Washington Redskins",21,26,18,258,195,63,3,23,370,205,165,1,2002-10-27,-2,0,"clt",-5
"9","Sun","November 3","L","","4-4",TRUE,"Tennessee Titans",15,23,25,378,298,80,3,13,198,77,121,0,2002-11-03,-3,0,"clt",-8
"10","Sun","November 10","W","","5-4",FALSE,"Philadelphia Eagles",35,13,18,446,319,127,1,21,374,269,105,2,2002-11-10,1,1,"clt",22
"11","Sun","November 17","W","","6-4",TRUE,"Dallas Cowboys",20,3,20,362,252,110,1,11,178,94,84,2,2002-11-17,1,1,"clt",17
"12","Sun","November 24","W","OT","7-4",FALSE,"Denver Broncos",23,20,26,344,216,128,3,15,285,172,113,2,2002-11-24,-1,1,"clt",3
"13","Sun","December 1","W","","8-4",TRUE,"Houston Texans",19,3,13,278,190,88,1,10,165,100,65,2,2002-12-01,1,1,"clt",16
"14","Sun","December 8","L","","8-5",FALSE,"Tennessee Titans",17,27,22,389,297,92,3,18,348,229,119,1,2002-12-08,-2,0,"clt",-10
"15","Sun","December 15","W","","9-5",FALSE,"Cleveland Browns",28,23,20,417,274,143,2,18,349,253,96,0,2002-12-15,-2,1,"clt",5
"16","Sun","December 22","L","","9-6",TRUE,"New York Giants",27,44,20,399,349,50,2,24,469,366,103,3,2002-12-22,1,0,"clt",-17
"17","Sun","December 29","W","","10-6",TRUE,"Jacksonville Jaguars",20,13,18,272,146,126,1,20,266,112,154,1,2002-12-29,0,1,"clt",7
"WildCard","Sat","January 4","L","","10-7",FALSE,"New York Jets",0,41,10,176,124,52,3,26,396,216,180,0,2003-01-04,-3,0,"clt",-41
"1","Sun","September 7","W","","1-0",FALSE,"Cleveland Browns",9,6,18,271,204,67,2,18,280,182,98,2,2003-09-07,0,1,"clt",3
"2","Sun","September 14","W","","2-0",TRUE,"Tennessee Titans",33,7,20,291,164,127,0,14,236,183,53,2,2003-09-14,2,1,"clt",26
"3","Sun","September 21","W","","3-0",TRUE,"Jacksonville Jaguars",23,13,17,289,216,73,1,15,266,114,152,1,2003-09-21,0,1,"clt",10
"4","Sun","September 28","W","","4-0",FALSE,"New Orleans Saints",55,21,20,418,318,100,0,20,363,208,155,4,2003-09-28,4,1,"clt",34
"5","Mon","October 6","W","OT","5-0",FALSE,"Tampa Bay Buccaneers",38,35,24,455,381,74,2,25,457,318,139,1,2003-10-06,-1,1,"clt",3
"6","Sun","October 12","L","OT","5-1",TRUE,"Carolina Panthers",20,23,20,369,293,76,3,17,341,152,189,2,2003-10-12,-1,0,"clt",-3
"8","Sun","October 26","W","","6-1",TRUE,"Houston Texans",30,21,23,391,269,122,1,18,270,139,131,2,2003-10-26,1,1,"clt",9
"9","Sun","November 2","W","","7-1",FALSE,"Miami Dolphins",23,17,23,356,241,115,2,12,239,192,47,2,2003-11-02,0,1,"clt",6
"10","Sun","November 9","L","","7-2",FALSE,"Jacksonville Jaguars",23,28,20,394,347,47,2,20,353,179,174,2,2003-11-09,0,0,"clt",-5
"11","Sun","November 16","W","","8-2",TRUE,"New York Jets",38,31,30,538,393,145,0,12,324,192,132,0,2003-11-16,0,1,"clt",7
"12","Sun","November 23","W","","9-2",FALSE,"Buffalo Bills",17,14,21,326,223,103,1,16,228,118,110,1,2003-11-23,0,1,"clt",3
"13","Sun","November 30","L","","9-3",TRUE,"New England Patriots",34,38,26,370,272,98,2,21,282,226,56,3,2003-11-30,1,0,"clt",-4
"14","Sun","December 7","W","","10-3",FALSE,"Tennessee Titans",29,27,21,340,224,116,0,23,327,234,93,4,2003-12-07,4,1,"clt",2
"15","Sun","December 14","W","","11-3",TRUE,"Atlanta Falcons",38,7,27,465,287,178,2,12,154,29,125,2,2003-12-14,0,1,"clt",31
"16","Sun","December 21","L","","11-4",TRUE,"Denver Broncos",17,31,11,183,136,47,0,26,465,238,227,1,2003-12-21,1,0,"clt",-14
"17","Sun","December 28","W","","12-4",FALSE,"Houston Texans",20,17,27,418,211,207,2,10,204,105,99,1,2003-12-28,-1,1,"clt",3
"WildCard","Sun","January 4","W","","13-4",TRUE,"Denver Broncos",41,10,23,479,394,85,1,20,322,176,146,3,2004-01-04,2,1,"clt",31
"Division","Sun","January 11","W","","14-4",FALSE,"Kansas City Chiefs",38,31,27,434,292,142,0,24,408,212,196,1,2004-01-11,1,1,"clt",7
"ConfChamp","Sun","January 18","L","","14-5",FALSE,"New England Patriots",14,24,21,306,208,98,5,20,349,237,112,2,2004-01-18,-3,0,"clt",-10
"1","Thu","September 9","L","","0-1",FALSE,"New England Patriots",24,27,28,446,244,202,3,22,402,320,82,2,2004-09-09,-1,0,"clt",-3
"2","Sun","September 19","W","","1-1",FALSE,"Tennessee Titans",31,17,27,373,244,129,1,25,389,236,153,2,2004-09-19,1,1,"clt",14
"3","Sun","September 26","W","","2-1",TRUE,"Green Bay Packers",45,31,26,453,393,60,0,24,459,385,74,2,2004-09-26,2,1,"clt",14
"4","Sun","October 3","W","","3-1",FALSE,"Jacksonville Jaguars",24,17,23,337,220,117,1,23,408,311,97,1,2004-10-03,0,1,"clt",7
"5","Sun","October 10","W","","4-1",TRUE,"Oakland Raiders",35,14,25,338,188,150,1,18,269,216,53,3,2004-10-10,2,1,"clt",21
"7","Sun","October 24","L","","4-2",TRUE,"Jacksonville Jaguars",24,27,23,446,359,87,2,20,414,286,128,2,2004-10-24,0,0,"clt",-3
"8","Sun","October 31","L","","4-3",FALSE,"Kansas City Chiefs",35,45,23,505,472,33,1,33,590,387,203,2,2004-10-31,1,0,"clt",-10
"9","Mon","November 8","W","","5-3",TRUE,"Minnesota Vikings",31,28,26,408,264,144,0,15,292,154,138,1,2004-11-08,1,1,"clt",3
"10","Sun","November 14","W","","6-3",TRUE,"Houston Texans",49,14,17,398,312,86,2,20,302,170,132,4,2004-11-14,2,1,"clt",35
"11","Sun","November 21","W","","7-3",FALSE,"Chicago Bears",41,10,31,486,211,275,1,14,224,145,79,5,2004-11-21,4,1,"clt",31
"12","Thu","November 25","W","","8-3",FALSE,"Detroit Lions",41,9,24,356,243,113,0,19,386,218,168,5,2004-11-25,5,1,"clt",32
"13","Sun","December 5","W","","9-3",TRUE,"Tennessee Titans",51,24,29,567,417,150,3,17,340,225,115,2,2004-12-05,-1,1,"clt",27
"14","Sun","December 12","W","","10-3",FALSE,"Houston Texans",23,14,22,382,281,101,0,17,273,125,148,2,2004-12-12,2,1,"clt",9
"15","Sun","December 19","W","","11-3",TRUE,"Baltimore Ravens",20,10,17,316,249,67,0,19,354,194,160,2,2004-12-19,2,1,"clt",10
"16","Sun","December 26","W","OT","12-3",TRUE,"San Diego Chargers",34,31,30,464,360,104,1,22,374,281,93,1,2004-12-26,0,1,"clt",3
"17","Sun","January 2","L","","12-4",FALSE,"Denver Broncos",14,33,8,200,166,34,1,23,453,239,214,0,2005-01-02,-1,0,"clt",-19
"WildCard","Sun","January 9","W","","13-4",TRUE,"Denver Broncos",49,24,27,530,454,76,1,18,338,260,78,1,2005-01-09,0,1,"clt",25
"Division","Sun","January 16","L","","13-5",FALSE,"New England Patriots",3,20,18,276,230,46,3,21,325,115,210,0,2005-01-16,-3,0,"clt",-17
"1","Sun","September 11","W","","1-0",FALSE,"Baltimore Ravens",24,7,19,340,254,86,0,22,401,324,77,4,2005-09-11,4,1,"clt",17
"2","Sun","September 18","W","","2-0",TRUE,"Jacksonville Jaguars",10,3,18,268,122,146,1,12,303,175,128,0,2005-09-18,-1,1,"clt",7
"3","Sun","September 25","W","","3-0",TRUE,"Cleveland Browns",13,6,20,339,228,111,1,14,263,188,75,0,2005-09-25,-1,1,"clt",7
"4","Sun","October 2","W","","4-0",FALSE,"Tennessee Titans",31,10,22,364,264,100,0,18,313,204,109,1,2005-10-02,1,1,"clt",21
"5","Sun","October 9","W","","5-0",FALSE,"San Francisco 49ers",28,3,22,365,245,120,3,12,177,44,133,5,2005-10-09,2,1,"clt",25
"6","Mon","October 17","W","","6-0",TRUE,"St. Louis Rams",45,28,31,363,187,176,1,20,349,244,105,4,2005-10-17,3,1,"clt",17
"7","Sun","October 23","W","","7-0",FALSE,"Houston Texans",38,20,30,437,232,205,2,13,139,6,133,2,2005-10-23,0,1,"clt",18
"9","Mon","November 7","W","","8-0",FALSE,"New England Patriots",40,21,28,453,321,132,1,17,288,254,34,2,2005-11-07,1,1,"clt",19
"10","Sun","November 13","W","","9-0",TRUE,"Houston Texans",31,17,26,419,293,126,2,11,209,126,83,0,2005-11-13,-2,1,"clt",14
"11","Sun","November 20","W","","10-0",FALSE,"Cincinnati Bengals",45,37,28,451,359,92,1,23,492,328,164,1,2005-11-20,0,1,"clt",8
"12","Mon","November 28","W","","11-0",TRUE,"Pittsburgh Steelers",26,7,17,366,239,127,1,10,197,111,86,2,2005-11-28,1,1,"clt",19
"13","Sun","December 4","W","","12-0",TRUE,"Tennessee Titans",35,3,21,292,187,105,1,17,260,207,53,1,2005-12-04,0,1,"clt",32
"14","Sun","December 11","W","","13-0",FALSE,"Jacksonville Jaguars",26,18,25,399,300,99,0,18,324,250,74,3,2005-12-11,3,1,"clt",8
"15","Sun","December 18","L","","13-1",TRUE,"San Diego Chargers",17,26,21,338,314,24,3,18,453,247,206,4,2005-12-18,1,0,"clt",-9
"16","Sat","December 24","L","","13-2",FALSE,"Seattle Seahawks",13,28,20,387,344,43,1,21,332,159,173,0,2005-12-24,-1,0,"clt",-15
"17","Sun","January 1","W","","14-2",TRUE,"Arizona Cardinals",17,13,15,218,207,11,1,23,413,284,129,2,2006-01-01,1,1,"clt",4
"Division","Sun","January 15","L","","14-3",TRUE,"Pittsburgh Steelers",18,21,15,305,247,58,0,21,295,183,112,2,2006-01-15,2,0,"clt",-3
"1","Sun","September 10","W","","1-0",FALSE,"New York Giants",26,21,22,327,272,55,1,23,433,247,186,2,2006-09-10,1,1,"clt",5
"2","Sun","September 17","W","","2-0",TRUE,"Houston Texans",43,24,34,515,390,125,1,18,299,191,108,2,2006-09-17,1,1,"clt",19
"3","Sun","September 24","W","","3-0",TRUE,"Jacksonville Jaguars",21,14,14,272,209,63,0,20,297,106,191,2,2006-09-24,2,1,"clt",7
"4","Sun","October 1","W","","4-0",FALSE,"New York Jets",31,28,26,352,192,160,0,23,321,186,135,3,2006-10-01,3,1,"clt",3
"5","Sun","October 8","W","","5-0",TRUE,"Tennessee Titans",14,13,20,320,166,154,2,15,277,63,214,1,2006-10-08,-1,1,"clt",1
"7","Sun","October 22","W","","6-0",TRUE,"Washington Redskins",36,22,25,452,342,110,0,19,325,211,114,0,2006-10-22,0,1,"clt",14
"8","Sun","October 29","W","","7-0",FALSE,"Denver Broncos",34,31,23,437,345,92,0,24,396,169,227,1,2006-10-29,1,1,"clt",3
"9","Sun","November 5","W","","8-0",FALSE,"New England Patriots",27,20,24,354,301,53,2,24,349,201,148,5,2006-11-05,3,1,"clt",7
"10","Sun","November 12","W","","9-0",TRUE,"Buffalo Bills",17,16,26,384,236,148,2,10,162,51,111,0,2006-11-12,-2,1,"clt",1
"11","Sun","November 19","L","","9-1",FALSE,"Dallas Cowboys",14,21,22,335,247,88,4,24,342,225,117,2,2006-11-19,-2,0,"clt",-7
"12","Sun","November 26","W","","10-1",TRUE,"Philadelphia Eagles",45,21,27,420,183,237,1,20,300,151,149,3,2006-11-26,2,1,"clt",24
"13","Sun","December 3","L","","10-2",FALSE,"Tennessee Titans",17,20,20,451,351,100,2,21,382,163,219,2,2006-12-03,0,0,"clt",-3
"14","Sun","December 10","L","","10-3",FALSE,"Jacksonville Jaguars",17,44,23,339,305,34,1,23,447,72,375,1,2006-12-10,0,0,"clt",-27
"15","Mon","December 18","W","","11-3",TRUE,"Cincinnati Bengals",34,16,27,394,282,112,1,20,278,145,133,1,2006-12-18,0,1,"clt",18
"16","Sun","December 24","L","","11-4",FALSE,"Houston Texans",24,27,19,319,205,114,1,22,354,163,191,0,2006-12-24,-1,0,"clt",-3
"17","Sun","December 31","W","","12-4",TRUE,"Miami Dolphins",27,22,24,399,282,117,1,19,354,204,150,1,2006-12-31,0,1,"clt",5
"WildCard","Sat","January 6","W","","13-4",TRUE,"Kansas City Chiefs",23,8,28,435,247,188,3,7,126,82,44,3,2007-01-06,0,1,"clt",15
"Division","Sat","January 13","W","","14-4",FALSE,"Baltimore Ravens",15,6,15,261,161,100,2,13,244,161,83,4,2007-01-13,2,1,"clt",9
"ConfChamp","Sun","January 21","W","","15-4",TRUE,"New England Patriots",38,34,32,455,330,125,1,17,319,226,93,1,2007-01-21,0,1,"clt",4
"SuperBowl","Sun","February 4","W","","16-4",TRUE,"Chicago Bears",29,17,24,430,239,191,3,11,265,154,111,5,2007-02-04,2,1,"clt",12
"1","Thu","September 6","W","","1-0",TRUE,"New Orleans Saints",41,10,20,452,288,164,1,18,293,187,106,3,2007-09-06,2,1,"clt",31
"2","Sun","September 16","W","","2-0",FALSE,"Tennessee Titans",22,20,23,381,300,81,1,19,313,172,141,2,2007-09-16,1,1,"clt",2
"3","Sun","September 23","W","","3-0",FALSE,"Houston Texans",30,24,18,362,270,92,0,16,254,214,40,2,2007-09-23,2,1,"clt",6
"4","Sun","September 30","W","","4-0",TRUE,"Denver Broncos",38,20,30,419,193,226,0,22,354,131,223,2,2007-09-30,2,1,"clt",18
"5","Sun","October 7","W","","5-0",TRUE,"Tampa Bay Buccaneers",33,14,28,400,253,147,1,12,177,160,17,1,2007-10-07,0,1,"clt",19
"7","Mon","October 22","W","","6-0",FALSE,"Jacksonville Jaguars",29,7,24,384,243,141,1,18,226,109,117,3,2007-10-22,2,1,"clt",22
"8","Sun","October 28","W","","7-0",FALSE,"Carolina Panthers",31,7,23,395,264,131,1,20,293,185,108,3,2007-10-28,2,1,"clt",24
"9","Sun","November 4","L","","7-1",TRUE,"New England Patriots",20,24,23,329,210,119,2,21,342,237,105,2,2007-11-04,0,0,"clt",-4
"10","Sun","November 11","L","","7-2",FALSE,"San Diego Chargers",21,23,25,386,311,75,6,11,177,86,91,3,2007-11-11,-3,0,"clt",-2
"11","Sun","November 18","W","","8-2",TRUE,"Kansas City Chiefs",13,10,16,216,150,66,1,11,234,162,72,2,2007-11-18,1,1,"clt",3
"12","Thu","November 22","W","","9-2",FALSE,"Atlanta Falcons",31,13,26,365,247,118,1,13,250,138,112,2,2007-11-22,1,1,"clt",18
"13","Sun","December 2","W","","10-2",TRUE,"Jacksonville Jaguars",28,25,19,342,279,63,1,27,411,243,168,2,2007-12-02,1,1,"clt",3
"14","Sun","December 9","W","","11-2",FALSE,"Baltimore Ravens",44,20,16,334,275,59,0,19,243,145,98,5,2007-12-09,5,1,"clt",24
"15","Sun","December 16","W","","12-2",FALSE,"Oakland Raiders",21,14,20,322,264,58,1,18,253,104,149,0,2007-12-16,-1,1,"clt",7
"16","Sun","December 23","W","","13-2",TRUE,"Houston Texans",38,15,33,458,338,120,1,18,299,233,66,3,2007-12-23,2,1,"clt",23
"17","Sun","December 30","L","","13-3",TRUE,"Tennessee Titans",10,16,13,194,148,46,1,25,356,258,98,2,2007-12-30,1,0,"clt",-6
"Division","Sun","January 13","L","","13-4",TRUE,"San Diego Chargers",24,28,29,446,402,44,3,20,411,312,99,1,2008-01-13,-2,0,"clt",-4
"1","Sun","September 7","L","","0-1",TRUE,"Chicago Bears",13,29,23,293,240,53,1,17,319,136,183,0,2008-09-07,-1,0,"clt",-16
"2","Sun","September 14","W","","1-1",FALSE,"Minnesota Vikings",18,15,17,321,296,25,2,16,299,120,179,1,2008-09-14,-1,1,"clt",3
"3","Sun","September 21","L","","1-2",TRUE,"Jacksonville Jaguars",21,23,19,325,211,114,2,25,403,167,236,1,2008-09-21,-1,0,"clt",-2
"5","Sun","October 5","W","","2-2",FALSE,"Houston Texans",31,27,18,314,235,79,1,23,391,235,156,3,2008-10-05,2,1,"clt",4
"6","Sun","October 12","W","","3-2",TRUE,"Baltimore Ravens",31,3,17,334,258,76,0,16,260,209,51,5,2008-10-12,5,1,"clt",28
"7","Sun","October 19","L","","3-3",FALSE,"Green Bay Packers",14,34,21,302,229,73,2,24,302,186,116,0,2008-10-19,-2,0,"clt",-20
"8","Mon","October 27","L","","3-4",FALSE,"Tennessee Titans",21,31,19,317,223,94,2,23,281,193,88,0,2008-10-27,-2,0,"clt",-10
"9","Sun","November 2","W","","4-4",TRUE,"New England Patriots",18,15,18,301,254,47,0,22,342,202,140,2,2008-11-02,2,1,"clt",3
"10","Sun","November 9","W","","5-4",FALSE,"Pittsburgh Steelers",24,20,17,290,228,62,0,18,326,271,55,3,2008-11-09,3,1,"clt",4
"11","Sun","November 16","W","","6-4",TRUE,"Houston Texans",33,27,30,474,320,154,0,16,356,179,177,1,2008-11-16,1,1,"clt",6
"12","Sun","November 23","W","","7-4",FALSE,"San Diego Chargers",23,20,19,341,250,91,1,21,394,274,120,1,2008-11-23,0,1,"clt",3
"13","Sun","November 30","W","","8-4",FALSE,"Cleveland Browns",10,6,14,215,125,90,3,13,193,92,101,2,2008-11-30,-1,1,"clt",4
"14","Sun","December 7","W","","9-4",TRUE,"Cincinnati Bengals",35,3,20,334,277,57,1,17,252,170,82,4,2008-12-07,3,1,"clt",32
"15","Sun","December 14","W","","10-4",TRUE,"Detroit Lions",31,21,28,421,315,106,2,18,323,233,90,2,2008-12-14,0,1,"clt",10
"16","Thu","December 18","W","","11-4",FALSE,"Jacksonville Jaguars",31,24,20,396,364,32,0,28,409,304,105,1,2008-12-18,1,1,"clt",7
"17","Sun","December 28","W","","12-4",TRUE,"Tennessee Titans",23,0,21,390,269,121,0,8,125,42,83,0,2008-12-28,0,1,"clt",23
"WildCard","Sat","January 3","L","OT","12-5",FALSE,"San Diego Chargers",17,23,17,366,302,64,0,26,357,190,167,2,2009-01-03,2,0,"clt",-6
"1","Sun","September 13","W","","1-0",TRUE,"Jacksonville Jaguars",14,12,21,365,294,71,2,12,228,114,114,0,2009-09-13,-2,1,"clt",2
"2","Mon","September 21","W","","2-0",FALSE,"Miami Dolphins",27,23,14,356,295,61,0,27,403,164,239,1,2009-09-21,1,1,"clt",4
"3","Sun","September 27","W","","3-0",FALSE,"Arizona Cardinals",31,10,22,505,379,126,1,21,323,299,24,3,2009-09-27,2,1,"clt",21
"4","Sun","October 4","W","","4-0",TRUE,"Seattle Seahawks",34,17,24,431,353,78,1,20,279,230,49,2,2009-10-04,1,1,"clt",17
"5","Sun","October 11","W","","5-0",FALSE,"Tennessee Titans",31,9,23,367,309,58,2,12,245,155,90,2,2009-10-11,0,1,"clt",22
"7","Sun","October 25","W","","6-0",FALSE,"St. Louis Rams",42,6,24,391,235,156,0,14,272,117,155,2,2009-10-25,2,1,"clt",36
"8","Sun","November 1","W","","7-0",TRUE,"San Francisco 49ers",18,14,20,410,349,61,0,16,295,182,113,2,2009-11-01,2,1,"clt",4
"9","Sun","November 8","W","","8-0",TRUE,"Houston Texans",20,17,27,378,306,72,2,22,382,301,81,3,2009-11-08,1,1,"clt",3
"10","Sun","November 15","W","","9-0",TRUE,"New England Patriots",35,34,25,407,316,91,2,24,477,364,113,2,2009-11-15,0,1,"clt",1
"11","Sun","November 22","W","","10-0",FALSE,"Baltimore Ravens",17,15,20,375,299,76,3,20,354,256,98,2,2009-11-22,-1,1,"clt",2
"12","Sun","November 29","W","","11-0",FALSE,"Houston Texans",35,27,28,342,228,114,2,27,396,274,122,3,2009-11-29,1,1,"clt",8
"13","Sun","December 6","W","","12-0",TRUE,"Tennessee Titans",27,17,23,358,270,88,0,24,375,233,142,2,2009-12-06,2,1,"clt",10
"14","Sun","December 13","W","","13-0",TRUE,"Denver Broncos",28,16,21,312,220,92,3,20,357,262,95,1,2009-12-13,-2,1,"clt",12
"15","Thu","December 17","W","","14-0",FALSE,"Jacksonville Jaguars",35,31,18,369,308,61,1,25,345,206,139,1,2009-12-17,0,1,"clt",4
"16","Sun","December 27","L","","14-1",TRUE,"New York Jets",15,29,18,286,222,64,2,17,293,91,202,0,2009-12-27,-2,0,"clt",-14
"17","Sun","January 3","L","","14-2",FALSE,"Buffalo Bills",7,30,11,157,132,25,3,19,403,155,248,0,2010-01-03,-3,0,"clt",-23
"Division","Sat","January 16","W","","15-2",TRUE,"Baltimore Ravens",20,3,22,275,233,42,1,12,270,183,87,4,2010-01-16,3,1,"clt",17
"ConfChamp","Sun","January 24","W","","16-2",TRUE,"New York Jets",30,17,27,461,360,101,1,17,388,302,86,1,2010-01-24,0,1,"clt",13
"SuperBowl","Sun","February 7","L","","16-3",TRUE,"New Orleans Saints",17,31,23,432,333,99,1,20,332,281,51,0,2010-02-07,-1,0,"clt",-14
"1","Sun","September 12","L","","0-1",FALSE,"Houston Texans",24,34,25,463,419,44,1,23,355,98,257,1,2010-09-12,0,0,"clt",-10
"2","Sun","September 19","W","","1-1",TRUE,"New York Giants",38,14,24,410,250,160,1,13,257,137,120,3,2010-09-19,2,1,"clt",24
"3","Sun","September 26","W","","2-1",FALSE,"Denver Broncos",27,13,18,365,325,40,0,23,519,472,47,2,2010-09-26,2,1,"clt",14
"4","Sun","October 3","L","","2-2",FALSE,"Jacksonville Jaguars",28,31,28,406,348,58,2,20,337,163,174,0,2010-10-03,-2,0,"clt",-3
"5","Sun","October 10","W","","3-2",TRUE,"Kansas City Chiefs",19,9,23,341,244,97,1,16,261,148,113,1,2010-10-10,0,1,"clt",10
"6","Sun","October 17","W","","4-2",FALSE,"Washington Redskins",27,24,22,469,299,170,3,23,335,222,113,2,2010-10-17,-1,1,"clt",3
"8","Mon","November 1","W","","5-2",TRUE,"Houston Texans",30,17,24,366,259,107,0,19,291,183,108,2,2010-11-01,2,1,"clt",13
"9","Sun","November 7","L","","5-3",FALSE,"Philadelphia Eagles",24,26,27,338,276,62,2,19,402,207,195,0,2010-11-07,-2,0,"clt",-2
"10","Sun","November 14","W","","6-3",TRUE,"Cincinnati Bengals",23,17,16,256,180,76,0,19,341,269,72,5,2010-11-14,5,1,"clt",6
"11","Sun","November 21","L","","6-4",FALSE,"New England Patriots",28,31,28,467,396,71,3,22,346,178,168,0,2010-11-21,-3,0,"clt",-3
"12","Sun","November 28","L","","6-5",TRUE,"San Diego Chargers",14,36,16,303,279,24,5,18,301,172,129,0,2010-11-28,-5,0,"clt",-22
"13","Sun","December 5","L","OT","6-6",TRUE,"Dallas Cowboys",35,38,24,405,365,40,4,24,368,151,217,0,2010-12-05,-4,0,"clt",-3
"14","Thu","December 9","W","","7-6",FALSE,"Tennessee Titans",30,28,21,399,312,87,0,22,365,244,121,2,2010-12-09,2,1,"clt",2
"15","Sun","December 19","W","","8-6",TRUE,"Jacksonville Jaguars",34,24,19,376,221,155,0,20,356,289,67,2,2010-12-19,2,1,"clt",10
"16","Sun","December 26","W","","9-6",FALSE,"Oakland Raiders",31,26,27,370,179,191,2,16,290,210,80,0,2010-12-26,-2,1,"clt",5
"17","Sun","January 2","W","","10-6",TRUE,"Tennessee Titans",23,20,24,358,257,101,1,17,341,290,51,1,2011-01-02,0,1,"clt",3
"WildCard","Sat","January 8","L","","10-7",TRUE,"New York Jets",16,17,16,312,219,93,0,23,353,184,169,1,2011-01-08,1,0,"clt",-1
"1","Sun","September 11","L","","0-1",FALSE,"Houston Texans",7,34,15,236,172,64,2,26,384,217,167,3,2011-09-11,1,0,"clt",-27
"2","Sun","September 18","L","","0-2",TRUE,"Cleveland Browns",19,27,19,285,176,109,2,18,303,197,106,1,2011-09-18,-1,0,"clt",-8
"3","Sun","September 25","L","","0-3",TRUE,"Pittsburgh Steelers",20,23,14,241,144,97,1,19,408,341,67,3,2011-09-25,2,0,"clt",-3
"4","Mon","October 3","L","","0-4",FALSE,"Tampa Bay Buccaneers",17,24,13,318,256,62,1,25,466,274,192,0,2011-10-03,-1,0,"clt",-7
"5","Sun","October 9","L","","0-5",TRUE,"Kansas City Chiefs",24,28,15,355,277,78,0,26,436,242,194,0,2011-10-09,0,0,"clt",-4
"6","Sun","October 16","L","","0-6",FALSE,"Cincinnati Bengals",17,27,18,273,179,94,3,17,358,264,94,0,2011-10-16,-3,0,"clt",-10
"7","Sun","October 23","L","","0-7",FALSE,"New Orleans Saints",7,62,11,252,97,155,3,36,557,321,236,0,2011-10-23,-3,0,"clt",-55
"8","Sun","October 30","L","","0-8",FALSE,"Tennessee Titans",10,27,22,399,241,158,2,17,311,215,96,0,2011-10-30,-2,0,"clt",-17
"9","Sun","November 6","L","","0-9",TRUE,"Atlanta Falcons",7,31,10,186,103,83,2,21,432,269,163,1,2011-11-06,-1,0,"clt",-24
"10","Sun","November 13","L","","0-10",TRUE,"Jacksonville Jaguars",3,17,17,212,128,84,3,18,251,110,141,1,2011-11-13,-2,0,"clt",-14
"12","Sun","November 27","L","","0-11",TRUE,"Carolina Panthers",19,27,17,323,218,105,2,22,377,176,201,1,2011-11-27,-1,0,"clt",-8
"13","Sun","December 4","L","","0-12",FALSE,"New England Patriots",24,31,26,437,338,99,2,24,362,289,73,0,2011-12-04,-2,0,"clt",-7
"14","Sun","December 11","L","","0-13",FALSE,"Baltimore Ravens",10,24,12,167,117,50,1,24,358,212,146,2,2011-12-11,1,0,"clt",-14
"15","Sun","December 18","W","","1-13",TRUE,"Tennessee Titans",27,13,10,287,82,205,1,21,388,322,66,3,2011-12-18,2,1,"clt",14
"16","Thu","December 22","W","","2-13",TRUE,"Houston Texans",19,16,24,320,225,95,1,14,283,112,171,1,2011-12-22,0,1,"clt",3
"17","Sun","January 1","L","","2-14",FALSE,"Jacksonville Jaguars",13,19,19,298,242,56,3,15,261,71,190,1,2012-01-01,-2,0,"clt",-6
"1","Sun","September 8","W","","1-0",TRUE,"Miami Dolphins",26,23,21,394,229,165,4,17,360,291,69,3,1985-09-08,-1,1,"oti",3
"2","Sun","September 15","L","","1-1",FALSE,"Washington Redskins",13,16,11,188,107,81,0,20,333,93,240,3,1985-09-15,3,0,"oti",-3
"3","Sun","September 22","L","","1-2",FALSE,"Pittsburgh Steelers",0,20,8,134,84,50,2,22,335,102,233,0,1985-09-22,-2,0,"oti",-20
"4","Sun","September 29","L","","1-3",TRUE,"Dallas Cowboys",10,17,13,214,133,81,5,16,339,183,156,0,1985-09-29,-5,0,"oti",-7
"5","Sun","October 6","L","","1-4",FALSE,"Denver Broncos",20,31,18,321,201,120,0,31,362,241,121,3,1985-10-06,3,0,"oti",-11
"6","Sun","October 13","L","","1-5",TRUE,"Cleveland Browns",6,21,14,190,67,123,2,13,360,208,152,4,1985-10-13,2,0,"oti",-15
"7","Sun","October 20","W","","2-5",TRUE,"Cincinnati Bengals",44,27,26,401,266,135,0,24,458,352,106,5,1985-10-20,5,1,"oti",17
"8","Sun","October 27","W","","3-5",FALSE,"St. Louis Cardinals",20,10,13,229,171,58,2,22,427,240,187,1,1985-10-27,-1,1,"oti",10
"9","Sun","November 3","W","","4-5",TRUE,"Kansas City Chiefs",23,20,24,377,241,136,1,26,389,236,153,3,1985-11-03,2,1,"oti",3
"10","Sun","November 10","L","","4-6",FALSE,"Buffalo Bills",0,20,7,142,31,111,6,18,207,60,147,2,1985-11-10,-4,0,"oti",-20
"11","Sun","November 17","L","","4-7",TRUE,"Pittsburgh Steelers",7,30,10,162,56,106,2,24,378,130,248,2,1985-11-17,0,0,"oti",-23
"12","Sun","November 24","W","","5-7",TRUE,"San Diego Chargers",37,35,26,415,278,137,2,29,439,323,116,5,1985-11-24,3,1,"oti",2
"13","Sun","December 1","L","","5-8",FALSE,"Cincinnati Bengals",27,45,22,345,272,73,2,28,555,324,231,1,1985-12-01,-1,0,"oti",-18
"14","Sun","December 8","L","","5-9",TRUE,"New York Giants",14,35,18,320,298,22,3,25,432,234,198,2,1985-12-08,-1,0,"oti",-21
"15","Sun","December 15","L","","5-10",FALSE,"Cleveland Browns",21,28,21,399,303,96,3,19,314,156,158,1,1985-12-15,-2,0,"oti",-7
"16","Sun","December 22","L","","5-11",FALSE,"Indianapolis Colts",16,34,18,421,345,76,3,22,467,168,299,0,1985-12-22,-3,0,"oti",-18
"1","Sun","September 7","W","","1-0",FALSE,"Green Bay Packers",31,3,23,375,218,157,1,9,224,147,77,2,1986-09-07,1,1,"oti",28
"2","Sun","September 14","L","","1-1",TRUE,"Cleveland Browns",20,23,20,404,264,140,5,9,243,156,87,1,1986-09-14,-4,0,"oti",-3
"3","Sun","September 21","L","","1-2",FALSE,"Kansas City Chiefs",13,27,16,284,187,97,3,12,223,117,106,1,1986-09-21,-2,0,"oti",-14
"4","Sun","September 28","L","OT","1-3",TRUE,"Pittsburgh Steelers",16,22,19,281,200,81,3,22,375,161,214,2,1986-09-28,-1,0,"oti",-6
"5","Sun","October 5","L","","1-4",FALSE,"Detroit Lions",13,24,16,454,398,56,4,17,234,76,158,1,1986-10-05,-3,0,"oti",-11
"6","Sun","October 12","L","","1-5",TRUE,"Chicago Bears",7,20,19,283,155,128,1,23,360,203,157,2,1986-10-12,1,0,"oti",-13
"7","Sun","October 19","L","","1-6",FALSE,"Cincinnati Bengals",28,31,16,233,155,78,3,22,412,188,224,1,1986-10-19,-2,0,"oti",-3
"8","Sun","October 26","L","","1-7",TRUE,"Los Angeles Raiders",17,28,18,335,253,82,5,21,352,218,134,2,1986-10-26,-3,0,"oti",-11
"9","Sun","November 2","L","","1-8",FALSE,"Miami Dolphins",7,28,18,301,137,164,2,17,345,217,128,3,1986-11-02,1,0,"oti",-21
"10","Sun","November 9","W","","2-8",TRUE,"Cincinnati Bengals",32,28,26,358,297,61,1,22,404,358,46,2,1986-11-09,1,1,"oti",4
"11","Sun","November 16","L","","2-9",FALSE,"Pittsburgh Steelers",10,21,19,291,220,71,2,20,287,116,171,1,1986-11-16,-1,0,"oti",-11
"12","Sun","November 23","W","","3-9",TRUE,"Indianapolis Colts",31,17,28,471,298,173,3,13,242,178,64,2,1986-11-23,-1,1,"oti",14
"13","Sun","November 30","L","OT","3-10",FALSE,"Cleveland Browns",10,13,18,290,162,128,6,18,345,170,175,4,1986-11-30,-2,0,"oti",-3
"14","Sun","December 7","L","","3-11",FALSE,"San Diego Chargers",0,27,9,134,55,79,3,23,409,285,124,0,1986-12-07,-3,0,"oti",-27
"15","Sun","December 14","W","","4-11",TRUE,"Minnesota Vikings",23,10,18,377,259,118,1,18,301,191,110,6,1986-12-14,5,1,"oti",13
"16","Sun","December 21","W","","5-11",TRUE,"Buffalo Bills",16,7,16,278,191,87,0,19,278,218,60,2,1986-12-21,2,1,"oti",9
"1","Sun","September 13","W","","1-0",TRUE,"Los Angeles Rams",20,16,22,400,287,113,3,14,244,97,147,3,1987-09-13,0,1,"oti",4
"2","Sun","September 20","L","","1-1",FALSE,"Buffalo Bills",30,34,19,327,130,197,1,30,383,248,135,2,1987-09-20,1,0,"oti",-4
"3","Sun","October 4","W","","2-1",FALSE,"Denver Broncos",40,10,20,414,260,154,2,14,220,182,38,3,1987-10-04,1,1,"oti",30
"4","Sun","October 11","W","","3-1",FALSE,"Cleveland Browns",15,10,17,317,143,174,2,9,169,119,50,4,1987-10-11,2,1,"oti",5
"5","Sun","October 18","L","","3-2",TRUE,"New England Patriots",7,21,17,334,221,113,3,17,310,196,114,0,1987-10-18,-3,0,"oti",-14
"6","Sun","October 25","W","","4-2",TRUE,"Atlanta Falcons",37,33,24,439,234,205,2,14,304,183,121,5,1987-10-25,3,1,"oti",4
"7","Sun","November 1","W","","5-2",FALSE,"Cincinnati Bengals",31,29,19,227,145,82,3,25,504,383,121,3,1987-11-01,0,1,"oti",2
"8","Sun","November 8","L","","5-3",FALSE,"San Francisco 49ers",20,27,15,269,221,48,4,33,443,280,163,2,1987-11-08,-2,0,"oti",-7
"9","Sun","November 15","W","","6-3",FALSE,"Pittsburgh Steelers",23,3,21,373,221,152,1,8,170,84,86,3,1987-11-15,2,1,"oti",20
"10","Sun","November 22","L","","6-4",TRUE,"Cleveland Browns",7,40,11,247,204,43,6,27,457,257,200,0,1987-11-22,-6,0,"oti",-33
"11","Sun","November 29","L","","6-5",FALSE,"Indianapolis Colts",27,51,26,454,318,136,5,18,359,148,211,1,1987-11-29,-4,0,"oti",-24
"12","Sun","December 6","W","","7-5",TRUE,"San Diego Chargers",33,18,21,324,184,140,1,19,332,289,43,4,1987-12-06,3,1,"oti",15
"13","Sun","December 13","L","","7-6",FALSE,"New Orleans Saints",10,24,20,354,244,110,0,21,391,240,151,2,1987-12-13,2,0,"oti",-14
"14","Sun","December 20","W","","8-6",TRUE,"Pittsburgh Steelers",24,16,17,283,221,62,1,22,348,172,176,3,1987-12-20,2,1,"oti",8
"15","Sun","December 27","W","","9-6",TRUE,"Cincinnati Bengals",21,17,25,461,267,194,3,16,359,267,92,2,1987-12-27,-1,1,"oti",4
"WildCard","Sun","January 3","W","OT","10-6",TRUE,"Seattle Seahawks",23,20,27,437,259,178,2,11,250,221,29,1,1988-01-03,-1,1,"oti",3
"Division","Sun","January 10","L","","10-7",FALSE,"Denver Broncos",10,34,20,337,264,73,3,19,316,255,61,1,1988-01-10,-2,0,"oti",-24
"1","Sun","September 4","W","OT","1-0",FALSE,"Indianapolis Colts",17,14,18,347,174,173,3,16,281,170,111,3,1988-09-04,0,1,"oti",3
"2","Sun","September 11","W","","2-0",TRUE,"Los Angeles Raiders",38,35,29,406,250,156,3,17,158,84,74,2,1988-09-11,-1,1,"oti",3
"3","Sun","September 18","L","","2-1",FALSE,"New York Jets",3,45,15,237,102,135,4,28,395,302,93,1,1988-09-18,-3,0,"oti",-42
"4","Sun","September 25","W","","3-1",TRUE,"New England Patriots",31,6,17,328,156,172,3,13,184,133,51,6,1988-09-25,3,1,"oti",25
"5","Sun","October 2","L","","3-2",FALSE,"Philadelphia Eagles",23,32,14,202,147,55,3,26,455,265,190,1,1988-10-02,-2,0,"oti",-9
"6","Sun","October 9","W","","4-2",TRUE,"Kansas City Chiefs",7,6,16,230,24,206,4,11,184,119,65,3,1988-10-09,-1,1,"oti",1
"7","Sun","October 16","W","","5-2",FALSE,"Pittsburgh Steelers",34,14,18,309,185,124,0,23,344,251,93,4,1988-10-16,4,1,"oti",20
"8","Sun","October 23","L","","5-3",FALSE,"Cincinnati Bengals",21,44,18,205,101,104,4,25,353,131,222,4,1988-10-23,0,0,"oti",-23
"9","Sun","October 30","W","","6-3",TRUE,"Washington Redskins",41,17,21,336,184,152,2,16,250,221,29,6,1988-10-30,4,1,"oti",24
"10","Mon","November 7","W","","7-3",TRUE,"Cleveland Browns",24,17,18,330,182,148,1,15,253,209,44,1,1988-11-07,0,1,"oti",7
"11","Sun","November 13","L","","7-4",FALSE,"Seattle Seahawks",24,27,22,419,182,237,1,22,365,188,177,1,1988-11-13,0,0,"oti",-3
"12","Sun","November 20","W","","8-4",TRUE,"Phoenix Cardinals",38,20,23,385,261,124,0,17,314,254,60,2,1988-11-20,2,1,"oti",18
"13","Thu","November 24","W","","9-4",FALSE,"Dallas Cowboys",25,17,19,355,210,145,0,17,282,203,79,2,1988-11-24,2,1,"oti",8
"14","Sun","December 4","L","","9-5",TRUE,"Pittsburgh Steelers",34,37,23,403,269,134,4,23,426,332,94,0,1988-12-04,-4,0,"oti",-3
"15","Sun","December 11","W","","10-5",TRUE,"Cincinnati Bengals",41,6,19,396,249,147,2,10,226,94,132,2,1988-12-11,0,1,"oti",35
"16","Sun","December 18","L","","10-6",FALSE,"Cleveland Browns",23,28,18,317,280,37,1,25,388,310,78,4,1988-12-18,3,0,"oti",-5
"WildCard","Sat","December 24","W","","11-6",FALSE,"Cleveland Browns",24,23,19,334,205,129,3,19,260,192,68,2,1988-12-24,-1,1,"oti",1
"Division","Sun","January 1","L","","11-7",FALSE,"Buffalo Bills",10,17,20,351,226,125,3,18,372,237,135,1,1989-01-01,-2,0,"oti",-7
"1","Sun","September 10","L","","0-1",FALSE,"Minnesota Vikings",7,38,11,104,34,70,3,29,343,188,155,0,1989-09-10,-3,0,"oti",-31
"2","Sun","September 17","W","","1-1",FALSE,"San Diego Chargers",34,27,26,367,235,132,0,24,413,372,41,5,1989-09-17,5,1,"oti",7
"3","Sun","September 24","L","OT","1-2",TRUE,"Buffalo Bills",41,47,33,439,311,128,2,22,449,337,112,1,1989-09-24,-1,0,"oti",-6
"4","Sun","October 1","W","","2-2",TRUE,"Miami Dolphins",39,7,23,448,251,197,1,9,160,117,43,3,1989-10-01,2,1,"oti",32
"5","Sun","October 8","L","","2-3",FALSE,"New England Patriots",13,23,14,307,202,105,4,19,282,138,144,1,1989-10-08,-3,0,"oti",-10
"6","Sun","October 15","W","","3-3",FALSE,"Chicago Bears",33,28,20,457,317,140,2,22,332,239,93,6,1989-10-15,4,1,"oti",5
"7","Sun","October 22","W","","4-3",TRUE,"Pittsburgh Steelers",27,0,22,361,229,132,1,10,132,100,32,4,1989-10-22,3,1,"oti",27
"8","Sun","October 29","L","","4-4",FALSE,"Cleveland Browns",17,28,17,299,210,89,0,18,383,280,103,2,1989-10-29,2,0,"oti",-11
"9","Sun","November 5","W","","5-4",TRUE,"Detroit Lions",35,31,30,455,345,110,4,19,351,257,94,2,1989-11-05,-2,1,"oti",4
"10","Mon","November 13","W","","6-4",TRUE,"Cincinnati Bengals",26,24,20,311,175,136,1,16,337,175,162,1,1989-11-13,0,1,"oti",2
"11","Sun","November 19","W","","7-4",TRUE,"Los Angeles Raiders",23,7,23,419,249,170,2,12,243,169,74,5,1989-11-19,3,1,"oti",16
"12","Sun","November 26","L","","7-5",FALSE,"Kansas City Chiefs",0,34,12,215,112,103,1,20,313,229,84,1,1989-11-26,0,0,"oti",-34
"13","Sun","December 3","W","","8-5",FALSE,"Pittsburgh Steelers",23,16,19,284,144,140,3,15,212,43,169,1,1989-12-03,-2,1,"oti",7
"14","Sun","December 10","W","","9-5",TRUE,"Tampa Bay Buccaneers",20,17,15,284,149,135,2,23,353,287,66,2,1989-12-10,0,1,"oti",3
"15","Sun","December 17","L","","9-6",FALSE,"Cincinnati Bengals",7,61,14,194,155,39,5,35,584,392,192,2,1989-12-17,-3,0,"oti",-54
"16","Sat","December 23","L","","9-7",TRUE,"Cleveland Browns",20,24,28,483,381,102,2,21,324,219,105,1,1989-12-23,-1,0,"oti",-4
"WildCard","Sun","December 31","L","OT","9-8",TRUE,"Pittsburgh Steelers",23,26,22,380,315,65,2,17,289,112,177,1,1989-12-31,-1,0,"oti",-3
"1","Sun","September 9","L","","0-1",FALSE,"Atlanta Falcons",27,47,28,418,389,29,6,19,301,206,95,2,1990-09-09,-4,0,"oti",-20
"2","Sun","September 16","L","","0-2",FALSE,"Pittsburgh Steelers",9,20,20,309,258,51,4,10,123,55,68,0,1990-09-16,-4,0,"oti",-11
"3","Sun","September 23","W","","1-2",TRUE,"Indianapolis Colts",24,10,22,372,303,69,3,18,252,195,57,4,1990-09-23,1,1,"oti",14
"4","Sun","September 30","W","","2-2",FALSE,"San Diego Chargers",17,7,29,421,329,92,1,14,298,167,131,2,1990-09-30,1,1,"oti",10
"5","Sun","October 7","L","","2-3",TRUE,"San Francisco 49ers",21,24,17,256,170,86,1,17,383,300,83,2,1990-10-07,1,0,"oti",-3
"6","Sun","October 14","W","","3-3",TRUE,"Cincinnati Bengals",48,17,27,514,401,113,2,17,251,135,116,4,1990-10-14,2,1,"oti",31
"7","Sun","October 21","W","","4-3",TRUE,"New Orleans Saints",23,10,21,305,202,103,2,19,320,259,61,3,1990-10-21,1,1,"oti",13
"8","Sun","October 28","L","","4-4",TRUE,"New York Jets",12,17,28,425,343,82,2,13,229,142,87,1,1990-10-28,-1,0,"oti",-5
"9","Sun","November 4","L","","4-5",FALSE,"Los Angeles Rams",13,17,20,366,333,33,2,23,316,198,118,1,1990-11-04,-1,0,"oti",-4
"11","Sun","November 18","W","","5-5",FALSE,"Cleveland Browns",35,23,21,378,284,94,2,21,361,263,98,4,1990-11-18,2,1,"oti",12
"12","Mon","November 26","W","","6-5",TRUE,"Buffalo Bills",27,24,21,411,283,128,1,24,289,210,79,1,1990-11-26,0,1,"oti",3
"13","Sun","December 2","L","OT","6-6",FALSE,"Seattle Seahawks",10,13,19,276,220,56,3,20,281,158,123,1,1990-12-02,-2,0,"oti",-3
"14","Sun","December 9","W","","7-6",TRUE,"Cleveland Browns",58,14,34,477,271,206,1,12,195,138,57,4,1990-12-09,3,1,"oti",44
"15","Sun","December 16","W","","8-6",FALSE,"Kansas City Chiefs",27,10,22,563,505,58,1,17,350,249,101,2,1990-12-16,1,1,"oti",17
"16","Sun","December 23","L","","8-7",FALSE,"Cincinnati Bengals",20,40,19,304,282,22,4,18,387,165,222,0,1990-12-23,-4,0,"oti",-20
"17","Sun","December 30","W","","9-7",TRUE,"Pittsburgh Steelers",34,14,28,427,232,195,1,17,299,220,79,2,1990-12-30,1,1,"oti",20
"WildCard","Sun","January 6","L","","9-8",FALSE,"Cincinnati Bengals",14,41,13,226,159,67,2,24,349,162,187,0,1991-01-06,-2,0,"oti",-27
"1","Sun","September 1","W","","1-0",TRUE,"Los Angeles Raiders",47,17,25,459,240,219,1,11,286,224,62,4,1991-09-01,3,1,"oti",30
"2","Sun","September 8","W","","2-0",FALSE,"Cincinnati Bengals",30,7,21,425,315,110,1,19,349,218,131,2,1991-09-08,1,1,"oti",23
"3","Mon","September 16","W","","3-0",TRUE,"Kansas City Chiefs",17,7,22,275,227,48,1,15,230,85,145,2,1991-09-16,1,1,"oti",10
"4","Sun","September 22","L","","3-1",FALSE,"New England Patriots",20,24,18,353,268,85,3,23,343,234,109,3,1991-09-22,0,0,"oti",-4
"6","Sun","October 6","W","","4-1",TRUE,"Denver Broncos",42,14,17,378,327,51,2,23,363,272,91,3,1991-10-06,1,1,"oti",28
"7","Sun","October 13","W","","5-1",FALSE,"New York Jets",23,20,25,436,409,27,3,21,279,236,43,1,1991-10-13,-2,1,"oti",3
"8","Sun","October 20","W","","6-1",FALSE,"Miami Dolphins",17,13,23,282,162,120,4,16,275,218,57,5,1991-10-20,1,1,"oti",4
"9","Sun","October 27","W","","7-1",TRUE,"Cincinnati Bengals",35,3,26,486,376,110,3,8,183,146,37,3,1991-10-27,0,1,"oti",32
"10","Sun","November 3","L","OT","7-2",FALSE,"Washington Redskins",13,16,16,267,242,25,3,19,349,195,154,4,1991-11-03,1,0,"oti",-3
"11","Sun","November 10","W","OT","8-2",TRUE,"Dallas Cowboys",26,23,33,583,425,158,1,21,291,241,50,1,1991-11-10,0,1,"oti",3
"12","Sun","November 17","W","","9-2",TRUE,"Cleveland Browns",28,24,25,440,395,45,4,17,311,262,49,1,1991-11-17,-3,1,"oti",4
"13","Sun","November 24","L","","9-3",FALSE,"Pittsburgh Steelers",14,26,21,331,307,24,6,16,294,155,139,2,1991-11-24,-4,0,"oti",-12
"14","Mon","December 2","L","","9-4",TRUE,"Philadelphia Eagles",6,13,15,247,226,21,5,14,240,146,94,1,1991-12-02,-4,0,"oti",-7
"15","Sun","December 8","W","","10-4",TRUE,"Pittsburgh Steelers",31,6,23,350,233,117,2,14,232,147,85,4,1991-12-08,2,1,"oti",25
"16","Sun","December 15","W","","11-4",FALSE,"Cleveland Browns",17,14,20,330,247,83,1,22,340,239,101,1,1991-12-15,0,1,"oti",3
"17","Sat","December 21","L","","11-5",FALSE,"New York Giants",20,24,23,345,222,123,0,21,383,190,193,1,1991-12-21,1,0,"oti",-4
"WildCard","Sun","December 29","W","","12-5",TRUE,"New York Jets",17,10,21,303,232,71,2,18,285,214,71,3,1991-12-29,1,1,"oti",7
"Division","Sat","January 4","L","","12-6",FALSE,"Denver Broncos",24,26,23,422,325,97,1,26,418,267,151,1,1992-01-04,0,0,"oti",-2
"1","Sun","September 6","L","","0-1",TRUE,"Pittsburgh Steelers",24,29,24,434,330,104,5,19,381,245,136,2,1992-09-06,-3,0,"oti",-5
"2","Sun","September 13","W","","1-1",FALSE,"Indianapolis Colts",20,10,23,419,350,69,0,14,162,106,56,1,1992-09-13,1,1,"oti",10
"3","Sun","September 20","W","OT","2-1",TRUE,"Kansas City Chiefs",23,20,18,342,265,77,3,21,345,158,187,1,1992-09-20,-2,1,"oti",3
"4","Sun","September 27","W","","3-1",TRUE,"San Diego Chargers",27,0,21,303,197,106,1,15,262,210,52,3,1992-09-27,2,1,"oti",27
"6","Sun","October 11","W","","4-1",FALSE,"Cincinnati Bengals",38,24,28,418,216,202,3,15,274,205,69,2,1992-10-11,-1,1,"oti",14
"7","Sun","October 18","L","","4-2",FALSE,"Denver Broncos",21,27,21,407,298,109,1,14,322,152,170,0,1992-10-18,-1,0,"oti",-6
"8","Sun","October 25","W","","5-2",TRUE,"Cincinnati Bengals",26,10,26,425,332,93,1,11,201,113,88,1,1992-10-25,0,1,"oti",16
"9","Sun","November 1","L","","5-3",FALSE,"Pittsburgh Steelers",20,21,21,283,228,55,2,20,302,183,119,3,1992-11-01,1,0,"oti",-1
"10","Sun","November 8","L","","5-4",TRUE,"Cleveland Browns",14,24,13,273,181,92,2,17,291,205,86,1,1992-11-08,-1,0,"oti",-10
"11","Sun","November 15","W","","6-4",FALSE,"Minnesota Vikings",17,13,27,342,215,127,4,10,170,96,74,1,1992-11-15,-3,1,"oti",4
"12","Sun","November 22","L","","6-5",FALSE,"Miami Dolphins",16,19,16,297,201,96,3,18,293,221,72,2,1992-11-22,-1,0,"oti",-3
"13","Thu","November 26","W","","7-5",FALSE,"Detroit Lions",24,21,21,383,332,51,2,14,214,141,73,3,1992-11-26,1,1,"oti",3
"14","Mon","December 7","W","","8-5",TRUE,"Chicago Bears",24,7,21,339,164,175,0,14,257,158,99,3,1992-12-07,3,1,"oti",17
"15","Sun","December 13","L","","8-6",TRUE,"Green Bay Packers",14,16,21,387,328,59,4,16,215,154,61,1,1992-12-13,-3,0,"oti",-2
"16","Sun","December 20","W","","9-6",FALSE,"Cleveland Browns",17,14,21,318,214,104,3,19,285,140,145,3,1992-12-20,0,1,"oti",3
"17","Sun","December 27","W","","10-6",TRUE,"Buffalo Bills",27,3,17,285,178,107,1,17,237,90,147,4,1992-12-27,3,1,"oti",24
"WildCard","Sun","January 3","L","OT","10-7",FALSE,"Buffalo Bills",38,41,27,429,347,82,2,19,366,268,98,1,1993-01-03,-1,0,"oti",-3
"1","Sun","September 5","L","","0-1",FALSE,"New Orleans Saints",21,33,21,405,335,70,5,21,346,204,142,1,1993-09-05,-4,0,"oti",-12
"2","Sun","September 12","W","","1-1",TRUE,"Kansas City Chiefs",30,0,17,247,190,57,2,10,206,160,46,5,1993-09-12,3,1,"oti",30
"3","Sun","September 19","L","","1-2",FALSE,"San Diego Chargers",17,18,17,295,224,71,5,19,284,173,111,1,1993-09-19,-4,0,"oti",-1
"4","Sun","September 26","L","","1-3",TRUE,"Los Angeles Rams",13,28,18,370,288,82,2,22,374,316,58,0,1993-09-26,-2,0,"oti",-15
"6","Mon","October 11","L","","1-4",FALSE,"Buffalo Bills",7,35,18,329,245,84,7,23,382,241,141,1,1993-10-11,-6,0,"oti",-28
"7","Sun","October 17","W","","2-4",FALSE,"New England Patriots",28,14,15,246,142,104,0,19,315,261,54,3,1993-10-17,3,1,"oti",14
"8","Sun","October 24","W","","3-4",TRUE,"Cincinnati Bengals",28,12,24,369,244,125,2,20,338,241,97,2,1993-10-24,0,1,"oti",16
"10","Sun","November 7","W","","4-4",TRUE,"Seattle Seahawks",24,14,26,458,347,111,2,14,252,168,84,1,1993-11-07,-1,1,"oti",10
"11","Sun","November 14","W","","5-4",FALSE,"Cincinnati Bengals",38,3,32,462,222,240,4,9,165,63,102,2,1993-11-14,-2,1,"oti",35
"12","Sun","November 21","W","","6-4",FALSE,"Cleveland Browns",27,20,25,384,182,202,4,20,349,300,49,5,1993-11-21,1,1,"oti",7
"13","Sun","November 28","W","","7-4",TRUE,"Pittsburgh Steelers",23,3,20,391,266,125,1,18,234,169,65,4,1993-11-28,3,1,"oti",20
"14","Sun","December 5","W","","8-4",TRUE,"Atlanta Falcons",33,17,18,388,336,52,3,25,333,296,37,7,1993-12-05,4,1,"oti",16
"15","Sun","December 12","W","","9-4",TRUE,"Cleveland Browns",19,17,18,257,129,128,1,19,410,305,105,3,1993-12-12,2,1,"oti",2
"16","Sun","December 19","W","","10-4",FALSE,"Pittsburgh Steelers",26,17,20,383,266,117,2,21,385,347,38,3,1993-12-19,1,1,"oti",9
"17","Sat","December 25","W","","11-4",FALSE,"San Francisco 49ers",10,7,16,311,195,116,3,20,337,247,90,3,1993-12-25,0,1,"oti",3
"18","Sun","January 2","W","","12-4",TRUE,"New York Jets",24,0,25,363,255,108,2,9,164,110,54,2,1994-01-02,0,1,"oti",24
"Division","Sun","January 16","L","","12-5",TRUE,"Kansas City Chiefs",20,28,19,277,238,39,3,18,354,283,71,2,1994-01-16,-1,0,"oti",-8
"1","Sun","September 4","L","","0-1",FALSE,"Indianapolis Colts",21,45,26,374,295,79,3,19,288,106,182,2,1994-09-04,-1,0,"oti",-24
"2","Sun","September 11","L","","0-2",FALSE,"Dallas Cowboys",17,20,20,339,202,137,2,18,340,225,115,1,1994-09-11,-1,0,"oti",-3
"3","Sun","September 18","L","","0-3",TRUE,"Buffalo Bills",7,15,13,256,159,97,3,17,298,183,115,1,1994-09-18,-2,0,"oti",-8
"4","Sun","September 25","W","","1-3",TRUE,"Cincinnati Bengals",20,13,19,341,193,148,4,13,176,74,102,4,1994-09-25,0,1,"oti",7
"5","Mon","October 3","L","","1-4",FALSE,"Pittsburgh Steelers",14,30,14,290,221,69,2,21,379,164,215,0,1994-10-03,-2,0,"oti",-16
"7","Thu","October 13","L","","1-5",TRUE,"Cleveland Browns",8,11,20,305,199,106,2,12,260,196,64,2,1994-10-13,0,0,"oti",-3
"8","Mon","October 24","L","","1-6",FALSE,"Philadelphia Eagles",6,21,15,282,214,68,4,14,372,287,85,2,1994-10-24,-2,0,"oti",-15
"9","Sun","October 30","L","","1-7",FALSE,"Los Angeles Raiders",14,17,21,302,203,99,3,16,278,144,134,4,1994-10-30,1,0,"oti",-3
"10","Sun","November 6","L","OT","1-8",TRUE,"Pittsburgh Steelers",9,12,17,244,160,84,1,17,266,155,111,0,1994-11-06,-1,0,"oti",-3
"11","Sun","November 13","L","","1-9",FALSE,"Cincinnati Bengals",31,34,24,284,129,155,0,17,387,348,39,2,1994-11-13,2,0,"oti",-3
"12","Mon","November 21","L","","1-10",TRUE,"New York Giants",10,13,13,278,112,166,0,18,287,124,163,0,1994-11-21,0,0,"oti",-3
"13","Sun","November 27","L","","1-11",FALSE,"Cleveland Browns",10,34,11,182,102,80,2,23,343,199,144,3,1994-11-27,1,0,"oti",-24
"14","Sun","December 4","L","","1-12",TRUE,"Arizona Cardinals",12,30,10,198,161,37,6,18,332,171,161,1,1994-12-04,-5,0,"oti",-18
"15","Sun","December 11","L","","1-13",TRUE,"Seattle Seahawks",14,16,14,208,145,63,2,21,330,64,266,1,1994-12-11,-1,0,"oti",-2
"16","Sun","December 18","L","","1-14",FALSE,"Kansas City Chiefs",9,31,16,217,98,119,5,17,363,228,135,0,1994-12-18,-5,0,"oti",-22
"17","Sat","December 24","W","","2-14",TRUE,"New York Jets",24,10,25,381,206,175,3,14,216,127,89,3,1994-12-24,0,1,"oti",14
"1","Sun","September 3","W","","1-0",FALSE,"Jacksonville Jaguars",10,3,14,240,80,160,1,10,146,45,101,2,1995-09-03,1,1,"oti",7
"2","Sun","September 10","L","","1-1",TRUE,"Pittsburgh Steelers",17,34,19,216,178,38,3,19,250,123,127,1,1995-09-10,-2,0,"oti",-17
"3","Sun","September 17","L","","1-2",TRUE,"Cleveland Browns",7,14,20,327,256,71,4,14,270,138,132,0,1995-09-17,-4,0,"oti",-7
"4","Sun","September 24","W","","2-2",FALSE,"Cincinnati Bengals",38,28,24,487,350,137,1,20,407,347,60,2,1995-09-24,1,1,"oti",10
"5","Sun","October 1","L","","2-3",TRUE,"Jacksonville Jaguars",16,17,19,297,206,91,3,16,219,151,68,3,1995-10-01,0,0,"oti",-1
"6","Sun","October 8","L","OT","2-4",FALSE,"Minnesota Vikings",17,23,15,203,128,75,2,21,388,281,107,3,1995-10-08,1,0,"oti",-6
"8","Sun","October 22","L","","2-5",FALSE,"Chicago Bears",32,35,15,327,281,46,3,26,480,349,131,3,1995-10-22,0,0,"oti",-3
"9","Sun","October 29","W","","3-5",TRUE,"Tampa Bay Buccaneers",19,7,22,275,156,119,1,10,155,61,94,3,1995-10-29,2,1,"oti",12
"10","Sun","November 5","W","","4-5",FALSE,"Cleveland Browns",37,10,16,277,141,136,1,25,367,265,102,5,1995-11-05,4,1,"oti",27
"11","Sun","November 12","L","","4-6",TRUE,"Cincinnati Bengals",25,32,19,287,180,107,4,16,300,220,80,3,1995-11-12,-1,0,"oti",-7
"12","Sun","November 19","L","","4-7",FALSE,"Kansas City Chiefs",13,20,16,294,189,105,4,11,181,115,66,2,1995-11-19,-2,0,"oti",-7
"13","Sun","November 26","W","","5-7",TRUE,"Denver Broncos",42,33,23,448,280,168,2,22,472,332,140,2,1995-11-26,0,1,"oti",9
"14","Sun","December 3","L","","5-8",FALSE,"Pittsburgh Steelers",7,21,11,249,174,75,2,17,358,205,153,4,1995-12-03,2,0,"oti",-14
"15","Sun","December 10","L","","5-9",TRUE,"Detroit Lions",17,24,26,405,312,93,6,15,322,263,59,4,1995-12-10,-2,0,"oti",-7
"16","Sun","December 17","W","","6-9",TRUE,"New York Jets",23,6,21,274,166,108,0,10,164,134,30,0,1995-12-17,0,1,"oti",17
"17","Sun","December 24","W","","7-9",FALSE,"Buffalo Bills",28,17,15,299,164,135,1,15,172,96,76,1,1995-12-24,0,1,"oti",11
"1","Sun","September 1","L","","0-1",TRUE,"Kansas City Chiefs",19,20,16,263,191,72,1,17,248,169,79,2,1996-09-01,1,0,"oti",-1
"2","Sun","September 8","W","","1-1",FALSE,"Jacksonville Jaguars",34,27,21,401,220,181,1,26,370,298,72,3,1996-09-08,2,1,"oti",7
"3","Sun","September 15","W","","2-1",TRUE,"Baltimore Ravens",29,13,19,312,172,140,0,19,281,208,73,3,1996-09-15,3,1,"oti",16
"5","Sun","September 29","L","","2-2",FALSE,"Pittsburgh Steelers",16,30,16,273,193,80,5,15,309,197,112,2,1996-09-29,-3,0,"oti",-14
"6","Sun","October 6","W","OT","3-2",FALSE,"Cincinnati Bengals",30,27,18,335,175,160,2,22,315,152,163,0,1996-10-06,-2,1,"oti",3
"7","Sun","October 13","W","","4-2",FALSE,"Atlanta Falcons",23,13,16,320,199,121,1,20,323,268,55,2,1996-10-13,1,1,"oti",10
"8","Sun","October 20","W","","5-2",TRUE,"Pittsburgh Steelers",23,13,23,328,237,91,2,12,275,192,83,2,1996-10-20,0,1,"oti",10
"9","Sun","October 27","L","","5-3",TRUE,"San Francisco 49ers",9,10,12,184,77,107,2,12,238,175,63,0,1996-10-27,-2,0,"oti",-1
"10","Sun","November 3","L","","5-4",FALSE,"Seattle Seahawks",16,23,13,353,225,128,1,19,342,310,32,1,1996-11-03,0,0,"oti",-7
"11","Sun","November 10","W","","6-4",FALSE,"New Orleans Saints",31,14,20,309,161,148,1,14,227,154,73,2,1996-11-10,1,1,"oti",17
"12","Sun","November 17","L","","6-5",TRUE,"Miami Dolphins",20,23,17,261,164,97,1,17,303,209,94,2,1996-11-17,1,0,"oti",-3
"13","Sun","November 24","L","","6-6",TRUE,"Carolina Panthers",6,31,17,271,186,85,4,12,254,160,94,1,1996-11-24,-3,0,"oti",-25
"14","Sun","December 1","W","","7-6",FALSE,"New York Jets",35,10,18,385,142,243,1,15,264,185,79,3,1996-12-01,2,1,"oti",25
"15","Sun","December 8","L","","7-7",TRUE,"Jacksonville Jaguars",17,23,21,361,287,74,4,19,279,165,114,1,1996-12-08,-3,0,"oti",-6
"16","Sun","December 15","L","","7-8",TRUE,"Cincinnati Bengals",13,21,22,341,235,106,4,12,205,126,79,0,1996-12-15,-4,0,"oti",-8
"17","Sun","December 22","W","","8-8",FALSE,"Baltimore Ravens",24,21,18,351,234,117,0,20,377,257,120,2,1996-12-22,2,1,"oti",3
"1","Sun","August 31","W","OT","1-0",TRUE,"Oakland Raiders",24,21,20,419,164,255,2,17,332,287,45,1,1997-08-31,-1,1,"oti",3
"2","Sun","September 7","L","OT","1-1",FALSE,"Miami Dolphins",13,16,13,294,109,185,1,21,354,300,54,1,1997-09-07,0,0,"oti",-3
"4","Sun","September 21","L","","1-2",TRUE,"Baltimore Ravens",10,36,18,285,188,97,5,21,398,309,89,0,1997-09-21,-5,0,"oti",-26
"5","Sun","September 28","L","","1-3",FALSE,"Pittsburgh Steelers",24,37,20,284,226,58,3,19,399,262,137,1,1997-09-28,-2,0,"oti",-13
"6","Sun","October 5","L","","1-4",FALSE,"Seattle Seahawks",13,16,18,253,97,156,2,20,405,238,167,2,1997-10-05,0,0,"oti",-3
"7","Sun","October 12","W","","2-4",TRUE,"Cincinnati Bengals",30,7,26,391,193,198,0,14,202,137,65,1,1997-10-12,1,1,"oti",23
"8","Sun","October 19","W","","3-4",TRUE,"Washington Redskins",28,14,23,389,185,204,0,18,312,220,92,3,1997-10-19,3,1,"oti",14
"9","Sun","October 26","W","","4-4",FALSE,"Arizona Cardinals",41,14,15,283,135,148,0,22,263,157,106,7,1997-10-26,7,1,"oti",27
"10","Sun","November 2","L","","4-5",TRUE,"Jacksonville Jaguars",24,30,15,302,195,107,2,17,290,155,135,2,1997-11-02,0,0,"oti",-6
"11","Sun","November 9","W","","5-5",TRUE,"New York Giants",10,6,19,326,173,153,2,10,218,111,107,1,1997-11-09,-1,1,"oti",4
"12","Sun","November 16","L","","5-6",FALSE,"Jacksonville Jaguars",9,17,17,320,184,136,2,21,352,249,103,2,1997-11-16,0,0,"oti",-8
"13","Sun","November 23","W","","6-6",TRUE,"Buffalo Bills",31,14,21,322,159,163,1,12,290,286,4,2,1997-11-23,1,1,"oti",17
"14","Thu","November 27","W","","7-6",FALSE,"Dallas Cowboys",27,14,14,245,81,164,1,16,386,340,46,5,1997-11-27,4,1,"oti",13
"15","Thu","December 4","L","","7-7",FALSE,"Cincinnati Bengals",14,41,12,175,131,44,0,34,515,239,276,0,1997-12-04,0,0,"oti",-27
"16","Sun","December 14","L","","7-8",FALSE,"Baltimore Ravens",19,21,23,390,200,190,4,11,246,192,54,1,1997-12-14,-3,0,"oti",-2
"17","Sun","December 21","W","","8-8",TRUE,"Pittsburgh Steelers",16,6,14,241,85,156,1,19,269,176,93,3,1997-12-21,2,1,"oti",10
"1","Sun","September 6","W","","1-0",FALSE,"Cincinnati Bengals",23,14,19,353,264,89,0,16,292,192,100,1,1998-09-06,1,1,"oti",9
"2","Sun","September 13","L","","1-1",TRUE,"San Diego Chargers",7,13,18,250,187,63,0,18,320,179,141,0,1998-09-13,0,0,"oti",-6
"3","Sun","September 20","L","","1-2",FALSE,"New England Patriots",16,27,18,306,194,112,2,13,322,228,94,0,1998-09-20,-2,0,"oti",-11
"4","Sun","September 27","L","","1-3",TRUE,"Jacksonville Jaguars",22,27,15,219,179,40,3,19,297,149,148,3,1998-09-27,0,0,"oti",-5
"6","Sun","October 11","W","","2-3",FALSE,"Baltimore Ravens",12,8,16,344,178,166,1,13,263,227,36,1,1998-10-11,0,1,"oti",4
"7","Sun","October 18","W","","3-3",TRUE,"Cincinnati Bengals",44,14,24,515,344,171,0,14,332,184,148,1,1998-10-18,1,1,"oti",30
"8","Sun","October 25","L","","3-4",TRUE,"Chicago Bears",20,23,25,356,176,180,4,20,286,138,148,1,1998-10-25,-3,0,"oti",-3
"9","Sun","November 1","W","","4-4",FALSE,"Pittsburgh Steelers",41,31,19,321,152,169,0,26,401,347,54,3,1998-11-01,3,1,"oti",10
"10","Sun","November 8","W","","5-4",FALSE,"Tampa Bay Buccaneers",31,22,20,353,117,236,1,19,397,294,103,1,1998-11-08,0,1,"oti",9
"11","Sun","November 15","W","","6-4",TRUE,"Pittsburgh Steelers",23,14,18,338,230,108,1,16,310,231,79,2,1998-11-15,1,1,"oti",9
"12","Sun","November 22","L","","6-5",TRUE,"New York Jets",3,24,12,223,129,94,1,22,361,231,130,0,1998-11-22,-1,0,"oti",-21
"13","Sun","November 29","L","","6-6",FALSE,"Seattle Seahawks",18,20,23,343,179,164,2,20,378,296,82,3,1998-11-29,1,0,"oti",-2
"14","Sun","December 6","W","","7-6",TRUE,"Baltimore Ravens",16,14,19,291,213,78,1,10,221,163,58,1,1998-12-06,0,1,"oti",2
"15","Sun","December 13","W","","8-6",FALSE,"Jacksonville Jaguars",16,13,20,354,223,131,2,15,241,172,69,1,1998-12-13,-1,1,"oti",3
"16","Sun","December 20","L","","8-7",FALSE,"Green Bay Packers",22,30,22,341,262,79,1,16,362,245,117,0,1998-12-20,-1,0,"oti",-8
"17","Sat","December 26","L","","8-8",TRUE,"Minnesota Vikings",16,26,20,354,264,90,0,22,338,235,103,1,1998-12-26,1,0,"oti",-10
"1","Sun","September 12","W","","1-0",TRUE,"Cincinnati Bengals",36,35,22,403,334,69,4,28,398,197,201,2,1999-09-12,-2,1,"oti",1
"2","Sun","September 19","W","","2-0",TRUE,"Cleveland Browns",26,9,24,412,310,102,0,12,173,90,83,1,1999-09-19,1,1,"oti",17
"3","Sun","September 26","W","","3-0",FALSE,"Jacksonville Jaguars",20,19,15,242,191,51,2,22,369,232,137,4,1999-09-26,2,1,"oti",1
"4","Sun","October 3","L","","3-1",FALSE,"San Francisco 49ers",22,24,17,392,337,55,1,17,329,243,86,0,1999-10-03,-1,0,"oti",-2
"5","Sun","October 10","W","","4-1",TRUE,"Baltimore Ravens",14,11,16,272,216,56,0,16,246,178,68,1,1999-10-10,1,1,"oti",3
"6","Sun","October 17","W","","5-1",FALSE,"New Orleans Saints",24,21,15,278,113,165,3,22,409,354,55,4,1999-10-17,1,1,"oti",3
"8","Sun","October 31","W","","6-1",TRUE,"St. Louis Rams",24,21,17,281,178,103,0,23,415,287,128,3,1999-10-31,3,1,"oti",3
"9","Sun","November 7","L","","6-2",FALSE,"Miami Dolphins",0,17,14,293,190,103,3,14,237,185,52,1,1999-11-07,-2,0,"oti",-17
"10","Sun","November 14","W","","7-2",FALSE,"Cincinnati Bengals",24,14,16,247,98,149,1,15,264,197,67,4,1999-11-14,3,1,"oti",10
"11","Sun","November 21","W","","8-2",TRUE,"Pittsburgh Steelers",16,10,17,261,149,112,1,14,267,161,106,1,1999-11-21,0,1,"oti",6
"12","Sun","November 28","W","","9-2",FALSE,"Cleveland Browns",33,21,22,337,179,158,1,18,309,228,81,2,1999-11-28,1,1,"oti",12
"13","Sun","December 5","L","","9-3",FALSE,"Baltimore Ravens",14,41,21,353,288,65,2,17,448,332,116,1,1999-12-05,-1,0,"oti",-27
"14","Thu","December 9","W","","10-3",TRUE,"Oakland Raiders",21,14,17,307,103,204,1,21,364,253,111,3,1999-12-09,2,1,"oti",7
"15","Sun","December 19","W","","11-3",TRUE,"Atlanta Falcons",30,17,14,399,268,131,0,23,347,291,56,6,1999-12-19,6,1,"oti",13
"16","Sun","December 26","W","","12-3",TRUE,"Jacksonville Jaguars",41,14,26,476,328,148,0,16,237,172,65,3,1999-12-26,3,1,"oti",27
"17","Sun","January 2","W","","13-3",FALSE,"Pittsburgh Steelers",47,36,21,343,203,140,3,22,433,295,138,4,2000-01-02,1,1,"oti",11
"WildCard","Sat","January 8","W","","14-3",TRUE,"Buffalo Bills",22,16,16,194,55,139,2,13,219,96,123,2,2000-01-08,0,1,"oti",6
"Division","Sun","January 16","W","","15-3",FALSE,"Indianapolis Colts",19,16,13,309,112,197,1,19,305,227,78,0,2000-01-16,-1,1,"oti",3
"ConfChamp","Sun","January 23","W","","16-3",FALSE,"Jacksonville Jaguars",33,14,18,289,112,177,4,20,355,211,144,6,2000-01-23,2,1,"oti",19
"SuperBowl","Sun","January 30","L","","16-4",TRUE,"St. Louis Rams",16,23,27,367,208,159,0,23,436,407,29,0,2000-01-30,0,0,"oti",-7
"1","Sun","September 3","L","","0-1",FALSE,"Buffalo Bills",13,16,9,172,119,53,1,17,266,137,129,0,2000-09-03,-1,0,"oti",-3
"2","Sun","September 10","W","OT","1-1",TRUE,"Kansas City Chiefs",17,14,23,353,232,121,3,14,189,127,62,0,2000-09-10,-3,1,"oti",3
"4","Sun","September 24","W","","2-1",FALSE,"Pittsburgh Steelers",23,20,15,372,287,85,3,20,364,249,115,1,2000-09-24,-2,1,"oti",3
"5","Sun","October 1","W","","3-1",TRUE,"New York Giants",28,14,28,436,284,152,1,14,215,191,24,4,2000-10-01,3,1,"oti",14
"6","Sun","October 8","W","","4-1",FALSE,"Cincinnati Bengals",23,14,21,417,214,203,2,7,213,84,129,2,2000-10-08,0,1,"oti",9
"7","Mon","October 16","W","","5-1",TRUE,"Jacksonville Jaguars",27,13,18,409,234,175,1,13,304,161,143,2,2000-10-16,1,1,"oti",14
"8","Sun","October 22","W","","6-1",FALSE,"Baltimore Ravens",14,6,7,191,101,90,2,24,368,255,113,4,2000-10-22,2,1,"oti",8
"9","Mon","October 30","W","","7-1",FALSE,"Washington Redskins",27,21,13,189,93,96,0,21,266,176,90,3,2000-10-30,3,1,"oti",6
"10","Sun","November 5","W","","8-1",TRUE,"Pittsburgh Steelers",9,7,21,364,216,148,1,10,167,93,74,3,2000-11-05,2,1,"oti",2
"11","Sun","November 12","L","","8-2",TRUE,"Baltimore Ravens",23,24,17,286,224,62,2,19,361,258,103,1,2000-11-12,-1,0,"oti",-1
"12","Sun","November 19","W","","9-2",TRUE,"Cleveland Browns",24,10,23,374,192,182,7,5,125,80,45,1,2000-11-19,-6,1,"oti",14
"13","Sun","November 26","L","","9-3",FALSE,"Jacksonville Jaguars",13,16,17,334,217,117,0,16,334,223,111,2,2000-11-26,2,0,"oti",-3
"14","Sun","December 3","W","","10-3",FALSE,"Philadelphia Eagles",15,13,24,331,213,118,1,14,262,206,56,0,2000-12-03,-1,1,"oti",2
"15","Sun","December 10","W","","11-3",TRUE,"Cincinnati Bengals",35,3,21,443,331,112,1,9,171,111,60,0,2000-12-10,-1,1,"oti",32
"16","Sun","December 17","W","","12-3",FALSE,"Cleveland Browns",24,0,19,305,93,212,1,6,113,63,50,2,2000-12-17,1,1,"oti",24
"17","Mon","December 25","W","","13-3",TRUE,"Dallas Cowboys",31,0,23,374,216,158,4,6,95,9,86,5,2000-12-25,1,1,"oti",31
"Division","Sun","January 7","L","","13-4",TRUE,"Baltimore Ravens",10,24,23,317,191,126,1,6,134,85,49,0,2001-01-07,-1,0,"oti",-14
"1","Sun","September 9","L","","0-1",TRUE,"Miami Dolphins",23,31,19,315,210,105,3,11,307,225,82,2,2001-09-09,-1,0,"oti",-8
"2","Sun","September 23","L","","0-2",FALSE,"Jacksonville Jaguars",6,13,13,264,177,87,0,16,329,210,119,2,2001-09-23,2,0,"oti",-7
"4","Sun","October 7","L","","0-3",FALSE,"Baltimore Ravens",7,26,9,185,138,47,2,23,460,253,207,0,2001-10-07,-2,0,"oti",-19
"5","Sun","October 14","W","OT","1-3",TRUE,"Tampa Bay Buccaneers",31,28,21,365,223,142,1,22,306,282,24,1,2001-10-14,0,1,"oti",3
"6","Sun","October 21","W","","2-3",FALSE,"Detroit Lions",27,24,18,329,227,102,2,18,363,322,41,2,2001-10-21,0,1,"oti",3
"7","Mon","October 29","L","","2-4",FALSE,"Pittsburgh Steelers",7,34,15,214,157,57,4,24,405,272,133,0,2001-10-29,-4,0,"oti",-27
"8","Sun","November 4","W","","3-4",TRUE,"Jacksonville Jaguars",28,24,27,362,216,146,0,20,309,239,70,1,2001-11-04,1,1,"oti",4
"9","Mon","November 12","L","","3-5",TRUE,"Baltimore Ravens",10,16,20,318,228,90,2,12,238,161,77,2,2001-11-12,0,0,"oti",-6
"10","Sun","November 18","W","","4-5",FALSE,"Cincinnati Bengals",20,7,13,293,164,129,2,17,264,224,40,3,2001-11-18,1,1,"oti",13
"11","Sun","November 25","L","","4-6",TRUE,"Pittsburgh Steelers",24,34,21,405,324,81,2,20,377,247,130,0,2001-11-25,-2,0,"oti",-10
"12","Sun","December 2","W","","5-6",FALSE,"Cleveland Browns",31,15,14,383,272,111,0,16,282,217,65,3,2001-12-02,3,1,"oti",16
"13","Sun","December 9","L","","5-7",FALSE,"Minnesota Vikings",24,42,24,453,271,182,2,24,496,348,148,1,2001-12-09,-1,0,"oti",-18
"14","Sun","December 16","W","","6-7",TRUE,"Green Bay Packers",26,20,23,423,256,167,2,14,223,192,31,2,2001-12-16,0,1,"oti",6
"15","Sat","December 22","W","","7-7",FALSE,"Oakland Raiders",13,10,14,262,159,103,2,20,311,234,77,1,2001-12-22,-1,1,"oti",3
"16","Sun","December 30","L","","7-8",TRUE,"Cleveland Browns",38,41,21,452,264,188,2,18,409,322,87,1,2001-12-30,-1,0,"oti",-3
"17","Sun","January 6","L","","7-9",TRUE,"Cincinnati Bengals",21,23,16,329,272,57,2,25,436,336,100,3,2002-01-06,1,0,"oti",-2
"1","Sun","September 8","W","","1-0",TRUE,"Philadelphia Eagles",27,24,22,328,267,61,4,17,261,181,80,3,2002-09-08,-1,1,"oti",3
"2","Sun","September 15","L","","1-1",FALSE,"Dallas Cowboys",13,21,19,333,235,98,1,14,297,230,67,0,2002-09-15,-1,0,"oti",-8
"3","Sun","September 22","L","OT","1-2",TRUE,"Cleveland Browns",28,31,13,187,101,86,0,26,403,311,92,4,2002-09-22,4,0,"oti",-3
"4","Sun","September 29","L","","1-3",FALSE,"Oakland Raiders",25,52,23,430,387,43,4,24,464,374,90,1,2002-09-29,-3,0,"oti",-27
"5","Sun","October 6","L","","1-4",TRUE,"Washington Redskins",14,31,17,289,230,59,4,25,442,286,156,0,2002-10-06,-4,0,"oti",-17
"6","Sun","October 13","W","","2-4",TRUE,"Jacksonville Jaguars",23,14,25,370,218,152,1,13,198,68,130,2,2002-10-13,1,1,"oti",9
"8","Sun","October 27","W","","3-4",FALSE,"Cincinnati Bengals",30,24,20,342,208,134,1,22,384,193,191,1,2002-10-27,0,1,"oti",6
"9","Sun","November 3","W","","4-4",FALSE,"Indianapolis Colts",23,15,13,198,77,121,0,25,378,298,80,3,2002-11-03,3,1,"oti",8
"10","Sun","November 10","W","","5-4",TRUE,"Houston Texans",17,10,15,251,109,142,2,13,233,165,68,3,2002-11-10,1,1,"oti",7
"11","Sun","November 17","W","","6-4",TRUE,"Pittsburgh Steelers",31,23,22,378,257,121,1,20,357,312,45,3,2002-11-17,2,1,"oti",8
"12","Sun","November 24","L","","6-5",FALSE,"Baltimore Ravens",12,13,19,402,281,121,4,12,199,87,112,2,2002-11-24,-2,0,"oti",-1
"13","Sun","December 1","W","OT","7-5",FALSE,"New York Giants",32,29,31,476,334,142,1,24,345,283,62,0,2002-12-01,-1,1,"oti",3
"14","Sun","December 8","W","","8-5",TRUE,"Indianapolis Colts",27,17,18,348,229,119,1,22,389,297,92,3,2002-12-08,2,1,"oti",10
"15","Mon","December 16","W","","9-5",TRUE,"New England Patriots",24,7,20,365,127,238,1,11,176,120,56,2,2002-12-16,1,1,"oti",17
"16","Sun","December 22","W","","10-5",FALSE,"Jacksonville Jaguars",28,10,20,298,123,175,0,13,214,139,75,1,2002-12-22,1,1,"oti",18
"17","Sun","December 29","W","","11-5",FALSE,"Houston Texans",13,3,15,277,137,140,0,16,224,196,28,1,2002-12-29,1,1,"oti",10
"Division","Sat","January 11","W","OT","12-5",TRUE,"Pittsburgh Steelers",34,31,29,430,331,99,4,21,324,257,67,1,2003-01-11,-3,1,"oti",3
"ConfChamp","Sun","January 19","L","","12-6",FALSE,"Oakland Raiders",24,41,28,312,174,138,2,25,375,286,89,1,2003-01-19,-1,0,"oti",-17
"1","Sun","September 7","W","","1-0",TRUE,"Oakland Raiders",25,20,20,334,258,76,2,13,280,246,34,1,2003-09-07,-1,1,"oti",5
"2","Sun","September 14","L","","1-1",FALSE,"Indianapolis Colts",7,33,14,236,183,53,2,20,291,164,127,0,2003-09-14,-2,0,"oti",-26
"3","Sun","September 21","W","","2-1",TRUE,"New Orleans Saints",27,12,28,385,280,105,1,11,188,165,23,2,2003-09-21,1,1,"oti",15
"4","Sun","September 28","W","","3-1",FALSE,"Pittsburgh Steelers",30,13,9,198,158,40,0,25,376,307,69,2,2003-09-28,2,1,"oti",17
"5","Sun","October 5","L","","3-2",FALSE,"New England Patriots",30,38,23,411,341,70,1,21,354,193,161,0,2003-10-05,-1,0,"oti",-8
"6","Sun","October 12","W","","4-2",TRUE,"Houston Texans",38,17,22,535,421,114,1,24,458,367,91,3,2003-10-12,2,1,"oti",21
"7","Sun","October 19","W","","5-2",FALSE,"Carolina Panthers",37,17,15,348,214,134,0,19,383,339,44,4,2003-10-19,4,1,"oti",20
"8","Sun","October 26","W","","6-2",FALSE,"Jacksonville Jaguars",30,17,23,320,187,133,1,15,293,239,54,3,2003-10-26,2,1,"oti",13
"10","Sun","November 9","W","","7-2",TRUE,"Miami Dolphins",31,7,17,324,223,101,0,12,224,165,59,5,2003-11-09,5,1,"oti",24
"11","Sun","November 16","W","","8-2",TRUE,"Jacksonville Jaguars",10,3,13,246,150,96,3,16,271,145,126,2,2003-11-16,-1,1,"oti",7
"12","Sun","November 23","W","","9-2",FALSE,"Atlanta Falcons",38,31,20,347,203,144,1,16,282,257,25,2,2003-11-23,1,1,"oti",7
"13","Mon","December 1","L","","9-3",FALSE,"New York Jets",17,24,19,347,263,84,2,19,320,223,97,2,2003-12-01,0,0,"oti",-7
"14","Sun","December 7","L","","9-4",TRUE,"Indianapolis Colts",27,29,23,327,234,93,4,21,340,224,116,0,2003-12-07,-4,0,"oti",-2
"15","Sun","December 14","W","","10-4",TRUE,"Buffalo Bills",28,26,23,349,263,86,1,13,241,152,89,1,2003-12-14,0,1,"oti",2
"16","Sun","December 21","W","","11-4",FALSE,"Houston Texans",27,24,21,450,268,182,1,14,326,235,91,3,2003-12-21,2,1,"oti",3
"17","Sun","December 28","W","","12-4",TRUE,"Tampa Bay Buccaneers",33,13,20,344,232,112,1,16,274,185,89,4,2003-12-28,3,1,"oti",20
"WildCard","Sat","January 3","W","","13-4",FALSE,"Baltimore Ravens",20,17,16,324,159,165,3,12,255,201,54,2,2004-01-03,-1,1,"oti",3
"Division","Sat","January 10","L","","13-5",FALSE,"New England Patriots",14,17,16,284,200,84,1,18,297,201,96,1,2004-01-10,0,0,"oti",-3
"1","Sat","September 11","W","","1-0",FALSE,"Miami Dolphins",17,7,15,243,61,182,1,14,263,198,65,3,2004-09-11,2,1,"oti",10
"2","Sun","September 19","L","","1-1",TRUE,"Indianapolis Colts",17,31,25,389,236,153,2,27,373,244,129,1,2004-09-19,-1,0,"oti",-14
"3","Sun","September 26","L","","1-2",TRUE,"Jacksonville Jaguars",12,15,13,249,130,119,1,15,253,117,136,0,2004-09-26,-1,0,"oti",-3
"4","Sun","October 3","L","","1-3",FALSE,"San Diego Chargers",17,38,21,330,258,72,0,16,393,198,195,0,2004-10-03,0,0,"oti",-21
"5","Mon","October 11","W","","2-3",FALSE,"Green Bay Packers",48,27,23,456,232,224,0,22,437,402,35,6,2004-10-11,6,1,"oti",21
"6","Sun","October 17","L","","2-4",TRUE,"Houston Texans",10,20,19,305,204,101,4,19,345,247,98,2,2004-10-17,-2,0,"oti",-10
"7","Sun","October 24","L","","2-5",FALSE,"Minnesota Vikings",3,20,16,243,188,55,4,20,313,161,152,0,2004-10-24,-4,0,"oti",-17
"8","Sun","October 31","W","","3-5",TRUE,"Cincinnati Bengals",27,20,22,358,195,163,1,16,274,217,57,2,2004-10-31,1,1,"oti",7
"10","Sun","November 14","L","OT","3-6",TRUE,"Chicago Bears",17,19,14,390,318,72,3,10,176,75,101,3,2004-11-14,0,0,"oti",-2
"11","Sun","November 21","W","","4-6",FALSE,"Jacksonville Jaguars",18,15,14,295,192,103,2,18,274,123,151,2,2004-11-21,0,1,"oti",3
"12","Sun","November 28","L","","4-7",FALSE,"Houston Texans",21,31,23,355,221,134,3,19,328,179,149,1,2004-11-28,-2,0,"oti",-10
"13","Sun","December 5","L","","4-8",FALSE,"Indianapolis Colts",24,51,17,340,225,115,2,29,567,417,150,3,2004-12-05,1,0,"oti",-27
"14","Mon","December 13","L","","4-9",TRUE,"Kansas City Chiefs",38,49,30,542,379,163,4,24,383,237,146,2,2004-12-13,-2,0,"oti",-11
"15","Sun","December 19","L","","4-10",FALSE,"Oakland Raiders",35,40,31,527,466,61,2,20,415,358,57,1,2004-12-19,-1,0,"oti",-5
"16","Sat","December 25","L","","4-11",TRUE,"Denver Broncos",16,37,10,153,94,59,2,26,496,303,193,2,2004-12-25,0,0,"oti",-21
"17","Sun","January 2","W","","5-11",TRUE,"Detroit Lions",24,19,15,312,217,95,0,23,434,331,103,2,2005-01-02,2,1,"oti",5
"1","Sun","September 11","L","","0-1",FALSE,"Pittsburgh Steelers",7,34,16,303,206,97,4,18,424,218,206,0,2005-09-11,-4,0,"oti",-27
"2","Sun","September 18","W","","1-1",TRUE,"Baltimore Ravens",25,10,16,290,193,97,1,12,182,168,14,2,2005-09-18,1,1,"oti",15
"3","Sun","September 25","L","","1-2",FALSE,"St. Louis Rams",27,31,18,335,248,87,3,22,360,259,101,4,2005-09-25,1,0,"oti",-4
"4","Sun","October 2","L","","1-3",TRUE,"Indianapolis Colts",10,31,18,313,204,109,1,22,364,264,100,0,2005-10-02,-1,0,"oti",-21
"5","Sun","October 9","W","","2-3",FALSE,"Houston Texans",34,20,22,310,220,90,0,14,257,96,161,1,2005-10-09,1,1,"oti",14
"6","Sun","October 16","L","","2-4",TRUE,"Cincinnati Bengals",23,31,21,377,259,118,3,24,387,268,119,0,2005-10-16,-3,0,"oti",-8
"7","Sun","October 23","L","","2-5",FALSE,"Arizona Cardinals",10,20,16,348,258,90,3,9,173,118,55,1,2005-10-23,-2,0,"oti",-10
"8","Sun","October 30","L","","2-6",TRUE,"Oakland Raiders",25,34,19,326,186,140,2,17,324,232,92,1,2005-10-30,-1,0,"oti",-9
"9","Sun","November 6","L","","2-7",FALSE,"Cleveland Browns",14,20,19,323,225,98,1,16,441,272,169,2,2005-11-06,1,0,"oti",-6
"11","Sun","November 20","L","","2-8",TRUE,"Jacksonville Jaguars",28,31,16,254,191,63,1,22,295,246,49,1,2005-11-20,0,0,"oti",-3
"12","Sun","November 27","W","","3-8",TRUE,"San Francisco 49ers",33,22,15,461,343,118,1,15,261,187,74,4,2005-11-27,3,1,"oti",11
"13","Sun","December 4","L","","3-9",FALSE,"Indianapolis Colts",3,35,17,260,207,53,1,21,292,187,105,1,2005-12-04,0,0,"oti",-32
"14","Sun","December 11","W","","4-9",TRUE,"Houston Texans",13,10,15,301,208,93,0,12,234,82,152,0,2005-12-11,0,1,"oti",3
"15","Sun","December 18","L","","4-10",TRUE,"Seattle Seahawks",24,28,25,417,336,81,0,26,459,276,183,0,2005-12-18,0,0,"oti",-4
"16","Sat","December 24","L","","4-11",FALSE,"Miami Dolphins",10,24,11,234,142,92,3,19,322,130,192,2,2005-12-24,-1,0,"oti",-14
"17","Sun","January 1","L","","4-12",FALSE,"Jacksonville Jaguars",13,40,15,270,171,99,2,25,335,213,122,1,2006-01-01,-1,0,"oti",-27
"1","Sun","September 10","L","","0-1",TRUE,"New York Jets",16,23,22,328,242,86,3,24,393,302,91,2,2006-09-10,-1,0,"oti",-7
"2","Sun","September 17","L","","0-2",FALSE,"San Diego Chargers",7,40,14,218,163,55,2,26,476,235,241,0,2006-09-17,-2,0,"oti",-33
"3","Sun","September 24","L","","0-3",FALSE,"Miami Dolphins",10,13,14,316,254,62,3,17,289,130,159,1,2006-09-24,-2,0,"oti",-3
"4","Sun","October 1","L","","0-4",TRUE,"Dallas Cowboys",14,45,16,229,151,78,3,23,396,179,217,1,2006-10-01,-2,0,"oti",-31
"5","Sun","October 8","L","","0-5",FALSE,"Indianapolis Colts",13,14,15,277,63,214,1,20,320,166,154,2,2006-10-08,1,0,"oti",-1
"6","Sun","October 15","W","","1-5",FALSE,"Washington Redskins",25,22,21,344,151,193,0,18,305,180,125,2,2006-10-15,2,1,"oti",3
"8","Sun","October 29","W","","2-5",TRUE,"Houston Texans",28,22,10,197,86,111,0,26,427,279,148,5,2006-10-29,5,1,"oti",6
"9","Sun","November 5","L","","2-6",FALSE,"Jacksonville Jaguars",7,37,14,262,154,108,3,17,342,169,173,0,2006-11-05,-3,0,"oti",-30
"10","Sun","November 12","L","","2-7",TRUE,"Baltimore Ravens",26,27,19,367,205,162,1,19,421,371,50,2,2006-11-12,1,0,"oti",-1
"11","Sun","November 19","W","","3-7",FALSE,"Philadelphia Eagles",31,13,13,293,84,209,1,22,390,267,123,3,2006-11-19,2,1,"oti",18
"12","Sun","November 26","W","","4-7",TRUE,"New York Giants",24,21,20,343,235,108,2,18,287,143,144,2,2006-11-26,0,1,"oti",3
"13","Sun","December 3","W","","5-7",TRUE,"Indianapolis Colts",20,17,21,382,163,219,2,20,451,351,100,2,2006-12-03,0,1,"oti",3
"14","Sun","December 10","W","OT","6-7",FALSE,"Houston Texans",26,20,22,418,200,218,2,15,240,133,107,0,2006-12-10,-2,1,"oti",6
"15","Sun","December 17","W","","7-7",TRUE,"Jacksonville Jaguars",24,17,5,98,57,41,0,23,396,203,193,4,2006-12-17,4,1,"oti",7
"16","Sun","December 24","W","","8-7",FALSE,"Buffalo Bills",30,29,18,396,181,215,0,22,368,251,117,2,2006-12-24,2,1,"oti",1
"17","Sun","December 31","L","","8-8",TRUE,"New England Patriots",23,40,17,342,207,135,3,19,414,243,171,0,2006-12-31,-3,0,"oti",-17
"1","Sun","September 9","W","","1-0",FALSE,"Jacksonville Jaguars",13,10,22,350,68,282,2,13,272,197,75,1,2007-09-09,-1,1,"oti",3
"2","Sun","September 16","L","","1-1",TRUE,"Indianapolis Colts",20,22,19,313,172,141,2,23,381,300,81,1,2007-09-16,-1,0,"oti",-2
"3","Mon","September 24","W","","2-1",FALSE,"New Orleans Saints",31,14,19,284,186,98,1,18,252,218,34,5,2007-09-24,4,1,"oti",17
"5","Sun","October 7","W","","3-1",TRUE,"Atlanta Falcons",20,13,20,249,157,92,5,9,198,99,99,2,2007-10-07,-3,1,"oti",7
"6","Sun","October 14","L","","3-2",FALSE,"Tampa Bay Buccaneers",10,13,20,317,221,96,3,13,304,274,30,1,2007-10-14,-2,0,"oti",-3
"7","Sun","October 21","W","","4-2",FALSE,"Houston Texans",38,36,23,422,267,155,2,18,333,294,39,6,2007-10-21,4,1,"oti",2
"8","Sun","October 28","W","","5-2",TRUE,"Oakland Raiders",13,9,11,218,26,192,0,14,235,143,92,2,2007-10-28,2,1,"oti",4
"9","Sun","November 4","W","","6-2",TRUE,"Carolina Panthers",20,7,20,236,96,140,4,15,191,113,78,2,2007-11-04,-2,1,"oti",13
"10","Sun","November 11","L","","6-3",TRUE,"Jacksonville Jaguars",13,28,17,292,230,62,3,19,262,96,166,1,2007-11-11,-2,0,"oti",-15
"11","Mon","November 19","L","","6-4",FALSE,"Denver Broncos",20,34,28,423,290,133,3,15,359,193,166,1,2007-11-19,-2,0,"oti",-14
"12","Sun","November 25","L","","6-5",FALSE,"Cincinnati Bengals",6,35,10,305,244,61,2,30,426,278,148,1,2007-11-25,-1,0,"oti",-29
"13","Sun","December 2","W","","7-5",TRUE,"Houston Texans",28,20,23,382,229,153,1,17,315,196,119,2,2007-12-02,1,1,"oti",8
"14","Sun","December 9","L","OT","7-6",TRUE,"San Diego Chargers",17,23,13,240,109,131,2,20,341,193,148,3,2007-12-09,1,0,"oti",-6
"15","Sun","December 16","W","","8-6",FALSE,"Kansas City Chiefs",26,17,19,327,179,148,0,17,306,217,89,3,2007-12-16,3,1,"oti",9
"16","Sun","December 23","W","","9-6",TRUE,"New York Jets",10,6,17,273,146,127,2,14,296,228,68,2,2007-12-23,0,1,"oti",4
"17","Sun","December 30","W","","10-6",FALSE,"Indianapolis Colts",16,10,25,356,258,98,2,13,194,148,46,1,2007-12-30,-1,1,"oti",6
"WildCard","Sun","January 6","L","","10-7",FALSE,"San Diego Chargers",6,17,15,248,129,119,2,17,350,282,68,1,2008-01-06,-1,0,"oti",-11
"1","Sun","September 7","W","","1-0",TRUE,"Jacksonville Jaguars",17,10,14,309,172,137,2,13,189,156,33,3,2008-09-07,1,1,"oti",7
"2","Sun","September 14","W","","2-0",FALSE,"Cincinnati Bengals",24,7,16,295,118,177,1,11,215,127,88,2,2008-09-14,1,1,"oti",17
"3","Sun","September 21","W","","3-0",TRUE,"Houston Texans",31,12,19,343,185,158,2,18,317,171,146,3,2008-09-21,1,1,"oti",19
"4","Sun","September 28","W","","4-0",TRUE,"Minnesota Vikings",30,17,16,275,199,76,1,18,333,253,80,4,2008-09-28,3,1,"oti",13
"5","Sun","October 5","W","","5-0",FALSE,"Baltimore Ravens",13,10,14,210,163,47,2,22,285,153,132,2,2008-10-05,0,1,"oti",3
"7","Sun","October 19","W","","6-0",FALSE,"Kansas City Chiefs",34,10,20,455,123,332,0,13,272,214,58,0,2008-10-19,0,1,"oti",24
"8","Mon","October 27","W","","7-0",TRUE,"Indianapolis Colts",31,21,23,281,193,88,0,19,317,223,94,2,2008-10-27,2,1,"oti",10
"9","Sun","November 2","W","OT","8-0",TRUE,"Green Bay Packers",19,16,20,347,169,178,0,18,390,288,102,2,2008-11-02,2,1,"oti",3
"10","Sun","November 9","W","","9-0",FALSE,"Chicago Bears",21,14,19,304,284,20,1,15,243,165,78,1,2008-11-09,0,1,"oti",7
"11","Sun","November 16","W","","10-0",FALSE,"Jacksonville Jaguars",24,14,13,344,230,114,1,17,257,117,140,1,2008-11-16,0,1,"oti",10
"12","Sun","November 23","L","","10-1",TRUE,"New York Jets",13,34,16,281,236,45,1,28,409,217,192,2,2008-11-23,1,0,"oti",-21
"13","Thu","November 27","W","","11-1",FALSE,"Detroit Lions",47,10,19,456,164,292,1,6,154,131,23,3,2008-11-27,2,1,"oti",37
"14","Sun","December 7","W","","12-1",TRUE,"Cleveland Browns",28,9,21,390,155,235,3,12,178,143,35,1,2008-12-07,-2,1,"oti",19
"15","Sun","December 14","L","","12-2",FALSE,"Houston Texans",12,13,14,281,181,100,2,22,375,268,107,1,2008-12-14,-1,0,"oti",-1
"16","Sun","December 21","W","","13-2",TRUE,"Pittsburgh Steelers",31,14,16,322,205,117,0,23,374,301,73,4,2008-12-21,4,1,"oti",17
"17","Sun","December 28","L","","13-3",FALSE,"Indianapolis Colts",0,23,8,125,42,83,0,21,390,269,121,0,2008-12-28,0,0,"oti",-23
"Division","Sat","January 10","L","","13-4",TRUE,"Baltimore Ravens",10,13,21,391,275,116,3,9,211,161,50,0,2009-01-10,-3,0,"oti",-3
"1","Thu","September 10","L","OT","0-1",FALSE,"Pittsburgh Steelers",10,13,18,320,234,86,2,19,357,321,36,3,2009-09-10,1,0,"oti",-3
"2","Sun","September 20","L","","0-2",TRUE,"Houston Texans",31,34,19,449,209,240,2,19,420,357,63,0,2009-09-20,-2,0,"oti",-3
"3","Sun","September 27","L","","0-3",FALSE,"New York Jets",17,24,17,286,159,127,4,13,229,146,83,2,2009-09-27,-2,0,"oti",-7
"4","Sun","October 4","L","","0-4",FALSE,"Jacksonville Jaguars",17,37,19,379,284,95,3,27,442,305,137,1,2009-10-04,-2,0,"oti",-20
"5","Sun","October 11","L","","0-5",TRUE,"Indianapolis Colts",9,31,12,245,155,90,2,23,367,309,58,2,2009-10-11,0,0,"oti",-22
"6","Sun","October 18","L","","0-6",FALSE,"New England Patriots",0,59,9,186,-7,193,5,32,619,426,193,0,2009-10-18,-5,0,"oti",-59
"8","Sun","November 1","W","","1-6",TRUE,"Jacksonville Jaguars",30,13,20,430,125,305,0,12,330,113,217,2,2009-11-01,2,1,"oti",17
"9","Sun","November 8","W","","2-6",FALSE,"San Francisco 49ers",34,27,14,315,163,152,0,25,358,250,108,4,2009-11-08,4,1,"oti",7
"10","Sun","November 15","W","","3-6",TRUE,"Buffalo Bills",41,17,20,378,210,168,1,14,296,207,89,2,2009-11-15,1,1,"oti",24
"11","Mon","November 23","W","","4-6",FALSE,"Houston Texans",20,17,22,344,116,228,1,17,340,283,57,0,2009-11-23,-1,1,"oti",3
"12","Sun","November 29","W","","5-6",TRUE,"Arizona Cardinals",20,17,20,532,369,163,1,15,292,217,75,0,2009-11-29,-1,1,"oti",3
"13","Sun","December 6","L","","5-7",FALSE,"Indianapolis Colts",17,27,24,375,233,142,2,23,358,270,88,0,2009-12-06,-2,0,"oti",-10
"14","Sun","December 13","W","","6-7",TRUE,"St. Louis Rams",47,7,19,446,286,160,1,15,240,160,80,5,2009-12-13,4,1,"oti",40
"15","Sun","December 20","W","OT","7-7",TRUE,"Miami Dolphins",27,24,19,364,236,128,2,23,468,347,121,4,2009-12-20,2,1,"oti",3
"16","Fri","December 25","L","","7-8",TRUE,"San Diego Chargers",17,42,17,270,88,182,3,30,425,259,166,1,2009-12-25,-2,0,"oti",-25
"17","Sun","January 3","W","","8-8",FALSE,"Seattle Seahawks",17,13,19,304,171,133,2,16,309,169,140,1,2010-01-03,-1,1,"oti",4
"1","Sun","September 12","W","","1-0",TRUE,"Oakland Raiders",38,13,17,345,140,205,1,21,286,150,136,2,2010-09-12,1,1,"oti",25
"2","Sun","September 19","L","","1-1",TRUE,"Pittsburgh Steelers",11,19,14,238,192,46,7,7,127,21,106,1,2010-09-19,-6,0,"oti",-8
"3","Sun","September 26","W","","2-1",FALSE,"New York Giants",29,10,17,271,110,161,0,26,471,364,107,3,2010-09-26,3,1,"oti",19
"4","Sun","October 3","L","","2-2",TRUE,"Denver Broncos",20,26,13,288,167,121,2,22,327,308,19,1,2010-10-03,-1,0,"oti",-6
"5","Sun","October 10","W","","3-2",FALSE,"Dallas Cowboys",34,27,17,321,163,158,0,25,511,370,141,3,2010-10-10,3,1,"oti",7
"6","Mon","October 18","W","","4-2",FALSE,"Jacksonville Jaguars",30,3,20,324,171,153,0,17,249,173,76,4,2010-10-18,4,1,"oti",27
"7","Sun","October 24","W","","5-2",TRUE,"Philadelphia Eagles",37,19,15,328,253,75,3,21,326,227,99,4,2010-10-24,1,1,"oti",18
"8","Sun","October 31","L","","5-3",FALSE,"San Diego Chargers",25,33,15,370,305,65,0,23,456,300,156,1,2010-10-31,1,0,"oti",-8
"10","Sun","November 14","L","","5-4",FALSE,"Miami Dolphins",17,29,15,259,124,135,3,21,404,316,88,1,2010-11-14,-2,0,"oti",-12
"11","Sun","November 21","L","OT","5-5",TRUE,"Washington Redskins",16,19,15,373,222,151,2,32,465,358,107,1,2010-11-21,-1,0,"oti",-3
"12","Sun","November 28","L","","5-6",FALSE,"Houston Texans",0,20,9,162,138,24,3,24,346,158,188,0,2010-11-28,-3,0,"oti",-20
"13","Sun","December 5","L","","5-7",TRUE,"Jacksonville Jaguars",6,17,11,220,163,57,2,23,377,119,258,0,2010-12-05,-2,0,"oti",-11
"14","Thu","December 9","L","","5-8",TRUE,"Indianapolis Colts",28,30,22,365,244,121,2,21,399,312,87,0,2010-12-09,-2,0,"oti",-2
"15","Sun","December 19","W","","6-8",TRUE,"Houston Texans",31,17,19,359,212,147,1,26,323,293,30,1,2010-12-19,0,1,"oti",14
"16","Sun","December 26","L","","6-9",FALSE,"Kansas City Chiefs",14,34,16,270,213,57,2,23,458,306,152,2,2010-12-26,0,0,"oti",-20
"17","Sun","January 2","L","","6-10",FALSE,"Indianapolis Colts",20,23,17,341,290,51,1,24,358,257,101,1,2011-01-02,0,0,"oti",-3
"1","Sun","September 11","L","","0-1",FALSE,"Jacksonville Jaguars",14,16,13,292,249,43,1,20,323,160,163,1,2011-09-11,0,0,"oti",-2
"2","Sun","September 18","W","","1-1",TRUE,"Baltimore Ravens",26,13,21,432,358,74,1,15,229,184,45,3,2011-09-18,2,1,"oti",13
"3","Sun","September 25","W","","2-1",TRUE,"Denver Broncos",17,14,17,333,295,38,2,19,231,172,59,2,2011-09-25,0,1,"oti",3
"4","Sun","October 2","W","","3-1",FALSE,"Cleveland Browns",31,13,13,332,220,112,1,25,416,332,84,1,2011-10-02,0,1,"oti",18
"5","Sun","October 9","L","","3-2",FALSE,"Pittsburgh Steelers",17,38,20,306,240,66,1,26,431,257,174,1,2011-10-09,0,0,"oti",-21
"7","Sun","October 23","L","","3-3",TRUE,"Houston Texans",7,41,11,148,95,53,2,29,518,296,222,0,2011-10-23,-2,0,"oti",-34
"8","Sun","October 30","W","","4-3",TRUE,"Indianapolis Colts",27,10,17,311,215,96,0,22,399,241,158,2,2011-10-30,2,1,"oti",17
"9","Sun","November 6","L","","4-4",TRUE,"Cincinnati Bengals",17,24,19,328,250,78,1,20,319,210,109,0,2011-11-06,-1,0,"oti",-7
"10","Sun","November 13","W","","5-4",FALSE,"Carolina Panthers",30,3,22,383,211,172,1,16,279,166,113,2,2011-11-13,1,1,"oti",27
"11","Sun","November 20","L","","5-5",FALSE,"Atlanta Falcons",17,23,17,298,257,41,1,25,432,316,116,1,2011-11-20,0,0,"oti",-6
"12","Sun","November 27","W","","6-5",TRUE,"Tampa Bay Buccaneers",23,17,18,352,150,202,4,15,308,186,122,5,2011-11-27,1,1,"oti",6
"13","Sun","December 4","W","","7-5",FALSE,"Buffalo Bills",23,17,18,317,130,187,0,18,386,282,104,2,2011-12-04,2,1,"oti",6
"14","Sun","December 11","L","","7-6",TRUE,"New Orleans Saints",17,22,17,373,314,59,0,24,437,323,114,0,2011-12-11,0,0,"oti",-5
"15","Sun","December 18","L","","7-7",FALSE,"Indianapolis Colts",13,27,21,388,322,66,3,10,287,82,205,1,2011-12-18,-2,0,"oti",-14
"16","Sat","December 24","W","","8-7",TRUE,"Jacksonville Jaguars",23,17,20,407,342,65,3,18,300,187,113,1,2011-12-24,-2,1,"oti",6
"17","Sun","January 1","W","","9-7",FALSE,"Houston Texans",23,22,17,361,275,86,1,22,387,235,152,1,2012-01-01,0,1,"oti",1
"1","Sun","September 3","L","","0-1",TRUE,"Houston Oilers",3,10,10,146,45,101,2,14,240,80,160,1,1995-09-03,-1,0,"jax",-7
"2","Sun","September 10","L","","0-2",FALSE,"Cincinnati Bengals",17,24,14,259,140,119,2,17,346,228,118,2,1995-09-10,0,0,"jax",-7
"3","Sun","September 17","L","","0-3",FALSE,"New York Jets",10,27,20,251,105,146,3,23,375,296,79,1,1995-09-17,-2,0,"jax",-17
"4","Sun","September 24","L","","0-4",TRUE,"Green Bay Packers",14,24,13,201,125,76,0,16,322,193,129,1,1995-09-24,1,0,"jax",-10
"5","Sun","October 1","W","","1-4",FALSE,"Houston Oilers",17,16,16,219,151,68,3,19,297,206,91,3,1995-10-01,0,1,"jax",1
"6","Sun","October 8","W","","2-4",TRUE,"Pittsburgh Steelers",20,16,17,267,171,96,0,16,350,282,68,1,1995-10-08,1,1,"jax",4
"7","Sun","October 15","L","","2-5",TRUE,"Chicago Bears",27,30,26,409,288,121,1,23,380,245,135,0,1995-10-15,-1,0,"jax",-3
"8","Sun","October 22","W","","3-5",FALSE,"Cleveland Browns",23,15,23,315,156,159,2,20,387,298,89,4,1995-10-22,2,1,"jax",8
"9","Sun","October 29","L","","3-6",FALSE,"Pittsburgh Steelers",7,24,14,229,145,84,1,20,316,178,138,1,1995-10-29,0,0,"jax",-17
"11","Sun","November 12","L","","3-7",TRUE,"Seattle Seahawks",30,47,20,266,105,161,2,26,481,235,246,1,1995-11-12,-1,0,"jax",-17
"12","Sun","November 19","L","","3-8",FALSE,"Tampa Bay Buccaneers",16,17,19,350,263,87,1,17,246,101,145,0,1995-11-19,-1,0,"jax",-1
"13","Sun","November 26","L","","3-9",TRUE,"Cincinnati Bengals",13,17,18,291,213,78,2,20,323,210,113,3,1995-11-26,1,0,"jax",-4
"14","Sun","December 3","L","","3-10",FALSE,"Denver Broncos",23,31,13,260,191,69,2,20,397,286,111,3,1995-12-03,1,0,"jax",-8
"15","Sun","December 10","L","","3-11",TRUE,"Indianapolis Colts",31,41,27,424,298,126,2,15,219,128,91,0,1995-12-10,-2,0,"jax",-10
"16","Sun","December 17","L","","3-12",FALSE,"Detroit Lions",0,44,15,235,126,109,5,28,386,230,156,0,1995-12-17,-5,0,"jax",-44
"17","Sun","December 24","W","","4-12",TRUE,"Cleveland Browns",24,21,18,373,268,105,0,26,450,316,134,3,1995-12-24,3,1,"jax",3
"1","Sun","September 1","W","","1-0",TRUE,"Pittsburgh Steelers",24,9,22,313,194,119,2,13,187,86,101,2,1996-09-01,0,1,"jax",15
"2","Sun","September 8","L","","1-1",TRUE,"Houston Oilers",27,34,26,370,298,72,3,21,401,220,181,1,1996-09-08,-2,0,"jax",-7
"3","Sun","September 15","L","","1-2",FALSE,"Oakland Raiders",3,17,14,270,201,69,2,18,331,197,134,3,1996-09-15,1,0,"jax",-14
"4","Sun","September 22","L","OT","1-3",FALSE,"New England Patriots",25,28,12,442,413,29,2,26,353,230,123,2,1996-09-22,0,0,"jax",-3
"5","Sun","September 29","W","","2-3",TRUE,"Carolina Panthers",24,14,22,378,199,179,2,21,272,215,57,2,1996-09-29,0,1,"jax",10
"6","Sun","October 6","L","","2-4",FALSE,"New Orleans Saints",13,17,22,382,241,141,2,11,197,161,36,1,1996-10-06,-1,0,"jax",-4
"7","Sun","October 13","W","","3-4",TRUE,"New York Jets",21,17,10,289,217,72,0,23,367,276,91,2,1996-10-13,2,1,"jax",4
"8","Sun","October 20","L","","3-5",FALSE,"St. Louis Rams",14,17,36,538,420,118,6,8,204,121,83,1,1996-10-20,-5,0,"jax",-3
"9","Sun","October 27","L","","3-6",FALSE,"Cincinnati Bengals",21,28,19,338,189,149,2,18,267,207,60,0,1996-10-27,-2,0,"jax",-7
"11","Sun","November 10","W","","4-6",TRUE,"Baltimore Ravens",30,27,22,418,332,86,2,24,387,235,152,3,1996-11-10,1,1,"jax",3
"12","Sun","November 17","L","","4-7",FALSE,"Pittsburgh Steelers",3,28,20,239,161,78,4,15,198,90,108,1,1996-11-17,-3,0,"jax",-25
"13","Sun","November 24","W","OT","5-7",FALSE,"Baltimore Ravens",28,25,23,374,292,82,2,29,460,356,104,2,1996-11-24,0,1,"jax",3
"14","Sun","December 1","W","","6-7",TRUE,"Cincinnati Bengals",30,27,19,422,356,66,0,27,485,313,172,2,1996-12-01,2,1,"jax",3
"15","Sun","December 8","W","","7-7",FALSE,"Houston Oilers",23,17,19,279,165,114,1,21,361,287,74,4,1996-12-08,3,1,"jax",6
"16","Sun","December 15","W","","8-7",TRUE,"Seattle Seahawks",20,13,18,351,218,133,0,19,306,147,159,1,1996-12-15,1,1,"jax",7
"17","Sun","December 22","W","","9-7",TRUE,"Atlanta Falcons",19,17,21,357,214,143,0,21,309,163,146,0,1996-12-22,0,1,"jax",2
"WildCard","Sat","December 28","W","","10-7",FALSE,"Buffalo Bills",30,27,18,409,225,184,2,19,308,216,92,3,1996-12-28,1,1,"jax",3
"Division","Sat","January 4","W","","11-7",FALSE,"Denver Broncos",30,27,22,443,240,203,0,21,351,225,126,0,1997-01-04,0,1,"jax",3
"ConfChamp","Sun","January 12","L","","11-8",FALSE,"New England Patriots",6,20,18,289,188,101,4,13,234,161,73,2,1997-01-12,-2,0,"jax",-14
"1","Sun","August 31","W","","1-0",FALSE,"Baltimore Ravens",28,27,19,411,303,108,1,22,373,301,72,3,1997-08-31,2,1,"jax",1
"2","Sun","September 7","W","","2-0",TRUE,"New York Giants",40,13,22,375,252,123,1,13,206,167,39,3,1997-09-07,2,1,"jax",27
"4","Mon","September 22","W","","3-0",TRUE,"Pittsburgh Steelers",30,21,23,343,303,40,0,19,306,153,153,2,1997-09-22,2,1,"jax",9
"5","Sun","September 28","L","","3-1",FALSE,"Washington Redskins",12,24,11,204,134,70,2,20,336,223,113,3,1997-09-28,1,0,"jax",-12
"6","Sun","October 5","W","","4-1",TRUE,"Cincinnati Bengals",21,13,21,308,148,160,0,17,348,200,148,0,1997-10-05,0,1,"jax",8
"7","Sun","October 12","W","","5-1",TRUE,"Philadelphia Eagles",38,21,21,306,157,149,1,23,393,303,90,2,1997-10-12,1,1,"jax",17
"8","Sun","October 19","L","","5-2",FALSE,"Dallas Cowboys",22,26,15,271,229,42,1,24,337,238,99,0,1997-10-19,-1,0,"jax",-4
"9","Sun","October 26","L","OT","5-3",FALSE,"Pittsburgh Steelers",17,23,16,267,194,73,1,26,439,298,141,3,1997-10-26,2,0,"jax",-6
"10","Sun","November 2","W","","6-3",FALSE,"Tennessee Oilers",30,24,17,290,155,135,2,15,302,195,107,2,1997-11-02,0,1,"jax",6
"11","Sun","November 9","W","","7-3",TRUE,"Kansas City Chiefs",24,10,16,332,182,150,2,22,413,265,148,5,1997-11-09,3,1,"jax",14
"12","Sun","November 16","W","","8-3",TRUE,"Tennessee Oilers",17,9,21,352,249,103,2,17,320,184,136,2,1997-11-16,0,1,"jax",8
"13","Sun","November 23","L","","8-4",FALSE,"Cincinnati Bengals",26,31,20,415,280,135,3,24,327,203,124,0,1997-11-23,-3,0,"jax",-5
"14","Sun","November 30","W","","9-4",TRUE,"Baltimore Ravens",29,27,23,404,313,91,1,17,221,163,58,0,1997-11-30,-1,1,"jax",2
"15","Sun","December 7","L","","9-5",TRUE,"New England Patriots",20,26,23,341,234,107,2,16,282,227,55,0,1997-12-07,-2,0,"jax",-6
"16","Sun","December 14","W","","10-5",FALSE,"Buffalo Bills",20,14,20,388,297,91,1,24,335,192,143,3,1997-12-14,2,1,"jax",6
"17","Sun","December 21","W","","11-5",FALSE,"Oakland Raiders",20,9,20,417,274,143,0,19,300,192,108,1,1997-12-21,1,1,"jax",11
"WildCard","Sat","December 27","L","","11-6",FALSE,"Denver Broncos",17,42,14,237,187,50,2,28,511,201,310,2,1997-12-27,0,0,"jax",-25
"1","Sun","September 6","W","","1-0",FALSE,"Chicago Bears",24,23,21,367,207,160,3,16,321,189,132,2,1998-09-06,-1,1,"jax",1
"2","Sun","September 13","W","","2-0",TRUE,"Kansas City Chiefs",21,16,19,256,111,145,0,23,364,253,111,2,1998-09-13,2,1,"jax",5
"3","Sun","September 20","W","","3-0",TRUE,"Baltimore Ravens",24,10,21,519,365,154,1,11,313,232,81,1,1998-09-20,0,1,"jax",14
"4","Sun","September 27","W","","4-0",FALSE,"Tennessee Oilers",27,22,19,297,149,148,3,15,219,179,40,3,1998-09-27,0,1,"jax",5
"6","Mon","October 12","W","","5-0",TRUE,"Miami Dolphins",28,21,12,385,199,186,1,25,374,307,67,2,1998-10-12,1,1,"jax",7
"7","Sun","October 18","L","","5-1",FALSE,"Buffalo Bills",16,17,16,238,104,134,0,22,337,227,110,1,1998-10-18,1,0,"jax",-1
"8","Sun","October 25","L","","5-2",FALSE,"Denver Broncos",24,37,24,348,282,66,1,24,465,295,170,0,1998-10-25,-1,0,"jax",-13
"9","Sun","November 1","W","","6-2",FALSE,"Baltimore Ravens",45,19,20,364,253,111,1,22,357,231,126,5,1998-11-01,4,1,"jax",26
"10","Sun","November 8","W","","7-2",TRUE,"Cincinnati Bengals",24,11,14,272,135,137,1,19,318,200,118,2,1998-11-08,1,1,"jax",13
"11","Sun","November 15","W","","8-2",TRUE,"Tampa Bay Buccaneers",29,24,18,374,230,144,0,13,343,186,157,3,1998-11-15,3,1,"jax",5
"12","Sun","November 22","L","","8-3",FALSE,"Pittsburgh Steelers",15,30,17,301,204,97,4,18,329,208,121,0,1998-11-22,-4,0,"jax",-15
"13","Sun","November 29","W","","9-3",FALSE,"Cincinnati Bengals",34,17,16,322,243,79,0,20,355,224,131,4,1998-11-29,4,1,"jax",17
"14","Sun","December 6","W","","10-3",TRUE,"Detroit Lions",37,22,24,426,221,205,0,16,332,212,120,0,1998-12-06,0,1,"jax",15
"15","Sun","December 13","L","","10-4",TRUE,"Tennessee Oilers",13,16,15,241,172,69,1,20,354,223,131,2,1998-12-13,1,0,"jax",-3
"16","Sun","December 20","L","","10-5",FALSE,"Minnesota Vikings",10,50,15,207,69,138,4,25,417,237,180,0,1998-12-20,-4,0,"jax",-40
"17","Mon","December 28","W","","11-5",TRUE,"Pittsburgh Steelers",21,3,16,297,168,129,0,20,361,156,205,3,1998-12-28,3,1,"jax",18
"WildCard","Sun","January 3","W","","12-5",TRUE,"New England Patriots",25,10,17,308,148,160,0,14,206,171,35,3,1999-01-03,3,1,"jax",15
"Division","Sun","January 10","L","","12-6",FALSE,"New York Jets",24,34,14,251,156,95,4,29,429,278,151,3,1999-01-10,-1,0,"jax",-10
"1","Sun","September 12","W","","1-0",TRUE,"San Francisco 49ers",41,3,18,344,247,97,0,11,203,109,94,5,1999-09-12,5,1,"jax",38
"2","Sun","September 19","W","","2-0",FALSE,"Carolina Panthers",22,20,27,414,200,214,1,16,283,196,87,1,1999-09-19,0,1,"jax",2
"3","Sun","September 26","L","","2-1",TRUE,"Tennessee Titans",19,20,22,369,232,137,4,15,242,191,51,2,1999-09-26,-2,0,"jax",-1
"4","Sun","October 3","W","","3-1",FALSE,"Pittsburgh Steelers",17,3,13,204,80,124,1,14,216,99,117,2,1999-10-03,1,1,"jax",14
"5","Mon","October 11","W","","4-1",FALSE,"New York Jets",16,6,16,322,197,125,1,13,230,141,89,2,1999-10-11,1,1,"jax",10
"6","Sun","October 17","W","","5-1",TRUE,"Cleveland Browns",24,7,21,325,222,103,0,16,243,130,113,1,1999-10-17,1,1,"jax",17
"8","Sun","October 31","W","","6-1",FALSE,"Cincinnati Bengals",41,10,23,377,194,183,0,14,300,207,93,3,1999-10-31,3,1,"jax",31
"9","Sun","November 7","W","","7-1",FALSE,"Atlanta Falcons",30,7,20,367,215,152,0,10,182,140,42,4,1999-11-07,4,1,"jax",23
"10","Sun","November 14","W","","8-1",TRUE,"Baltimore Ravens",6,3,9,132,85,47,0,13,242,154,88,1,1999-11-14,1,1,"jax",3
"11","Sun","November 21","W","","9-1",TRUE,"New Orleans Saints",41,23,30,494,355,139,1,21,339,233,106,1,1999-11-21,0,1,"jax",18
"12","Sun","November 28","W","","10-1",FALSE,"Baltimore Ravens",30,23,24,388,328,60,3,14,280,199,81,3,1999-11-28,0,1,"jax",7
"13","Thu","December 2","W","","11-1",TRUE,"Pittsburgh Steelers",20,6,24,466,298,168,1,15,235,172,63,0,1999-12-02,-1,1,"jax",14
"14","Mon","December 13","W","","12-1",TRUE,"Denver Broncos",27,24,18,265,104,161,0,18,358,268,90,2,1999-12-13,2,1,"jax",3
"15","Sun","December 19","W","","13-1",FALSE,"Cleveland Browns",24,14,20,442,261,181,2,19,269,197,72,1,1999-12-19,-1,1,"jax",10
"16","Sun","December 26","L","","13-2",FALSE,"Tennessee Titans",14,41,16,237,172,65,3,26,476,328,148,0,1999-12-26,-3,0,"jax",-27
"17","Sun","January 2","W","","14-2",TRUE,"Cincinnati Bengals",24,7,30,440,305,135,1,13,236,126,110,2,2000-01-02,1,1,"jax",17
"Division","Sat","January 15","W","","15-2",TRUE,"Miami Dolphins",62,7,21,520,263,257,2,10,131,110,21,7,2000-01-15,5,1,"jax",55
"ConfChamp","Sun","January 23","L","","15-3",TRUE,"Tennessee Titans",14,33,20,355,211,144,6,18,289,112,177,4,2000-01-23,-2,0,"jax",-19
"1","Sun","September 3","W","","1-0",FALSE,"Cleveland Browns",27,7,28,398,279,119,0,9,249,153,96,1,2000-09-03,1,1,"jax",20
"2","Sun","September 10","L","","1-1",FALSE,"Baltimore Ravens",36,39,22,421,375,46,4,17,331,242,89,2,2000-09-10,-2,0,"jax",-3
"3","Sun","September 17","W","","2-1",TRUE,"Cincinnati Bengals",13,0,15,241,157,84,1,14,233,162,71,4,2000-09-17,3,1,"jax",13
"4","Mon","September 25","L","","2-2",FALSE,"Indianapolis Colts",14,43,18,286,189,97,2,21,533,440,93,1,2000-09-25,-1,0,"jax",-29
"5","Sun","October 1","L","","2-3",TRUE,"Pittsburgh Steelers",13,24,17,206,180,26,2,22,332,123,209,3,2000-10-01,1,0,"jax",-11
"6","Sun","October 8","L","","2-4",TRUE,"Baltimore Ravens",10,15,22,348,253,95,6,10,194,138,56,1,2000-10-08,-5,0,"jax",-5
"7","Mon","October 16","L","","2-5",FALSE,"Tennessee Titans",13,27,13,304,161,143,2,18,409,234,175,1,2000-10-16,-1,0,"jax",-14
"8","Sun","October 22","L","","2-6",TRUE,"Washington Redskins",16,35,21,385,239,146,4,18,399,269,130,2,2000-10-22,-2,0,"jax",-19
"9","Sun","October 29","W","OT","3-6",FALSE,"Dallas Cowboys",23,17,18,392,231,161,0,22,325,207,118,3,2000-10-29,3,1,"jax",6
"11","Sun","November 12","L","","3-7",TRUE,"Seattle Seahawks",21,28,24,437,315,122,1,22,326,230,96,0,2000-11-12,-1,0,"jax",-7
"12","Sun","November 19","W","","4-7",FALSE,"Pittsburgh Steelers",34,24,20,417,177,240,2,15,302,155,147,5,2000-11-19,3,1,"jax",10
"13","Sun","November 26","W","","5-7",TRUE,"Tennessee Titans",16,13,16,334,223,111,2,17,334,217,117,0,2000-11-26,-2,1,"jax",3
"14","Sun","December 3","W","","6-7",TRUE,"Cleveland Browns",48,0,28,449,205,244,0,2,53,-9,62,1,2000-12-03,1,1,"jax",48
"15","Sun","December 10","W","","7-7",TRUE,"Arizona Cardinals",44,10,25,469,255,214,0,11,189,149,40,1,2000-12-10,1,1,"jax",34
"16","Sun","December 17","L","","7-8",FALSE,"Cincinnati Bengals",14,17,17,276,162,114,1,15,263,157,106,4,2000-12-17,3,0,"jax",-3
"17","Sat","December 23","L","","7-9",FALSE,"New York Giants",25,28,14,327,257,70,2,19,373,293,80,1,2000-12-23,-1,0,"jax",-3
"1","Sun","September 9","W","","1-0",TRUE,"Pittsburgh Steelers",21,3,16,299,198,101,0,15,281,161,120,4,2001-09-09,4,1,"jax",18
"2","Sun","September 23","W","","2-0",TRUE,"Tennessee Titans",13,6,16,329,210,119,2,13,264,177,87,0,2001-09-23,-2,1,"jax",7
"3","Sun","September 30","L","","2-1",TRUE,"Cleveland Browns",14,23,14,259,161,98,2,19,321,226,95,3,2001-09-30,1,0,"jax",-9
"4","Sun","October 7","L","","2-2",FALSE,"Seattle Seahawks",15,24,18,256,199,57,2,21,395,210,185,2,2001-10-07,0,0,"jax",-9
"6","Thu","October 18","L","","2-3",TRUE,"Buffalo Bills",10,13,14,247,132,115,2,19,317,219,98,0,2001-10-18,-2,0,"jax",-3
"7","Sun","October 28","L","","2-4",FALSE,"Baltimore Ravens",17,18,19,365,284,81,1,23,305,191,114,1,2001-10-28,0,0,"jax",-1
"8","Sun","November 4","L","","2-5",FALSE,"Tennessee Titans",24,28,20,309,239,70,1,27,362,216,146,0,2001-11-04,-1,0,"jax",-4
"9","Sun","November 11","W","","3-5",TRUE,"Cincinnati Bengals",30,13,21,261,164,97,0,18,352,279,73,1,2001-11-11,1,1,"jax",17
"10","Sun","November 18","L","","3-6",FALSE,"Pittsburgh Steelers",7,20,14,234,186,48,3,20,402,257,145,0,2001-11-18,-3,0,"jax",-13
"11","Sun","November 25","L","","3-7",TRUE,"Baltimore Ravens",21,24,19,305,230,75,0,24,361,246,115,2,2001-11-25,2,0,"jax",-3
"12","Mon","December 3","L","","3-8",TRUE,"Green Bay Packers",21,28,20,348,286,62,4,20,389,352,37,1,2001-12-03,-3,0,"jax",-7
"13","Sun","December 9","W","","4-8",FALSE,"Cincinnati Bengals",14,10,17,255,193,62,1,12,200,140,60,1,2001-12-09,0,1,"jax",4
"14","Sun","December 16","W","","5-8",FALSE,"Cleveland Browns",15,10,19,282,154,128,3,11,220,173,47,2,2001-12-16,-1,1,"jax",5
"15","Sun","December 23","W","","6-8",FALSE,"Minnesota Vikings",33,3,23,423,209,214,0,16,214,186,28,2,2001-12-23,2,1,"jax",30
"16","Sun","December 30","L","","6-9",TRUE,"Kansas City Chiefs",26,30,22,431,249,182,3,23,365,273,92,4,2001-12-30,1,0,"jax",-4
"17","Sun","January 6","L","","6-10",FALSE,"Chicago Bears",13,33,17,237,146,91,3,19,322,153,169,1,2002-01-06,-2,0,"jax",-20
"1","Sun","September 8","L","","0-1",TRUE,"Indianapolis Colts",25,28,19,343,225,118,2,18,307,203,104,2,2002-09-08,0,0,"jax",-3
"2","Sun","September 15","W","","1-1",FALSE,"Kansas City Chiefs",23,16,19,450,320,130,1,18,336,196,140,2,2002-09-15,1,1,"jax",7
"4","Sun","September 29","W","","2-1",TRUE,"New York Jets",28,3,20,383,160,223,0,18,345,267,78,4,2002-09-29,4,1,"jax",25
"5","Sun","October 6","W","","3-1",TRUE,"Philadelphia Eagles",28,25,16,267,197,70,0,28,406,207,199,0,2002-10-06,0,1,"jax",3
"6","Sun","October 13","L","","3-2",FALSE,"Tennessee Titans",14,23,13,198,68,130,2,25,370,218,152,1,2002-10-13,-1,0,"jax",-9
"7","Sun","October 20","L","","3-3",FALSE,"Baltimore Ravens",10,17,22,397,224,173,3,16,261,143,118,2,2002-10-20,-1,0,"jax",-7
"8","Sun","October 27","L","","3-4",TRUE,"Houston Texans",19,21,18,290,164,126,0,12,242,161,81,1,2002-10-27,1,0,"jax",-2
"9","Sun","November 3","L","","3-5",FALSE,"New York Giants",17,24,16,329,203,126,1,26,394,217,177,1,2002-11-03,0,0,"jax",-7
"10","Sun","November 10","W","","4-5",TRUE,"Washington Redskins",26,7,18,309,167,142,0,23,307,239,68,3,2002-11-10,3,1,"jax",19
"11","Sun","November 17","W","","5-5",FALSE,"Houston Texans",24,21,16,321,199,122,1,18,272,194,78,2,2002-11-17,1,1,"jax",3
"12","Sun","November 24","L","","5-6",FALSE,"Dallas Cowboys",19,21,19,326,194,132,3,21,405,287,118,3,2002-11-24,0,0,"jax",-2
"13","Sun","December 1","L","","5-7",TRUE,"Pittsburgh Steelers",23,25,13,226,124,102,0,23,403,184,219,1,2002-12-01,1,0,"jax",-2
"14","Sun","December 8","L","","5-8",TRUE,"Cleveland Browns",20,21,13,211,54,157,0,21,417,244,173,2,2002-12-08,2,0,"jax",-1
"15","Sun","December 15","W","","6-8",FALSE,"Cincinnati Bengals",29,15,20,321,212,109,0,19,300,235,65,2,2002-12-15,2,1,"jax",14
"16","Sun","December 22","L","","6-9",TRUE,"Tennessee Titans",10,28,13,214,139,75,1,20,298,123,175,0,2002-12-22,-1,0,"jax",-18
"17","Sun","December 29","L","","6-10",FALSE,"Indianapolis Colts",13,20,20,266,112,154,1,18,272,146,126,1,2002-12-29,0,0,"jax",-7
"1","Sun","September 7","L","","0-1",FALSE,"Carolina Panthers",23,24,17,331,256,75,1,17,242,120,122,2,2003-09-07,1,0,"jax",-1
"2","Sun","September 14","L","","0-2",TRUE,"Buffalo Bills",17,38,20,287,192,95,0,20,371,328,43,0,2003-09-14,0,0,"jax",-21
"3","Sun","September 21","L","","0-3",FALSE,"Indianapolis Colts",13,23,15,266,114,152,1,17,289,216,73,1,2003-09-21,0,0,"jax",-10
"4","Sun","September 28","L","","0-4",FALSE,"Houston Texans",20,24,15,342,263,79,5,21,339,229,110,4,2003-09-28,-1,0,"jax",-4
"5","Sun","October 5","W","","1-4",TRUE,"San Diego Chargers",27,21,21,436,313,123,1,21,346,277,69,2,2003-10-05,1,1,"jax",6
"6","Sun","October 12","L","","1-5",TRUE,"Miami Dolphins",10,24,22,332,244,88,5,16,234,143,91,2,2003-10-12,-3,0,"jax",-14
"8","Sun","October 26","L","","1-6",TRUE,"Tennessee Titans",17,30,15,293,239,54,3,23,320,187,133,1,2003-10-26,-2,0,"jax",-13
"9","Sun","November 2","L","","1-7",FALSE,"Baltimore Ravens",17,24,20,320,186,134,3,9,259,156,103,2,2003-11-02,-1,0,"jax",-7
"10","Sun","November 9","W","","2-7",TRUE,"Indianapolis Colts",28,23,20,353,179,174,2,20,394,347,47,2,2003-11-09,0,1,"jax",5
"11","Sun","November 16","L","","2-8",FALSE,"Tennessee Titans",3,10,16,271,145,126,2,13,246,150,96,3,2003-11-16,1,0,"jax",-7
"12","Sun","November 23","L","","2-9",FALSE,"New York Jets",10,13,20,330,172,158,2,17,282,221,61,1,2003-11-23,-1,0,"jax",-3
"13","Sun","November 30","W","","3-9",TRUE,"Tampa Bay Buccaneers",17,10,21,359,224,135,1,16,221,144,77,1,2003-11-30,0,1,"jax",7
"14","Sun","December 7","W","","4-9",TRUE,"Houston Texans",27,0,23,390,182,208,0,7,124,54,70,3,2003-12-07,3,1,"jax",27
"15","Sun","December 14","L","","4-10",FALSE,"New England Patriots",13,27,17,354,282,72,2,18,296,212,84,1,2003-12-14,-1,0,"jax",-14
"16","Sun","December 21","W","","5-10",TRUE,"New Orleans Saints",20,19,22,374,131,243,2,20,350,289,61,1,2003-12-21,-1,1,"jax",1
"17","Sun","December 28","L","","5-11",FALSE,"Atlanta Falcons",14,21,21,320,163,157,1,21,344,178,166,1,2003-12-28,0,0,"jax",-7
"1","Sun","September 12","W","","1-0",FALSE,"Buffalo Bills",13,10,14,225,142,83,2,16,242,147,95,2,2004-09-12,0,1,"jax",3
"2","Sun","September 19","W","","2-0",TRUE,"Denver Broncos",7,6,8,176,109,67,0,20,356,250,106,1,2004-09-19,1,1,"jax",1
"3","Sun","September 26","W","","3-0",FALSE,"Tennessee Titans",15,12,15,253,117,136,0,13,249,130,119,1,2004-09-26,1,1,"jax",3
"4","Sun","October 3","L","","3-1",TRUE,"Indianapolis Colts",17,24,23,408,311,97,1,23,337,220,117,1,2004-10-03,0,0,"jax",-7
"5","Sun","October 10","L","","3-2",FALSE,"San Diego Chargers",21,34,28,429,349,80,3,18,386,210,176,0,2004-10-10,-3,0,"jax",-13
"6","Sun","October 17","W","","4-2",TRUE,"Kansas City Chiefs",22,16,19,378,277,101,0,19,350,273,77,1,2004-10-17,1,1,"jax",6
"7","Sun","October 24","W","","5-2",FALSE,"Indianapolis Colts",27,24,20,414,286,128,2,23,446,359,87,2,2004-10-24,0,1,"jax",3
"8","Sun","October 31","L","","5-3",FALSE,"Houston Texans",6,20,14,287,248,39,2,24,369,276,93,2,2004-10-31,0,0,"jax",-14
"10","Sun","November 14","W","OT","6-3",TRUE,"Detroit Lions",23,17,22,415,176,239,0,10,190,109,81,1,2004-11-14,1,1,"jax",6
"11","Sun","November 21","L","","6-4",TRUE,"Tennessee Titans",15,18,18,274,123,151,2,14,295,192,103,2,2004-11-21,0,0,"jax",-3
"12","Sun","November 28","L","","6-5",FALSE,"Minnesota Vikings",16,27,18,379,225,154,2,24,330,218,112,2,2004-11-28,0,0,"jax",-11
"13","Sun","December 5","L","","6-6",TRUE,"Pittsburgh Steelers",16,17,20,359,259,100,0,15,316,196,120,0,2004-12-05,0,0,"jax",-1
"14","Sun","December 12","W","","7-6",TRUE,"Chicago Bears",22,3,22,332,242,90,1,10,210,179,31,2,2004-12-12,1,1,"jax",19
"15","Sun","December 19","W","","8-6",FALSE,"Green Bay Packers",28,25,19,312,115,197,2,26,444,350,94,5,2004-12-19,3,1,"jax",3
"16","Sun","December 26","L","","8-7",TRUE,"Houston Texans",0,21,6,126,31,95,3,19,333,114,219,2,2004-12-26,-1,0,"jax",-21
"17","Sun","January 2","W","","9-7",FALSE,"Oakland Raiders",13,6,13,242,149,93,2,16,281,134,147,4,2005-01-02,2,1,"jax",7
"1","Sun","September 11","W","","1-0",TRUE,"Seattle Seahawks",26,14,18,362,243,119,0,20,322,225,97,5,2005-09-11,5,1,"jax",12
"2","Sun","September 18","L","","1-1",FALSE,"Indianapolis Colts",3,10,12,303,175,128,0,18,268,122,146,1,2005-09-18,1,0,"jax",-7
"3","Sun","September 25","W","OT","2-1",FALSE,"New York Jets",26,20,16,308,169,139,3,12,168,79,89,3,2005-09-25,0,1,"jax",6
"4","Sun","October 2","L","","2-2",TRUE,"Denver Broncos",7,20,13,241,229,12,4,24,306,118,188,0,2005-10-02,-4,0,"jax",-13
"5","Sun","October 9","W","","3-2",TRUE,"Cincinnati Bengals",23,20,19,342,161,181,1,20,364,232,132,1,2005-10-09,0,1,"jax",3
"6","Sun","October 16","W","OT","4-2",FALSE,"Pittsburgh Steelers",23,17,17,246,153,93,1,16,218,145,73,4,2005-10-16,3,1,"jax",6
"8","Sun","October 30","L","","4-3",FALSE,"St. Louis Rams",21,24,16,427,206,221,2,15,386,186,200,3,2005-10-30,1,0,"jax",-3
"9","Sun","November 6","W","","5-3",TRUE,"Houston Texans",21,14,18,312,214,98,0,17,279,191,88,1,2005-11-06,1,1,"jax",7
"10","Sun","November 13","W","","6-3",TRUE,"Baltimore Ravens",30,3,20,338,205,133,0,8,163,110,53,3,2005-11-13,3,1,"jax",27
"11","Sun","November 20","W","","7-3",FALSE,"Tennessee Titans",31,28,22,295,246,49,1,16,254,191,63,1,2005-11-20,0,1,"jax",3
"12","Sun","November 27","W","","8-3",FALSE,"Arizona Cardinals",24,17,19,295,133,162,0,23,368,301,67,2,2005-11-27,2,1,"jax",7
"13","Sun","December 4","W","","9-3",FALSE,"Cleveland Browns",20,14,17,237,115,122,1,15,303,205,98,0,2005-12-04,-1,1,"jax",6
"14","Sun","December 11","L","","9-4",TRUE,"Indianapolis Colts",18,26,18,324,250,74,3,25,399,300,99,0,2005-12-11,-3,0,"jax",-8
"15","Sun","December 18","W","","10-4",TRUE,"San Francisco 49ers",10,9,21,336,202,134,0,11,217,107,110,1,2005-12-18,1,1,"jax",1
"16","Sat","December 24","W","","11-4",FALSE,"Houston Texans",38,20,30,448,276,172,0,18,370,263,107,1,2005-12-24,1,1,"jax",18
"17","Sun","January 1","W","","12-4",TRUE,"Tennessee Titans",40,13,25,335,213,122,1,15,270,171,99,2,2006-01-01,1,1,"jax",27
"WildCard","Sat","January 7","L","","12-5",FALSE,"New England Patriots",3,28,15,292,205,87,2,17,307,189,118,0,2006-01-07,-2,0,"jax",-25
"1","Sun","September 10","W","","1-0",TRUE,"Dallas Cowboys",24,17,22,307,229,78,1,14,323,235,88,3,2006-09-10,2,1,"jax",7
"2","Mon","September 18","W","","2-0",TRUE,"Pittsburgh Steelers",9,0,17,362,252,110,1,9,153,127,26,2,2006-09-18,1,1,"jax",9
"3","Sun","September 24","L","","2-1",FALSE,"Indianapolis Colts",14,21,20,297,106,191,2,14,272,209,63,0,2006-09-24,-2,0,"jax",-7
"4","Sun","October 1","L","OT","2-2",FALSE,"Washington Redskins",30,36,12,307,275,32,2,22,481,329,152,2,2006-10-01,0,0,"jax",-6
"5","Sun","October 8","W","","3-2",TRUE,"New York Jets",41,0,19,312,131,181,0,11,177,45,132,4,2006-10-08,4,1,"jax",41
"7","Sun","October 22","L","","3-3",FALSE,"Houston Texans",7,27,14,220,118,102,2,21,349,218,131,0,2006-10-22,-2,0,"jax",-20
"8","Sun","October 29","W","","4-3",FALSE,"Philadelphia Eagles",13,6,16,285,76,209,1,14,227,142,85,0,2006-10-29,-1,1,"jax",7
"9","Sun","November 5","W","","5-3",TRUE,"Tennessee Titans",37,7,17,342,169,173,0,14,262,154,108,3,2006-11-05,3,1,"jax",30
"10","Sun","November 12","L","","5-4",TRUE,"Houston Texans",10,13,16,322,204,118,4,21,306,158,148,0,2006-11-12,-4,0,"jax",-3
"11","Mon","November 20","W","","6-4",TRUE,"New York Giants",26,10,21,414,249,165,1,13,247,222,25,3,2006-11-20,2,1,"jax",16
"12","Sun","November 26","L","","6-5",FALSE,"Buffalo Bills",24,27,19,323,116,207,1,13,241,169,72,1,2006-11-26,0,0,"jax",-3
"13","Sun","December 3","W","","7-5",FALSE,"Miami Dolphins",24,10,18,353,203,150,1,20,309,241,68,2,2006-12-03,1,1,"jax",14
"14","Sun","December 10","W","","8-5",TRUE,"Indianapolis Colts",44,17,23,447,72,375,1,23,339,305,34,1,2006-12-10,0,1,"jax",27
"15","Sun","December 17","L","","8-6",FALSE,"Tennessee Titans",17,24,23,396,203,193,4,5,98,57,41,0,2006-12-17,-4,0,"jax",-7
"16","Sun","December 24","L","","8-7",TRUE,"New England Patriots",21,24,12,339,195,144,1,22,359,242,117,0,2006-12-24,-1,0,"jax",-3
"17","Sun","December 31","L","","8-8",FALSE,"Kansas City Chiefs",30,35,24,397,284,113,1,23,395,225,170,3,2006-12-31,2,0,"jax",-5
"1","Sun","September 9","L","","0-1",TRUE,"Tennessee Titans",10,13,13,272,197,75,1,22,350,68,282,2,2007-09-09,1,0,"jax",-3
"2","Sun","September 16","W","","1-1",TRUE,"Atlanta Falcons",13,7,17,364,251,113,0,13,248,166,82,0,2007-09-16,0,1,"jax",6
"3","Sun","September 23","W","","2-1",FALSE,"Denver Broncos",23,14,21,326,140,186,2,11,265,218,47,3,2007-09-23,1,1,"jax",9
"5","Sun","October 7","W","","3-1",FALSE,"Kansas City Chiefs",17,7,20,357,201,156,0,14,271,261,10,1,2007-10-07,1,1,"jax",10
"6","Sun","October 14","W","","4-1",TRUE,"Houston Texans",37,17,25,457,213,244,3,23,390,329,61,3,2007-10-14,0,1,"jax",20
"7","Mon","October 22","L","","4-2",TRUE,"Indianapolis Colts",7,29,18,226,109,117,3,24,384,243,141,1,2007-10-22,-2,0,"jax",-22
"8","Sun","October 28","W","","5-2",FALSE,"Tampa Bay Buccaneers",24,23,12,219,86,133,0,18,385,249,136,3,2007-10-28,3,1,"jax",1
"9","Sun","November 4","L","","5-3",FALSE,"New Orleans Saints",24,41,18,432,344,88,3,32,538,435,103,1,2007-11-04,-2,0,"jax",-17
"10","Sun","November 11","W","","6-3",FALSE,"Tennessee Titans",28,13,19,262,96,166,1,17,292,230,62,3,2007-11-11,2,1,"jax",15
"11","Sun","November 18","W","","7-3",TRUE,"San Diego Chargers",24,17,18,311,189,122,0,18,388,309,79,2,2007-11-18,2,1,"jax",7
"12","Sun","November 25","W","","8-3",TRUE,"Buffalo Bills",36,14,21,416,292,124,1,20,297,203,94,3,2007-11-25,2,1,"jax",22
"13","Sun","December 2","L","","8-4",FALSE,"Indianapolis Colts",25,28,27,411,243,168,2,19,342,279,63,1,2007-12-02,-1,0,"jax",-3
"14","Sun","December 9","W","","9-4",TRUE,"Carolina Panthers",37,6,24,427,249,178,1,10,149,99,50,2,2007-12-09,1,1,"jax",31
"15","Sun","December 16","W","","10-4",FALSE,"Pittsburgh Steelers",29,22,25,421,197,224,1,13,217,102,115,0,2007-12-16,-1,1,"jax",7
"16","Sun","December 23","W","","11-4",TRUE,"Oakland Raiders",49,11,26,437,236,201,2,13,215,105,110,4,2007-12-23,2,1,"jax",38
"17","Sun","December 30","L","","11-5",FALSE,"Houston Texans",28,42,24,381,285,96,1,19,290,120,170,1,2007-12-30,0,0,"jax",-14
"WildCard","Sat","January 5","W","","12-5",FALSE,"Pittsburgh Steelers",31,29,14,239,104,135,2,24,340,297,43,4,2008-01-05,2,1,"jax",2
"Division","Sat","January 12","L","","12-6",FALSE,"New England Patriots",20,31,22,350,270,80,2,24,403,258,145,0,2008-01-12,-2,0,"jax",-11
"1","Sun","September 7","L","","0-1",FALSE,"Tennessee Titans",10,17,13,189,156,33,3,14,309,172,137,2,2008-09-07,-1,0,"jax",-7
"2","Sun","September 14","L","","0-2",TRUE,"Buffalo Bills",16,20,18,243,145,98,2,18,285,210,75,1,2008-09-14,-1,0,"jax",-4
"3","Sun","September 21","W","","1-2",FALSE,"Indianapolis Colts",23,21,25,403,167,236,1,19,325,211,114,2,2008-09-21,1,1,"jax",2
"4","Sun","September 28","W","OT","2-2",TRUE,"Houston Texans",30,27,21,375,236,139,0,23,386,307,79,0,2008-09-28,0,1,"jax",3
"5","Sun","October 5","L","","2-3",TRUE,"Pittsburgh Steelers",21,26,14,213,175,38,0,28,415,286,129,1,2008-10-05,1,0,"jax",-5
"6","Sun","October 12","W","","3-3",FALSE,"Denver Broncos",24,17,26,416,261,155,2,19,323,192,131,3,2008-10-12,1,1,"jax",7
"8","Sun","October 26","L","","3-4",TRUE,"Cleveland Browns",17,23,23,380,267,113,1,15,327,236,91,0,2008-10-26,-1,0,"jax",-6
"9","Sun","November 2","L","","3-5",FALSE,"Cincinnati Bengals",19,21,9,282,214,68,1,20,312,153,159,2,2008-11-02,1,0,"jax",-2
"10","Sun","November 9","W","","4-5",FALSE,"Detroit Lions",38,14,24,384,227,157,0,13,256,153,103,1,2008-11-09,1,1,"jax",24
"11","Sun","November 16","L","","4-6",TRUE,"Tennessee Titans",14,24,17,257,117,140,1,13,344,230,114,1,2008-11-16,0,0,"jax",-10
"12","Sun","November 23","L","","4-7",TRUE,"Minnesota Vikings",12,30,17,321,286,35,5,15,226,104,122,1,2008-11-23,-4,0,"jax",-18
"13","Mon","December 1","L","","4-8",FALSE,"Houston Texans",17,30,21,388,262,126,3,18,326,200,126,1,2008-12-01,-2,0,"jax",-13
"14","Sun","December 7","L","","4-9",FALSE,"Chicago Bears",10,23,14,278,159,119,1,16,296,210,86,1,2008-12-07,0,0,"jax",-13
"15","Sun","December 14","W","","5-9",TRUE,"Green Bay Packers",20,16,18,323,229,94,0,18,338,254,84,1,2008-12-14,1,1,"jax",4
"16","Thu","December 18","L","","5-10",TRUE,"Indianapolis Colts",24,31,28,409,304,105,1,20,396,364,32,0,2008-12-18,-1,0,"jax",-7
"17","Sun","December 28","L","","5-11",FALSE,"Baltimore Ravens",7,27,14,245,127,118,4,20,431,304,127,0,2008-12-28,-4,0,"jax",-20
"1","Sun","September 13","L","","0-1",FALSE,"Indianapolis Colts",12,14,12,228,114,114,0,21,365,294,71,2,2009-09-13,2,0,"jax",-2
"2","Sun","September 20","L","","0-2",TRUE,"Arizona Cardinals",17,31,18,367,275,92,3,22,383,265,118,2,2009-09-20,-1,0,"jax",-14
"3","Sun","September 27","W","","1-2",FALSE,"Houston Texans",31,24,24,399,214,185,1,23,397,286,111,2,2009-09-27,1,1,"jax",7
"4","Sun","October 4","W","","2-2",TRUE,"Tennessee Titans",37,17,27,442,305,137,1,19,379,284,95,3,2009-10-04,2,1,"jax",20
"5","Sun","October 11","L","","2-3",FALSE,"Seattle Seahawks",0,41,10,199,161,38,2,24,379,236,143,0,2009-10-11,-2,0,"jax",-41
"6","Sun","October 18","W","OT","3-3",TRUE,"St. Louis Rams",23,20,33,492,326,166,3,13,262,207,55,1,2009-10-18,-2,1,"jax",3
"8","Sun","November 1","L","","3-4",FALSE,"Tennessee Titans",13,30,12,330,113,217,2,20,430,125,305,0,2009-11-01,-2,0,"jax",-17
"9","Sun","November 8","W","","4-4",TRUE,"Kansas City Chiefs",24,21,21,426,253,173,1,14,301,241,60,0,2009-11-08,-1,1,"jax",3
"10","Sun","November 15","W","","5-4",FALSE,"New York Jets",24,22,18,347,208,139,1,19,322,212,110,3,2009-11-15,2,1,"jax",2
"11","Sun","November 22","W","","6-4",TRUE,"Buffalo Bills",18,15,19,310,208,102,2,14,343,290,53,3,2009-11-22,1,1,"jax",3
"12","Sun","November 29","L","","6-5",FALSE,"San Francisco 49ers",3,20,18,357,261,96,2,15,284,232,52,0,2009-11-29,-2,0,"jax",-17
"13","Sun","December 6","W","","7-5",TRUE,"Houston Texans",23,18,19,323,216,107,1,19,305,233,72,3,2009-12-06,2,1,"jax",5
"14","Sun","December 13","L","","7-6",TRUE,"Miami Dolphins",10,14,10,217,122,95,0,22,354,208,146,3,2009-12-13,3,0,"jax",-4
"15","Thu","December 17","L","","7-7",TRUE,"Indianapolis Colts",31,35,25,345,206,139,1,18,369,308,61,1,2009-12-17,0,0,"jax",-4
"16","Sun","December 27","L","","7-8",FALSE,"New England Patriots",7,35,16,275,177,98,2,26,464,267,197,1,2009-12-27,-1,0,"jax",-28
"17","Sun","January 3","L","","7-9",FALSE,"Cleveland Browns",17,23,18,328,197,131,1,18,300,86,214,1,2010-01-03,0,0,"jax",-6
"1","Sun","September 12","W","","1-0",TRUE,"Denver Broncos",24,17,18,299,165,134,0,21,363,274,89,2,2010-09-12,2,1,"jax",7
"2","Sun","September 19","L","","1-1",FALSE,"San Diego Chargers",13,38,20,350,279,71,6,25,477,326,151,3,2010-09-19,-3,0,"jax",-25
"3","Sun","September 26","L","","1-2",TRUE,"Philadelphia Eagles",3,28,16,191,52,139,1,15,373,267,106,0,2010-09-26,-1,0,"jax",-25
"4","Sun","October 3","W","","2-2",TRUE,"Indianapolis Colts",31,28,20,337,163,174,0,28,406,348,58,2,2010-10-03,2,1,"jax",3
"5","Sun","October 10","W","","3-2",FALSE,"Buffalo Bills",36,26,21,381,165,216,3,17,306,196,110,0,2010-10-10,-3,1,"jax",10
"6","Mon","October 18","L","","3-3",TRUE,"Tennessee Titans",3,30,17,249,173,76,4,20,324,171,153,0,2010-10-18,-4,0,"jax",-27
"7","Sun","October 24","L","","3-4",FALSE,"Kansas City Chiefs",20,42,19,300,216,84,3,25,426,190,236,0,2010-10-24,-3,0,"jax",-22
"8","Sun","October 31","W","","4-4",FALSE,"Dallas Cowboys",35,17,20,387,238,149,1,25,415,365,50,4,2010-10-31,3,1,"jax",18
"10","Sun","November 14","W","","5-4",TRUE,"Houston Texans",31,24,29,491,326,165,0,20,395,314,81,1,2010-11-14,1,1,"jax",7
"11","Sun","November 21","W","","6-4",TRUE,"Cleveland Browns",24,20,24,371,226,145,6,15,283,195,88,1,2010-11-21,-5,1,"jax",4
"12","Sun","November 28","L","","6-5",FALSE,"New York Giants",20,24,26,328,121,207,2,17,361,226,135,0,2010-11-28,-2,0,"jax",-4
"13","Sun","December 5","W","","7-5",FALSE,"Tennessee Titans",17,6,23,377,119,258,0,11,220,163,57,2,2010-12-05,2,1,"jax",11
"14","Sun","December 12","W","","8-5",TRUE,"Oakland Raiders",38,31,19,385,151,234,1,21,476,323,153,2,2010-12-12,1,1,"jax",7
"15","Sun","December 19","L","","8-6",FALSE,"Indianapolis Colts",24,34,20,356,289,67,2,19,376,221,155,0,2010-12-19,-2,0,"jax",-10
"16","Sun","December 26","L","OT","8-7",TRUE,"Washington Redskins",17,20,15,336,258,78,2,15,251,172,79,1,2010-12-26,-1,0,"jax",-3
"17","Sun","January 2","L","","8-8",FALSE,"Houston Texans",17,34,23,322,124,198,2,22,497,253,244,0,2011-01-02,-2,0,"jax",-17
"1","Sun","September 11","W","","1-0",TRUE,"Tennessee Titans",16,14,20,323,160,163,1,13,292,249,43,1,2011-09-11,0,1,"jax",2
"2","Sun","September 18","L","","1-1",FALSE,"New York Jets",3,32,11,203,91,112,4,15,283,182,101,2,2011-09-18,-2,0,"jax",-29
"3","Sun","September 25","L","","1-2",FALSE,"Carolina Panthers",10,16,13,257,129,128,1,16,265,158,107,0,2011-09-25,-1,0,"jax",-6
"4","Sun","October 2","L","","1-3",TRUE,"New Orleans Saints",10,23,15,274,170,104,1,30,503,326,177,2,2011-10-02,1,0,"jax",-13
"5","Sun","October 9","L","","1-4",TRUE,"Cincinnati Bengals",20,30,12,296,200,96,2,13,239,162,77,1,2011-10-09,-1,0,"jax",-10
"6","Sun","October 16","L","","1-5",FALSE,"Pittsburgh Steelers",13,17,16,209,76,133,0,15,370,185,185,0,2011-10-16,0,0,"jax",-4
"7","Mon","October 24","W","","2-5",TRUE,"Baltimore Ravens",12,7,13,205,73,132,1,11,146,112,34,2,2011-10-24,1,1,"jax",5
"8","Sun","October 30","L","","2-6",FALSE,"Houston Texans",14,24,13,174,90,84,2,20,358,202,156,2,2011-10-30,0,0,"jax",-10
"10","Sun","November 13","W","","3-6",FALSE,"Indianapolis Colts",17,3,18,251,110,141,1,17,212,128,84,3,2011-11-13,2,1,"jax",14
"11","Sun","November 20","L","","3-7",FALSE,"Cleveland Browns",10,14,23,303,195,108,0,20,334,186,148,1,2011-11-20,1,0,"jax",-4
"12","Sun","November 27","L","","3-8",TRUE,"Houston Texans",13,20,14,255,150,105,1,9,215,127,88,1,2011-11-27,0,0,"jax",-7
"13","Mon","December 5","L","","3-9",TRUE,"San Diego Chargers",14,38,17,306,177,129,1,19,433,294,139,0,2011-12-05,-1,0,"jax",-24
"14","Sun","December 11","W","","4-9",TRUE,"Tampa Bay Buccaneers",41,14,21,325,209,116,2,15,280,170,110,7,2011-12-11,5,1,"jax",27
"15","Thu","December 15","L","","4-10",FALSE,"Atlanta Falcons",14,41,12,207,91,116,4,20,373,276,97,0,2011-12-15,-4,0,"jax",-27
"16","Sat","December 24","L","","4-11",FALSE,"Tennessee Titans",17,23,18,300,187,113,1,20,407,342,65,3,2011-12-24,2,0,"jax",-6
"17","Sun","January 1","W","","5-11",TRUE,"Indianapolis Colts",19,13,15,261,71,190,1,19,298,242,56,3,2012-01-01,2,1,"jax",6
"1","Sun","September 8","L","","0-1",FALSE,"Los Angeles Rams",16,20,13,277,214,63,3,19,285,138,147,3,1985-09-08,0,0,"den",-4
"2","Sun","September 15","W","","1-1",TRUE,"New Orleans Saints",34,23,22,432,327,105,2,17,342,235,107,1,1985-09-15,-1,1,"den",11
"3","Sun","September 22","W","","2-1",FALSE,"Atlanta Falcons",44,28,27,428,280,148,2,16,341,233,108,2,1985-09-22,0,1,"den",16
"4","Sun","September 29","L","","2-2",TRUE,"Miami Dolphins",26,30,23,395,226,169,2,19,418,365,53,1,1985-09-29,-1,0,"den",-4
"5","Sun","October 6","W","","3-2",TRUE,"Houston Oilers",31,20,31,362,241,121,3,18,321,201,120,0,1985-10-06,-3,1,"den",11
"6","Sun","October 13","W","","4-2",FALSE,"Indianapolis Colts",15,10,20,351,223,128,1,12,237,117,120,3,1985-10-13,2,1,"den",5
"7","Sun","October 20","W","OT","5-2",TRUE,"Seattle Seahawks",13,10,14,246,148,98,0,17,249,77,172,5,1985-10-20,5,1,"den",3
"8","Sun","October 27","W","","6-2",FALSE,"Kansas City Chiefs",30,10,25,324,118,206,0,13,257,180,77,0,1985-10-27,0,1,"den",20
"9","Sun","November 3","L","","6-3",FALSE,"San Diego Chargers",10,30,17,295,231,64,3,24,430,285,145,3,1985-11-03,0,0,"den",-20
"10","Mon","November 11","W","","7-3",TRUE,"San Francisco 49ers",17,16,18,336,215,121,1,16,341,203,138,0,1985-11-11,-1,1,"den",1
"11","Sun","November 17","W","OT","8-3",TRUE,"San Diego Chargers",30,24,21,331,240,91,2,22,340,245,95,4,1985-11-17,2,1,"den",6
"12","Sun","November 24","L","OT","8-4",FALSE,"Los Angeles Raiders",28,31,25,291,138,153,1,21,424,223,201,3,1985-11-24,2,0,"den",-3
"13","Sun","December 1","W","","9-4",FALSE,"Pittsburgh Steelers",31,23,20,331,238,93,1,22,327,250,77,4,1985-12-01,3,1,"den",8
"14","Sun","December 8","L","OT","9-5",TRUE,"Los Angeles Raiders",14,17,17,207,120,87,4,20,274,93,181,5,1985-12-08,1,0,"den",-3
"15","Sat","December 14","W","","10-5",TRUE,"Kansas City Chiefs",14,13,20,411,301,110,6,14,262,156,106,1,1985-12-14,-5,1,"den",1
"16","Fri","December 20","W","","11-5",FALSE,"Seattle Seahawks",27,24,26,479,385,94,0,20,331,205,126,1,1985-12-20,1,1,"den",3
"1","Sun","September 7","W","","1-0",TRUE,"Los Angeles Raiders",38,36,20,290,235,55,1,22,431,315,116,3,1986-09-07,2,1,"den",2
"2","Mon","September 15","W","","2-0",FALSE,"Pittsburgh Steelers",21,10,20,326,235,91,1,17,236,206,30,3,1986-09-15,2,1,"den",11
"3","Sun","September 21","W","","3-0",FALSE,"Philadelphia Eagles",33,7,19,328,125,203,1,16,273,196,77,2,1986-09-21,1,1,"den",26
"4","Sun","September 28","W","","4-0",TRUE,"New England Patriots",27,20,22,338,182,156,2,16,224,184,40,1,1986-09-28,-1,1,"den",7
"5","Sun","October 5","W","","5-0",TRUE,"Dallas Cowboys",29,14,19,319,198,121,1,19,266,225,41,3,1986-10-05,2,1,"den",15
"6","Sun","October 12","W","","6-0",FALSE,"San Diego Chargers",31,14,25,403,247,156,1,19,358,316,42,2,1986-10-12,1,1,"den",17
"7","Mon","October 20","L","","6-1",FALSE,"New York Jets",10,22,19,279,232,47,3,20,211,74,137,0,1986-10-20,-3,0,"den",-12
"8","Sun","October 26","W","","7-1",TRUE,"Seattle Seahawks",20,13,24,450,332,118,2,13,214,50,164,0,1986-10-26,-2,1,"den",7
"9","Sun","November 2","W","","8-1",FALSE,"Los Angeles Raiders",21,10,11,246,132,114,1,25,407,326,81,6,1986-11-02,5,1,"den",11
"10","Sun","November 9","L","","8-2",TRUE,"San Diego Chargers",3,9,12,245,184,61,5,14,225,147,78,2,1986-11-09,-3,0,"den",-6
"11","Sun","November 16","W","","9-2",TRUE,"Kansas City Chiefs",38,17,18,265,198,67,2,16,297,220,77,4,1986-11-16,2,1,"den",21
"12","Sun","November 23","L","","9-3",FALSE,"New York Giants",16,19,26,405,325,80,4,14,262,119,143,2,1986-11-23,-2,0,"den",-3
"13","Sun","November 30","W","","10-3",TRUE,"Cincinnati Bengals",34,28,27,401,219,182,0,22,426,302,124,3,1986-11-30,3,1,"den",6
"14","Sun","December 7","L","","10-4",FALSE,"Kansas City Chiefs",10,37,16,323,242,81,5,12,169,93,76,1,1986-12-07,-4,0,"den",-27
"15","Sat","December 13","W","","11-4",TRUE,"Washington Redskins",31,30,23,330,259,71,0,19,412,285,127,2,1986-12-13,2,1,"den",1
"16","Sat","December 20","L","","11-5",FALSE,"Seattle Seahawks",16,41,18,268,193,75,0,27,536,238,298,1,1986-12-20,1,0,"den",-25
"Division","Sun","January 4","W","","12-5",TRUE,"New England Patriots",22,17,23,441,253,188,2,12,271,150,121,0,1987-01-04,-2,1,"den",5
"ConfChamp","Sun","January 11","W","OT","13-5",FALSE,"Cleveland Browns",23,20,22,374,225,149,1,17,356,256,100,3,1987-01-11,2,1,"den",3
"SuperBowl","Sun","January 25","L","","13-6",TRUE,"New York Giants",20,39,24,372,320,52,1,24,399,263,136,0,1987-01-25,-1,0,"den",-19
"1","Sun","September 13","W","","1-0",TRUE,"Seattle Seahawks",40,17,25,504,338,166,2,15,277,169,108,5,1987-09-13,3,1,"den",23
"2","Sun","September 20","T","OT","1-0-1",FALSE,"Green Bay Packers",17,17,29,478,281,197,6,14,234,100,134,1,1987-09-20,-5,0,"den",0
"3","Sun","October 4","L","","1-1-1",TRUE,"Houston Oilers",10,40,14,220,182,38,3,20,414,260,154,2,1987-10-04,-1,0,"den",-30
"4","Mon","October 12","W","","2-1-1",TRUE,"Los Angeles Raiders",30,14,24,346,142,204,2,16,270,168,102,5,1987-10-12,3,1,"den",16
"5","Sun","October 18","W","","3-1-1",FALSE,"Kansas City Chiefs",26,17,23,373,275,98,4,16,247,125,122,3,1987-10-18,-1,1,"den",9
"6","Mon","October 26","L","","3-2-1",FALSE,"Minnesota Vikings",27,34,21,329,206,123,1,27,393,196,197,5,1987-10-26,4,0,"den",-7
"7","Sun","November 1","W","","4-2-1",TRUE,"Detroit Lions",34,0,28,460,248,212,1,14,191,128,63,2,1987-11-01,1,1,"den",34
"8","Sun","November 8","L","","4-3-1",FALSE,"Buffalo Bills",14,21,12,215,139,76,2,25,428,170,258,3,1987-11-08,1,0,"den",-7
"9","Mon","November 16","W","","5-3-1",TRUE,"Chicago Bears",31,29,26,439,341,98,2,24,446,300,146,2,1987-11-16,0,1,"den",2
"10","Sun","November 22","W","","6-3-1",FALSE,"Los Angeles Raiders",23,17,20,403,276,127,1,17,271,122,149,1,1987-11-22,0,1,"den",6
"11","Sun","November 29","W","","7-3-1",FALSE,"San Diego Chargers",31,17,31,522,347,175,1,18,378,312,66,2,1987-11-29,1,1,"den",14
"12","Sun","December 6","W","","8-3-1",TRUE,"New England Patriots",31,20,21,371,259,112,3,20,369,158,211,6,1987-12-06,3,1,"den",11
"13","Sun","December 13","L","","8-4-1",FALSE,"Seattle Seahawks",21,28,20,380,308,72,2,24,367,226,141,4,1987-12-13,2,0,"den",-7
"14","Sat","December 19","W","","9-4-1",TRUE,"Kansas City Chiefs",20,17,22,369,226,143,2,20,377,254,123,1,1987-12-19,-1,1,"den",3
"15","Sun","December 27","W","","10-4-1",TRUE,"San Diego Chargers",24,0,15,215,86,129,4,7,151,108,43,5,1987-12-27,1,1,"den",24
"Division","Sun","January 10","W","","11-4-1",TRUE,"Houston Oilers",34,10,19,316,255,61,1,20,337,264,73,3,1988-01-10,2,1,"den",24
"ConfChamp","Sun","January 17","W","","12-4-1",TRUE,"Cleveland Browns",38,33,24,412,256,156,1,25,464,336,128,4,1988-01-17,3,1,"den",5
"SuperBowl","Sun","January 31","L","","12-5-1",TRUE,"Washington Redskins",10,42,18,327,230,97,3,25,602,322,280,1,1988-01-31,-2,0,"den",-32
"1","Sun","September 4","L","","0-1",TRUE,"Seattle Seahawks",14,21,19,302,226,76,3,19,330,152,178,1,1988-09-04,-2,0,"den",-7
"2","Sun","September 11","W","","1-1",TRUE,"San Diego Chargers",34,3,24,443,259,184,0,13,244,111,133,2,1988-09-11,2,1,"den",31
"3","Sun","September 18","L","","1-2",FALSE,"Kansas City Chiefs",13,20,17,283,213,70,3,22,380,250,130,0,1988-09-18,-3,0,"den",-7
"4","Mon","September 26","L","OT","1-3",TRUE,"Los Angeles Raiders",27,30,23,398,209,189,5,20,363,235,128,1,1988-09-26,-4,0,"den",-3
"5","Sun","October 2","W","","2-3",FALSE,"San Diego Chargers",12,0,22,291,162,129,1,11,190,170,20,2,1988-10-02,1,1,"den",12
"6","Sun","October 9","W","OT","3-3",FALSE,"San Francisco 49ers",16,13,24,314,167,147,3,21,417,171,246,4,1988-10-09,1,1,"den",3
"7","Sun","October 16","W","","4-3",TRUE,"Atlanta Falcons",30,14,21,406,302,104,1,20,311,137,174,3,1988-10-16,2,1,"den",16
"8","Sun","October 23","L","","4-4",FALSE,"Pittsburgh Steelers",21,39,15,323,278,45,4,18,386,130,256,2,1988-10-23,-2,0,"den",-18
"9","Mon","October 31","L","","4-5",FALSE,"Indianapolis Colts",23,55,22,397,266,131,4,23,464,220,244,0,1988-10-31,-4,0,"den",-32
"10","Sun","November 6","W","","5-5",TRUE,"Kansas City Chiefs",17,11,23,308,177,131,2,16,273,183,90,3,1988-11-06,1,1,"den",6
"11","Sun","November 13","W","","6-5",TRUE,"Cleveland Browns",30,7,27,335,215,120,0,15,227,140,87,4,1988-11-13,4,1,"den",23
"12","Sun","November 20","L","","6-6",FALSE,"New Orleans Saints",0,42,17,258,206,52,1,28,385,189,196,0,1988-11-20,-1,0,"den",-42
"13","Sun","November 27","W","","7-6",TRUE,"Los Angeles Rams",35,24,19,368,270,98,1,28,484,352,132,3,1988-11-27,2,1,"den",11
"14","Sun","December 4","L","","7-7",FALSE,"Los Angeles Raiders",20,21,20,347,297,50,3,14,216,87,129,2,1988-12-04,-1,0,"den",-1
"15","Sun","December 11","L","","7-8",FALSE,"Seattle Seahawks",14,42,25,402,301,101,1,30,450,220,230,0,1988-12-11,-1,0,"den",-28
"16","Sat","December 17","W","","8-8",TRUE,"New England Patriots",21,10,20,331,143,188,2,18,351,186,165,2,1988-12-17,0,1,"den",11
"1","Sun","September 10","W","","1-0",TRUE,"Kansas City Chiefs",34,20,14,250,150,100,2,14,287,242,45,4,1989-09-10,2,1,"den",14
"2","Mon","September 18","W","","2-0",FALSE,"Buffalo Bills",28,14,26,382,181,201,2,28,413,319,94,4,1989-09-18,2,1,"den",14
"3","Sun","September 24","W","","3-0",TRUE,"Los Angeles Raiders",31,21,18,283,113,170,3,15,360,270,90,6,1989-09-24,3,1,"den",10
"4","Sun","October 1","L","","3-1",FALSE,"Cleveland Browns",13,16,10,241,161,80,3,16,296,201,95,1,1989-10-01,-2,0,"den",-3
"5","Sun","October 8","W","","4-1",TRUE,"San Diego Chargers",16,10,24,335,179,156,1,12,211,93,118,2,1989-10-08,1,1,"den",6
"6","Sun","October 15","W","","5-1",TRUE,"Indianapolis Colts",14,3,20,319,150,169,2,7,128,84,44,1,1989-10-15,-1,1,"den",11
"7","Sun","October 22","W","OT","6-1",FALSE,"Seattle Seahawks",24,21,15,371,316,55,1,23,363,224,139,4,1989-10-22,3,1,"den",3
"8","Sun","October 29","L","","6-2",TRUE,"Philadelphia Eagles",24,28,22,320,216,104,6,17,313,98,215,2,1989-10-29,-4,0,"den",-4
"9","Sun","November 5","W","","7-2",TRUE,"Pittsburgh Steelers",34,7,22,414,261,153,2,7,170,77,93,1,1989-11-05,-1,1,"den",27
"10","Sun","November 12","W","","8-2",FALSE,"Kansas City Chiefs",16,13,12,213,112,101,1,20,312,171,141,2,1989-11-12,1,1,"den",3
"11","Mon","November 20","W","","9-2",FALSE,"Washington Redskins",14,10,19,232,106,126,2,14,223,146,77,2,1989-11-20,0,1,"den",4
"12","Sun","November 26","W","","10-2",TRUE,"Seattle Seahawks",41,14,18,353,216,137,0,21,325,192,133,4,1989-11-26,4,1,"den",27
"13","Sun","December 3","L","OT","10-3",FALSE,"Los Angeles Raiders",13,16,26,332,176,156,2,11,257,178,79,1,1989-12-03,-1,0,"den",-3
"14","Sun","December 10","L","","10-4",TRUE,"New York Giants",7,14,18,367,284,83,0,16,261,148,113,0,1989-12-10,0,0,"den",-7
"15","Sat","December 16","W","","11-4",FALSE,"Phoenix Cardinals",37,0,28,475,271,204,2,7,101,79,22,3,1989-12-16,1,1,"den",37
"16","Sun","December 24","L","","11-5",FALSE,"San Diego Chargers",16,19,16,206,109,97,3,18,387,305,82,6,1989-12-24,3,0,"den",-3
"Division","Sun","January 7","W","","12-5",TRUE,"Pittsburgh Steelers",24,23,19,364,226,138,1,19,404,229,175,2,1990-01-07,1,1,"den",1
"ConfChamp","Sun","January 14","W","","13-5",TRUE,"Cleveland Browns",37,21,22,497,377,120,2,14,256,190,66,3,1990-01-14,1,1,"den",16
"SuperBowl","Sun","January 28","L","","13-6",TRUE,"San Francisco 49ers",10,55,12,167,103,64,4,28,461,317,144,0,1990-01-28,-4,0,"den",-45
"1","Sun","September 9","L","","0-1",FALSE,"Los Angeles Raiders",9,14,13,196,157,39,4,12,194,71,123,2,1990-09-09,-2,0,"den",-5
"2","Mon","September 17","W","","1-1",TRUE,"Kansas City Chiefs",24,23,18,399,250,149,2,22,441,363,78,1,1990-09-17,-1,1,"den",1
"3","Sun","September 23","W","OT","2-1",TRUE,"Seattle Seahawks",34,31,30,422,281,141,1,24,369,185,184,3,1990-09-23,2,1,"den",3
"4","Sun","September 30","L","","2-2",FALSE,"Buffalo Bills",28,29,28,410,202,208,5,15,197,133,64,3,1990-09-30,-2,0,"den",-1
"5","Mon","October 8","L","","2-3",TRUE,"Cleveland Browns",29,30,19,316,175,141,2,23,415,318,97,3,1990-10-08,1,0,"den",-1
"6","Sun","October 14","L","","2-4",TRUE,"Pittsburgh Steelers",17,34,16,244,178,66,1,25,451,343,108,2,1990-10-14,1,0,"den",-17
"7","Sun","October 21","W","","3-4",FALSE,"Indianapolis Colts",27,17,23,444,293,151,1,23,363,304,59,1,1990-10-21,0,1,"den",10
"9","Sun","November 4","L","","3-5",FALSE,"Minnesota Vikings",22,27,19,287,141,146,3,15,256,111,145,1,1990-11-04,-2,0,"den",-5
"10","Sun","November 11","L","","3-6",FALSE,"San Diego Chargers",7,19,15,211,149,62,2,17,340,159,181,0,1990-11-11,-2,0,"den",-12
"11","Sun","November 18","L","OT","3-7",TRUE,"Chicago Bears",13,16,21,330,222,108,2,21,341,139,202,0,1990-11-18,-2,0,"den",-3
"12","Thu","November 22","L","","3-8",FALSE,"Detroit Lions",27,40,19,284,211,73,2,22,421,248,173,1,1990-11-22,-1,0,"den",-13
"13","Sun","December 2","L","","3-9",TRUE,"Los Angeles Raiders",20,23,20,357,216,141,1,17,293,145,148,0,1990-12-02,-1,0,"den",-3
"14","Sun","December 9","L","","3-10",FALSE,"Kansas City Chiefs",20,31,26,374,300,74,3,19,365,254,111,1,1990-12-09,-2,0,"den",-11
"15","Sun","December 16","W","","4-10",TRUE,"San Diego Chargers",20,10,16,320,233,87,0,24,390,298,92,2,1990-12-16,2,1,"den",10
"16","Sun","December 23","L","","4-11",FALSE,"Seattle Seahawks",12,17,16,246,145,101,2,13,213,103,110,1,1990-12-23,-1,0,"den",-5
"17","Sun","December 30","W","","5-11",TRUE,"Green Bay Packers",22,13,24,373,188,185,1,14,296,208,88,4,1990-12-30,3,1,"den",9
"1","Sun","September 1","W","","1-0",TRUE,"Cincinnati Bengals",45,14,25,471,286,185,0,10,246,193,53,4,1991-09-01,4,1,"den",31
"2","Sun","September 8","L","","1-1",FALSE,"Los Angeles Raiders",13,16,12,247,214,33,1,16,273,140,133,0,1991-09-08,-1,0,"den",-3
"3","Sun","September 15","W","","2-1",TRUE,"Seattle Seahawks",16,10,16,345,246,99,2,17,362,312,50,4,1991-09-15,2,1,"den",6
"4","Sun","September 22","W","","3-1",TRUE,"San Diego Chargers",27,19,18,360,216,144,2,17,297,126,171,2,1991-09-22,0,1,"den",8
"5","Sun","September 29","W","","4-1",FALSE,"Minnesota Vikings",13,6,17,242,63,179,1,15,324,121,203,3,1991-09-29,2,1,"den",7
"6","Sun","October 6","L","","4-2",FALSE,"Houston Oilers",14,42,23,363,272,91,3,17,378,327,51,2,1991-10-06,-1,0,"den",-28
"8","Sun","October 20","W","","5-2",TRUE,"Kansas City Chiefs",19,16,14,324,229,95,0,22,328,209,119,0,1991-10-20,0,1,"den",3
"9","Sun","October 27","W","","6-2",FALSE,"New England Patriots",9,6,14,243,141,102,1,15,287,146,141,0,1991-10-27,-1,1,"den",3
"10","Sun","November 3","W","","7-2",TRUE,"Pittsburgh Steelers",20,13,17,274,130,144,2,19,309,163,146,1,1991-11-03,-1,1,"den",7
"11","Sun","November 10","L","","7-3",TRUE,"Los Angeles Raiders",16,17,23,383,183,200,3,13,244,126,118,0,1991-11-10,-3,0,"den",-1
"12","Sun","November 17","W","","8-3",FALSE,"Kansas City Chiefs",24,20,14,259,87,172,0,21,417,292,125,4,1991-11-17,4,1,"den",4
"13","Sun","November 24","L","","8-4",FALSE,"Seattle Seahawks",10,13,12,210,112,98,4,11,199,53,146,4,1991-11-24,0,0,"den",-3
"14","Sun","December 1","W","","9-4",TRUE,"New England Patriots",20,3,19,325,209,116,1,14,252,202,50,4,1991-12-01,3,1,"den",17
"15","Sun","December 8","W","","10-4",FALSE,"Cleveland Browns",17,7,17,290,200,90,1,9,181,80,101,1,1991-12-08,0,1,"den",10
"16","Sun","December 15","W","","11-4",TRUE,"Phoenix Cardinals",24,19,22,365,243,122,3,13,231,158,73,0,1991-12-15,-3,1,"den",5
"17","Sun","December 22","W","","12-4",FALSE,"San Diego Chargers",17,14,21,311,166,145,1,13,221,107,114,4,1991-12-22,3,1,"den",3
"Division","Sat","January 4","W","","13-4",TRUE,"Houston Oilers",26,24,26,418,267,151,1,23,422,325,97,1,1992-01-04,0,1,"den",2
"ConfChamp","Sun","January 12","L","","13-5",FALSE,"Buffalo Bills",7,10,20,304,223,81,2,12,213,109,104,2,1992-01-12,0,0,"den",-3
"1","Sun","September 6","W","","1-0",TRUE,"Los Angeles Raiders",17,13,12,200,153,47,3,20,313,161,152,5,1992-09-06,2,1,"den",4
"2","Sun","September 13","W","","2-0",TRUE,"San Diego Chargers",21,13,12,226,162,64,1,27,355,187,168,2,1992-09-13,1,1,"den",8
"3","Sun","September 20","L","","2-1",FALSE,"Philadelphia Eagles",0,30,4,82,30,52,1,20,388,258,130,0,1992-09-20,-1,0,"den",-30
"4","Sun","September 27","W","","3-1",FALSE,"Cleveland Browns",12,0,15,300,112,188,1,10,216,75,141,3,1992-09-27,2,1,"den",12
"5","Sun","October 4","W","","4-1",TRUE,"Kansas City Chiefs",20,19,20,347,279,68,1,20,369,279,90,0,1992-10-04,-1,1,"den",1
"6","Mon","October 12","L","","4-2",FALSE,"Washington Redskins",3,34,7,128,102,26,4,17,362,245,117,1,1992-10-12,-3,0,"den",-31
"7","Sun","October 18","W","","5-2",TRUE,"Houston Oilers",27,21,14,322,152,170,0,21,407,298,109,1,1992-10-18,1,1,"den",6
"8","Sun","October 25","L","","5-3",FALSE,"San Diego Chargers",21,24,18,351,260,91,3,20,441,340,101,3,1992-10-25,0,0,"den",-3
"10","Sun","November 8","W","","6-3",TRUE,"New York Jets",27,16,19,375,261,114,4,15,341,182,159,2,1992-11-08,-2,1,"den",11
"11","Sun","November 15","W","","7-3",TRUE,"New York Giants",27,13,18,379,230,149,2,10,159,39,120,1,1992-11-15,-1,1,"den",14
"12","Sun","November 22","L","","7-4",FALSE,"Los Angeles Raiders",0,24,15,267,182,85,3,20,317,150,167,0,1992-11-22,-3,0,"den",-24
"13","Mon","November 30","L","OT","7-5",FALSE,"Seattle Seahawks",13,16,10,196,112,84,2,15,308,234,74,4,1992-11-30,2,0,"den",-3
"14","Sun","December 6","L","","7-6",TRUE,"Dallas Cowboys",27,31,15,354,261,93,5,22,304,222,82,0,1992-12-06,-5,0,"den",-4
"15","Sat","December 12","L","","7-7",FALSE,"Buffalo Bills",17,27,24,320,222,98,5,17,361,210,151,4,1992-12-12,-1,0,"den",-10
"16","Sun","December 20","W","","8-7",TRUE,"Seattle Seahawks",10,6,15,293,204,89,5,16,222,80,142,2,1992-12-20,-3,1,"den",4
"17","Sun","December 27","L","","8-8",FALSE,"Kansas City Chiefs",20,42,16,290,208,82,3,13,220,160,60,3,1992-12-27,0,0,"den",-22
"1","Sun","September 5","W","","1-0",FALSE,"New York Jets",26,20,18,353,254,99,1,20,422,351,71,3,1993-09-05,2,1,"den",6
"2","Sun","September 12","W","","2-0",TRUE,"San Diego Chargers",34,17,17,342,284,58,2,26,390,322,68,2,1993-09-12,0,1,"den",17
"3","Mon","September 20","L","","2-1",FALSE,"Kansas City Chiefs",7,15,17,335,300,35,3,21,414,254,160,1,1993-09-20,-2,0,"den",-8
"5","Sun","October 3","W","","3-1",TRUE,"Indianapolis Colts",35,13,26,454,258,196,2,16,271,160,111,2,1993-10-03,0,1,"den",22
"6","Sun","October 10","L","","3-2",FALSE,"Green Bay Packers",27,30,26,388,333,55,2,15,299,235,64,3,1993-10-10,1,0,"den",-3
"7","Mon","October 18","L","","3-3",TRUE,"Los Angeles Raiders",20,23,18,253,121,132,2,12,308,255,53,2,1993-10-18,0,0,"den",-3
"9","Sun","October 31","W","","4-3",TRUE,"Seattle Seahawks",28,17,25,326,239,87,1,19,287,184,103,2,1993-10-31,1,1,"den",11
"10","Sun","November 7","W","","5-3",FALSE,"Cleveland Browns",29,14,21,393,233,160,1,14,266,191,75,0,1993-11-07,-1,1,"den",15
"11","Sun","November 14","L","","5-4",TRUE,"Minnesota Vikings",23,26,25,342,250,92,4,18,427,357,70,3,1993-11-14,-1,0,"den",-3
"12","Sun","November 21","W","","6-4",TRUE,"Pittsburgh Steelers",37,13,23,364,257,107,0,19,349,248,101,3,1993-11-21,3,1,"den",24
"13","Sun","November 28","W","","7-4",FALSE,"Seattle Seahawks",17,9,19,307,206,101,2,13,288,161,127,2,1993-11-28,0,1,"den",8
"14","Sun","December 5","L","","7-5",FALSE,"San Diego Chargers",10,13,14,224,138,86,2,20,298,203,95,0,1993-12-05,-2,0,"den",-3
"15","Sun","December 12","W","","8-5",TRUE,"Kansas City Chiefs",27,21,23,340,204,136,2,17,311,234,77,1,1993-12-12,-1,1,"den",6
"16","Sat","December 18","W","","9-5",FALSE,"Chicago Bears",13,3,15,234,105,129,1,14,185,101,84,5,1993-12-18,4,1,"den",10
"17","Sun","December 26","L","","9-6",TRUE,"Tampa Bay Buccaneers",10,17,18,335,225,110,3,13,236,171,65,1,1993-12-26,-2,0,"den",-7
"18","Sun","January 2","L","OT","9-7",FALSE,"Los Angeles Raiders",30,33,22,471,361,110,0,24,398,304,94,1,1994-01-02,1,0,"den",-3
"WildCard","Sun","January 9","L","","9-8",FALSE,"Los Angeles Raiders",24,42,26,387,331,56,1,19,427,291,136,0,1994-01-09,-1,0,"den",-18
"1","Sun","September 4","L","","0-1",TRUE,"San Diego Chargers",34,37,30,470,341,129,3,19,370,232,138,1,1994-09-04,-2,0,"den",-3
"2","Sun","September 11","L","OT","0-2",FALSE,"New York Jets",22,25,22,401,316,85,1,19,366,287,79,2,1994-09-11,1,0,"den",-3
"3","Sun","September 18","L","","0-3",TRUE,"Los Angeles Raiders",16,48,21,292,223,69,3,20,424,322,102,1,1994-09-18,-2,0,"den",-32
"4","Mon","September 26","L","","0-4",FALSE,"Buffalo Bills",20,27,21,337,260,77,2,19,315,166,149,1,1994-09-26,-1,0,"den",-7
"6","Sun","October 9","W","","1-4",FALSE,"Seattle Seahawks",16,9,19,278,128,150,0,16,338,244,94,5,1994-10-09,5,1,"den",7
"7","Mon","October 17","L","","1-5",TRUE,"Kansas City Chiefs",28,31,21,330,233,97,3,26,483,393,90,2,1994-10-17,-1,0,"den",-3
"8","Sun","October 23","W","","2-5",FALSE,"San Diego Chargers",20,15,16,294,225,69,3,18,321,155,166,3,1994-10-23,0,1,"den",5
"9","Sun","October 30","W","","3-5",TRUE,"Cleveland Browns",26,14,29,457,343,114,2,17,317,276,41,1,1994-10-30,-1,1,"den",12
"10","Sun","November 6","L","","3-6",FALSE,"Los Angeles Rams",21,27,24,284,236,48,0,23,385,244,141,2,1994-11-06,2,0,"den",-6
"11","Sun","November 13","W","","4-6",TRUE,"Seattle Seahawks",17,10,21,297,128,169,2,14,289,131,158,1,1994-11-13,-1,1,"den",7
"12","Sun","November 20","W","","5-6",TRUE,"Atlanta Falcons",32,28,25,425,336,89,2,16,330,254,76,0,1994-11-20,-2,1,"den",4
"13","Sun","November 27","W","","6-6",TRUE,"Cincinnati Bengals",15,13,12,256,206,50,0,16,328,198,130,4,1994-11-27,4,1,"den",2
"14","Sun","December 4","W","OT","7-6",FALSE,"Kansas City Chiefs",20,17,26,393,270,123,1,17,401,323,78,1,1994-12-04,0,1,"den",3
"15","Sun","December 11","L","","7-7",FALSE,"Los Angeles Raiders",13,23,16,291,228,63,2,16,305,177,128,0,1994-12-11,-2,0,"den",-10
"16","Sat","December 17","L","","7-8",FALSE,"San Francisco 49ers",19,42,20,334,286,48,3,25,488,386,102,1,1994-12-17,-2,0,"den",-23
"17","Sat","December 24","L","","7-9",TRUE,"New Orleans Saints",28,30,23,348,258,90,4,22,447,367,80,1,1994-12-24,-3,0,"den",-2
"1","Sun","September 3","W","","1-0",TRUE,"Buffalo Bills",22,7,24,439,299,140,1,14,234,174,60,0,1995-09-03,-1,1,"den",15
"2","Sun","September 10","L","","1-1",FALSE,"Dallas Cowboys",21,31,17,287,198,89,2,27,358,196,162,1,1995-09-10,-1,0,"den",-10
"3","Sun","September 17","W","","2-1",TRUE,"Washington Redskins",38,31,28,476,318,158,0,20,354,225,129,1,1995-09-17,1,1,"den",7
"4","Sun","September 24","L","","2-2",FALSE,"San Diego Chargers",6,17,12,246,181,65,0,23,334,176,158,1,1995-09-24,1,0,"den",-11
"5","Sun","October 1","L","","2-3",FALSE,"Seattle Seahawks",10,27,18,318,243,75,1,26,422,192,230,0,1995-10-01,-1,0,"den",-17
"6","Sun","October 8","W","","3-3",FALSE,"New England Patriots",37,3,23,403,282,121,1,22,329,248,81,2,1995-10-08,1,1,"den",34
"7","Mon","October 16","W","","4-3",TRUE,"Oakland Raiders",27,0,24,475,351,124,3,10,169,148,21,4,1995-10-16,1,1,"den",27
"8","Sun","October 22","L","","4-4",TRUE,"Kansas City Chiefs",7,21,19,285,200,85,3,21,332,161,171,0,1995-10-22,-3,0,"den",-14
"10","Sun","November 5","W","","5-4",TRUE,"Arizona Cardinals",38,6,24,406,258,148,1,18,277,203,74,2,1995-11-05,1,1,"den",32
"11","Sun","November 12","L","","5-5",FALSE,"Philadelphia Eagles",13,31,15,280,148,132,1,25,381,256,125,0,1995-11-12,-1,0,"den",-18
"12","Sun","November 19","W","","6-5",TRUE,"San Diego Chargers",30,27,25,463,290,173,2,20,269,199,70,1,1995-11-19,-1,1,"den",3
"13","Sun","November 26","L","","6-6",FALSE,"Houston Oilers",33,42,22,472,332,140,2,23,448,280,168,2,1995-11-26,0,0,"den",-9
"14","Sun","December 3","W","","7-6",TRUE,"Jacksonville Jaguars",31,23,20,397,286,111,3,13,260,191,69,2,1995-12-03,-1,1,"den",8
"15","Sun","December 10","L","","7-7",TRUE,"Seattle Seahawks",27,31,25,388,148,240,5,19,326,192,134,2,1995-12-10,-3,0,"den",-4
"16","Sun","December 17","L","","7-8",FALSE,"Kansas City Chiefs",17,20,18,268,204,64,2,22,364,219,145,1,1995-12-17,-1,0,"den",-3
"17","Sun","December 24","W","","8-8",FALSE,"Oakland Raiders",31,28,30,437,307,130,3,19,336,238,98,2,1995-12-24,-1,1,"den",3
"1","Sun","September 1","W","","1-0",TRUE,"New York Jets",31,6,21,367,167,200,3,12,188,72,116,4,1996-09-01,1,1,"den",25
"2","Sun","September 8","W","","2-0",FALSE,"Seattle Seahawks",30,20,22,374,194,180,1,10,211,172,39,3,1996-09-08,2,1,"den",10
"3","Sun","September 15","W","","3-0",TRUE,"Tampa Bay Buccaneers",27,23,20,374,180,194,3,15,307,186,121,2,1996-09-15,-1,1,"den",4
"4","Sun","September 22","L","","3-1",FALSE,"Kansas City Chiefs",14,17,17,299,138,161,2,20,306,231,75,1,1996-09-22,-1,0,"den",-3
"5","Sun","September 29","W","","4-1",FALSE,"Cincinnati Bengals",14,10,22,402,288,114,3,17,253,147,106,1,1996-09-29,-2,1,"den",4
"6","Sun","October 6","W","","5-1",TRUE,"San Diego Chargers",28,17,23,406,312,94,1,14,245,210,35,0,1996-10-06,-1,1,"den",11
"8","Sun","October 20","W","","6-1",TRUE,"Baltimore Ravens",45,34,26,548,326,222,1,23,392,317,75,1,1996-10-20,0,1,"den",11
"9","Sun","October 27","W","","7-1",TRUE,"Kansas City Chiefs",34,7,26,499,286,213,3,10,232,208,24,2,1996-10-27,-1,1,"den",27
"10","Mon","November 4","W","","8-1",FALSE,"Oakland Raiders",22,21,18,312,160,152,1,17,321,216,105,0,1996-11-04,-1,1,"den",1
"11","Sun","November 10","W","","9-1",TRUE,"Chicago Bears",17,12,17,284,192,92,0,24,346,172,174,3,1996-11-10,3,1,"den",5
"12","Sun","November 17","W","","10-1",FALSE,"New England Patriots",34,8,26,422,224,198,1,12,218,201,17,1,1996-11-17,0,1,"den",26
"13","Sun","November 24","W","","11-1",FALSE,"Minnesota Vikings",21,17,22,388,309,79,3,20,296,246,50,2,1996-11-24,-1,1,"den",4
"14","Sun","December 1","W","","12-1",TRUE,"Seattle Seahawks",34,7,31,441,236,205,0,13,277,172,105,3,1996-12-01,3,1,"den",27
"15","Sun","December 8","L","","12-2",FALSE,"Green Bay Packers",6,41,9,176,83,93,3,22,379,276,103,2,1996-12-08,-1,0,"den",-35
"16","Sun","December 15","W","","13-2",TRUE,"Oakland Raiders",24,19,23,285,186,99,3,18,255,150,105,4,1996-12-15,1,1,"den",5
"17","Sun","December 22","L","","13-3",FALSE,"San Diego Chargers",10,16,13,214,148,66,4,14,244,163,81,3,1996-12-22,-1,0,"den",-6
"Division","Sat","January 4","L","","13-4",TRUE,"Jacksonville Jaguars",27,30,21,351,225,126,0,22,443,240,203,0,1997-01-04,0,0,"den",-3
"1","Sun","August 31","W","","1-0",TRUE,"Kansas City Chiefs",19,3,20,378,232,146,0,12,241,108,133,1,1997-08-31,1,1,"den",16
"2","Sun","September 7","W","","2-0",FALSE,"Seattle Seahawks",35,14,22,331,188,143,1,16,289,220,69,1,1997-09-07,0,1,"den",21
"3","Sun","September 14","W","","3-0",TRUE,"St. Louis Rams",35,14,19,377,233,144,2,18,314,184,130,2,1997-09-14,0,1,"den",21
"4","Sun","September 21","W","","4-0",TRUE,"Cincinnati Bengals",38,20,23,372,150,222,1,22,389,194,195,1,1997-09-21,0,1,"den",18
"5","Sun","September 28","W","","5-0",FALSE,"Atlanta Falcons",29,21,16,329,228,101,1,17,308,196,112,1,1997-09-28,0,1,"den",8
"6","Mon","October 6","W","","6-0",TRUE,"New England Patriots",34,13,25,380,188,192,2,13,262,211,51,2,1997-10-06,0,1,"den",21
"8","Sun","October 19","L","","6-1",FALSE,"Oakland Raiders",25,28,25,441,294,147,1,12,324,81,243,2,1997-10-19,1,0,"den",-3
"9","Sun","October 26","W","OT","7-1",FALSE,"Buffalo Bills",23,20,17,341,116,225,3,19,315,160,155,6,1997-10-26,3,1,"den",3
"10","Sun","November 2","W","","8-1",TRUE,"Seattle Seahawks",30,27,19,385,245,140,2,22,349,245,104,2,1997-11-02,0,1,"den",3
"11","Sun","November 9","W","","9-1",TRUE,"Carolina Panthers",34,0,20,393,233,160,1,7,147,113,34,4,1997-11-09,3,1,"den",34
"12","Sun","November 16","L","","9-2",FALSE,"Kansas City Chiefs",22,24,26,329,194,135,1,15,202,96,106,1,1997-11-16,0,0,"den",-2
"13","Mon","November 24","W","","10-2",TRUE,"Oakland Raiders",31,3,23,370,260,110,1,14,260,150,110,2,1997-11-24,1,1,"den",28
"14","Sun","November 30","W","","11-2",FALSE,"San Diego Chargers",38,28,28,438,240,198,0,22,269,222,47,2,1997-11-30,2,1,"den",10
"15","Sun","December 7","L","","11-3",FALSE,"Pittsburgh Steelers",24,35,18,320,231,89,1,22,476,290,186,2,1997-12-07,1,0,"den",-11
"16","Mon","December 15","L","","11-4",FALSE,"San Francisco 49ers",17,34,15,237,141,96,3,18,323,265,58,1,1997-12-15,-2,0,"den",-17
"17","Sun","December 21","W","","12-4",TRUE,"San Diego Chargers",38,3,24,451,321,130,1,9,203,133,70,1,1997-12-21,0,1,"den",35
"WildCard","Sat","December 27","W","","13-4",TRUE,"Jacksonville Jaguars",42,17,28,511,201,310,2,14,237,187,50,2,1997-12-27,0,1,"den",25
"Division","Sun","January 4","W","","14-4",FALSE,"Kansas City Chiefs",14,10,16,272,163,109,2,18,303,226,77,0,1998-01-04,-2,1,"den",4
"ConfChamp","Sun","January 11","W","","15-4",FALSE,"Pittsburgh Steelers",24,21,23,345,195,150,2,23,354,193,161,4,1998-01-11,2,1,"den",3
"SuperBowl","Sun","January 25","W","","16-4",TRUE,"Green Bay Packers",31,24,21,302,123,179,2,21,350,255,95,3,1998-01-25,1,1,"den",7
"1","Mon","September 7","W","","1-0",TRUE,"New England Patriots",27,21,20,339,248,91,0,17,339,258,81,0,1998-09-07,0,1,"den",6
"2","Sun","September 13","W","","2-0",TRUE,"Dallas Cowboys",42,23,21,515,306,209,0,18,370,201,169,0,1998-09-13,0,1,"den",19
"3","Sun","September 20","W","","3-0",FALSE,"Oakland Raiders",34,17,25,338,193,145,2,13,258,164,94,3,1998-09-20,1,1,"den",17
"4","Sun","September 27","W","","4-0",FALSE,"Washington Redskins",38,16,18,365,180,185,0,18,387,235,152,3,1998-09-27,3,1,"den",22
"5","Sun","October 4","W","","5-0",TRUE,"Philadelphia Eagles",41,16,22,423,192,231,2,12,157,100,57,2,1998-10-04,0,1,"den",25
"6","Sun","October 11","W","","6-0",FALSE,"Seattle Seahawks",21,16,17,373,171,202,2,16,319,242,77,1,1998-10-11,-1,1,"den",5
"8","Sun","October 25","W","","7-0",TRUE,"Jacksonville Jaguars",37,24,24,465,295,170,0,24,348,282,66,1,1998-10-25,1,1,"den",13
"9","Sun","November 1","W","","8-0",FALSE,"Cincinnati Bengals",33,26,20,352,202,150,1,25,372,245,127,1,1998-11-01,0,1,"den",7
"10","Sun","November 8","W","","9-0",TRUE,"San Diego Chargers",27,10,19,289,217,72,1,13,213,136,77,3,1998-11-08,2,1,"den",17
"11","Mon","November 16","W","","10-0",FALSE,"Kansas City Chiefs",30,7,26,379,174,205,0,15,221,190,31,1,1998-11-16,1,1,"den",23
"12","Sun","November 22","W","","11-0",TRUE,"Oakland Raiders",40,14,28,397,201,196,1,15,294,245,49,3,1998-11-22,2,1,"den",26
"13","Sun","November 29","W","","12-0",FALSE,"San Diego Chargers",31,16,18,322,226,96,4,21,367,302,65,6,1998-11-29,2,1,"den",15
"14","Sun","December 6","W","","13-0",TRUE,"Kansas City Chiefs",35,31,23,476,383,93,3,20,266,222,44,1,1998-12-06,-2,1,"den",4
"15","Sun","December 13","L","","13-1",FALSE,"New York Giants",16,20,21,329,159,170,1,18,392,254,138,2,1998-12-13,1,0,"den",-4
"16","Mon","December 21","L","","13-2",FALSE,"Miami Dolphins",21,31,14,219,161,58,2,19,391,355,36,2,1998-12-21,0,0,"den",-10
"17","Sun","December 27","W","","14-2",TRUE,"Seattle Seahawks",28,21,31,511,316,195,1,19,241,217,24,1,1998-12-27,0,1,"den",7
"Division","Sat","January 9","W","","15-2",TRUE,"Miami Dolphins",38,3,24,424,174,250,0,14,252,238,14,3,1999-01-09,3,1,"den",35
"ConfChamp","Sun","January 17","W","","16-2",TRUE,"New York Jets",23,10,14,331,153,178,0,18,370,356,14,6,1999-01-17,6,1,"den",13
"SuperBowl","Sun","January 31","W","","17-2",TRUE,"Atlanta Falcons",34,19,22,457,336,121,1,21,337,206,131,4,1999-01-31,3,1,"den",15
"1","Mon","September 13","L","","0-1",TRUE,"Miami Dolphins",21,38,25,353,240,113,1,22,326,215,111,0,1999-09-13,-1,0,"den",-17
"2","Sun","September 19","L","","0-2",FALSE,"Kansas City Chiefs",10,26,20,244,156,88,4,17,365,177,188,1,1999-09-19,-3,0,"den",-16
"3","Sun","September 26","L","","0-3",FALSE,"Tampa Bay Buccaneers",10,13,8,173,120,53,1,17,243,78,165,2,1999-09-26,1,0,"den",-3
"4","Sun","October 3","L","","0-4",TRUE,"New York Jets",13,21,17,326,218,108,6,23,334,224,110,2,1999-10-03,-4,0,"den",-8
"5","Sun","October 10","W","","1-4",FALSE,"Oakland Raiders",16,13,16,302,221,81,2,17,265,210,55,2,1999-10-10,0,1,"den",3
"6","Sun","October 17","W","","2-4",TRUE,"Green Bay Packers",31,10,28,514,363,151,1,5,133,112,21,3,1999-10-17,2,1,"den",21
"7","Sun","October 24","L","","2-5",FALSE,"New England Patriots",23,24,23,442,309,133,0,15,325,192,133,0,1999-10-24,0,0,"den",-1
"8","Sun","October 31","L","","2-6",TRUE,"Minnesota Vikings",20,23,24,391,256,135,3,15,302,205,97,0,1999-10-31,-3,0,"den",-3
"9","Sun","November 7","W","","3-6",FALSE,"San Diego Chargers",33,17,17,241,127,114,0,19,273,214,59,4,1999-11-07,4,1,"den",16
"10","Sun","November 14","L","","3-7",FALSE,"Seattle Seahawks",17,20,18,323,236,87,1,14,271,230,41,2,1999-11-14,1,0,"den",-3
"11","Mon","November 22","W","OT","4-7",TRUE,"Oakland Raiders",27,21,17,291,171,120,2,16,284,205,79,3,1999-11-22,1,1,"den",6
"13","Sun","December 5","L","","4-8",TRUE,"Kansas City Chiefs",10,16,14,291,208,83,1,17,352,175,177,1,1999-12-05,0,0,"den",-6
"14","Mon","December 13","L","","4-9",FALSE,"Jacksonville Jaguars",24,27,18,358,268,90,2,18,265,104,161,0,1999-12-13,-2,0,"den",-3
"15","Sun","December 19","W","OT","5-9",TRUE,"Seattle Seahawks",36,30,26,430,170,260,2,19,364,250,114,2,1999-12-19,0,1,"den",6
"16","Sat","December 25","W","","6-9",FALSE,"Detroit Lions",17,7,22,369,165,204,1,16,274,242,32,0,1999-12-25,-1,1,"den",10
"17","Sun","January 2","L","","6-10",TRUE,"San Diego Chargers",6,12,15,235,191,44,1,17,377,183,194,4,2000-01-02,3,0,"den",-6
"1","Mon","September 4","L","","0-1",FALSE,"St. Louis Rams",36,41,25,424,274,150,0,23,513,433,80,3,2000-09-04,3,0,"den",-5
"2","Sun","September 10","W","","1-1",TRUE,"Atlanta Falcons",42,14,29,407,255,152,0,12,186,139,47,3,2000-09-10,3,1,"den",28
"3","Sun","September 17","W","","2-1",FALSE,"Oakland Raiders",33,24,25,387,207,180,1,16,263,140,123,4,2000-09-17,3,1,"den",9
"4","Sun","September 24","L","","2-2",TRUE,"Kansas City Chiefs",22,23,21,342,197,145,3,21,294,245,49,3,2000-09-24,0,0,"den",-1
"5","Sun","October 1","L","","2-3",TRUE,"New England Patriots",19,28,26,405,326,79,2,19,314,260,54,1,2000-10-01,-1,0,"den",-9
"6","Sun","October 8","W","","3-3",FALSE,"San Diego Chargers",21,7,18,304,208,96,0,17,277,212,65,3,2000-10-08,3,1,"den",14
"7","Sun","October 15","W","","4-3",TRUE,"Cleveland Browns",44,10,24,499,353,146,0,12,278,240,38,3,2000-10-15,3,1,"den",34
"8","Sun","October 22","L","","4-4",FALSE,"Cincinnati Bengals",21,31,32,500,358,142,3,15,421,14,407,1,2000-10-22,-2,0,"den",-10
"10","Sun","November 5","W","","5-4",FALSE,"New York Jets",30,23,23,447,317,130,1,22,381,293,88,3,2000-11-05,2,1,"den",7
"11","Mon","November 13","W","","6-4",TRUE,"Oakland Raiders",27,24,18,329,258,71,2,25,411,373,38,3,2000-11-13,1,1,"den",3
"12","Sun","November 19","W","","7-4",TRUE,"San Diego Chargers",38,37,34,536,443,93,5,14,385,299,86,3,2000-11-19,-2,1,"den",1
"13","Sun","November 26","W","","8-4",FALSE,"Seattle Seahawks",38,31,25,538,237,301,5,17,354,269,85,3,2000-11-26,-2,1,"den",7
"14","Sun","December 3","W","","9-4",FALSE,"New Orleans Saints",38,23,24,483,200,283,0,19,446,425,21,3,2000-12-03,3,1,"den",15
"15","Sun","December 10","W","","10-4",TRUE,"Seattle Seahawks",31,24,20,313,182,131,1,22,405,298,107,4,2000-12-10,3,1,"den",7
"16","Sun","December 17","L","","10-5",FALSE,"Kansas City Chiefs",7,20,11,278,225,53,1,24,424,160,264,2,2000-12-17,1,0,"den",-13
"17","Sat","December 23","W","","11-5",TRUE,"San Francisco 49ers",38,9,28,362,203,159,1,16,192,146,46,2,2000-12-23,1,1,"den",29
"WildCard","Sun","December 31","L","","11-6",FALSE,"Baltimore Ravens",3,21,9,177,135,42,1,13,240,118,122,0,2000-12-31,-1,0,"den",-18
"1","Mon","September 10","W","","1-0",TRUE,"New York Giants",31,20,25,473,330,143,0,17,308,245,63,0,2001-09-10,0,1,"den",11
"2","Sun","September 23","W","","2-0",FALSE,"Arizona Cardinals",38,17,27,381,234,147,0,14,308,224,84,3,2001-09-23,3,1,"den",21
"3","Sun","September 30","L","","2-1",TRUE,"Baltimore Ravens",13,20,13,228,167,61,3,16,333,221,112,1,2001-09-30,-2,0,"den",-7
"4","Sun","October 7","W","","3-1",TRUE,"Kansas City Chiefs",20,6,15,300,103,197,1,16,297,255,42,4,2001-10-07,3,1,"den",14
"5","Sun","October 14","L","","3-2",FALSE,"Seattle Seahawks",21,34,20,281,189,92,3,21,254,93,161,1,2001-10-14,-2,0,"den",-13
"6","Sun","October 21","L","","3-3",FALSE,"San Diego Chargers",10,27,19,263,182,81,3,22,379,272,107,2,2001-10-21,-1,0,"den",-17
"7","Sun","October 28","W","","4-3",TRUE,"New England Patriots",31,20,18,355,269,86,2,21,300,183,117,5,2001-10-28,3,1,"den",11
"8","Mon","November 5","L","","4-4",FALSE,"Oakland Raiders",28,38,26,366,247,119,2,27,356,242,114,1,2001-11-05,-1,0,"den",-10
"9","Sun","November 11","W","","5-4",TRUE,"San Diego Chargers",26,16,19,338,221,117,1,9,243,147,96,5,2001-11-11,4,1,"den",10
"10","Sun","November 18","L","","5-5",TRUE,"Washington Redskins",10,17,10,186,98,88,2,18,245,127,118,3,2001-11-18,1,0,"den",-7
"11","Thu","November 22","W","","6-5",FALSE,"Dallas Cowboys",26,24,19,279,160,119,1,16,191,164,27,2,2001-11-22,1,1,"den",2
"12","Sun","December 2","L","","6-6",FALSE,"Miami Dolphins",10,21,19,273,126,147,2,12,218,176,42,1,2001-12-02,-1,0,"den",-11
"13","Sun","December 9","W","","7-6",TRUE,"Seattle Seahawks",20,7,20,309,144,165,2,15,277,207,70,2,2001-12-09,0,1,"den",13
"14","Sun","December 16","L","OT","7-7",FALSE,"Kansas City Chiefs",23,26,22,335,241,94,1,22,396,259,137,3,2001-12-16,2,0,"den",-3
"16","Sun","December 30","W","","8-7",TRUE,"Oakland Raiders",23,17,15,231,125,106,0,24,334,283,51,3,2001-12-30,3,1,"den",6
"17","Sun","January 6","L","","8-8",FALSE,"Indianapolis Colts",10,29,17,219,104,115,4,22,335,184,151,1,2002-01-06,-3,0,"den",-19
"1","Sun","September 8","W","","1-0",TRUE,"St. Louis Rams",23,16,18,291,187,104,2,15,327,295,32,2,2002-09-08,0,1,"den",7
"2","Sun","September 15","W","","2-0",FALSE,"San Francisco 49ers",24,14,21,299,98,201,1,18,261,190,71,2,2002-09-15,1,1,"den",10
"3","Sun","September 22","W","","3-0",TRUE,"Buffalo Bills",28,23,22,342,179,163,0,17,291,252,39,1,2002-09-22,1,1,"den",5
"4","Mon","September 30","L","","3-1",FALSE,"Baltimore Ravens",23,34,30,403,306,97,3,14,230,146,84,2,2002-09-30,-1,0,"den",-11
"5","Sun","October 6","W","","4-1",TRUE,"San Diego Chargers",26,9,20,417,300,117,1,16,314,235,79,3,2002-10-06,2,1,"den",17
"6","Sun","October 13","L","","4-2",TRUE,"Miami Dolphins",22,24,27,410,299,111,3,16,259,201,58,2,2002-10-13,-1,0,"den",-2
"7","Sun","October 20","W","OT","5-2",FALSE,"Kansas City Chiefs",37,34,22,507,366,141,1,24,305,143,162,0,2002-10-20,-1,1,"den",3
"8","Sun","October 27","W","","6-2",FALSE,"New England Patriots",24,16,23,351,215,136,2,16,179,110,69,0,2002-10-27,-2,1,"den",8
"10","Mon","November 11","L","","6-3",TRUE,"Oakland Raiders",10,34,27,342,265,77,1,20,374,347,27,0,2002-11-11,-1,0,"den",-24
"11","Sun","November 17","W","","7-3",FALSE,"Seattle Seahawks",31,9,22,401,199,202,1,13,204,153,51,3,2002-11-17,2,1,"den",22
"12","Sun","November 24","L","OT","7-4",TRUE,"Indianapolis Colts",20,23,15,285,172,113,2,26,344,216,128,3,2002-11-24,1,0,"den",-3
"13","Sun","December 1","L","OT","7-5",FALSE,"San Diego Chargers",27,30,20,417,261,156,3,25,434,214,220,0,2002-12-01,-3,0,"den",-3
"14","Sun","December 8","L","","7-6",FALSE,"New York Jets",13,19,21,369,258,111,1,18,281,217,64,0,2002-12-08,-1,0,"den",-6
"15","Sun","December 15","W","","8-6",TRUE,"Kansas City Chiefs",31,24,24,482,285,197,3,22,494,309,185,0,2002-12-15,-3,1,"den",7
"16","Sun","December 22","L","","8-7",FALSE,"Oakland Raiders",16,28,21,324,243,81,3,20,322,186,136,2,2002-12-22,-1,0,"den",-12
"17","Sun","December 29","W","","9-7",TRUE,"Arizona Cardinals",37,7,24,450,191,259,0,18,207,123,84,2,2002-12-29,2,1,"den",30
"1","Sun","September 7","W","","1-0",FALSE,"Cincinnati Bengals",30,10,19,293,109,184,3,15,294,243,51,4,2003-09-07,1,1,"den",20
"2","Sun","September 14","W","","2-0",FALSE,"San Diego Chargers",37,13,24,382,185,197,0,19,303,182,121,1,2003-09-14,1,1,"den",24
"3","Mon","September 22","W","","3-0",TRUE,"Oakland Raiders",31,10,20,383,193,190,1,11,195,156,39,1,2003-09-22,0,1,"den",21
"4","Sun","September 28","W","","4-0",TRUE,"Detroit Lions",20,16,20,332,253,79,1,16,285,141,144,0,2003-09-28,-1,1,"den",4
"5","Sun","October 5","L","","4-1",FALSE,"Kansas City Chiefs",23,24,22,468,292,176,1,13,262,129,133,2,2003-10-05,1,0,"den",-1
"6","Sun","October 12","W","","5-1",TRUE,"Pittsburgh Steelers",17,14,15,242,165,77,3,17,215,130,85,1,2003-10-12,-2,1,"den",3
"7","Sun","October 19","L","","5-2",FALSE,"Minnesota Vikings",20,28,27,321,183,138,3,14,340,268,72,0,2003-10-19,-3,0,"den",-8
"8","Sun","October 26","L","","5-3",FALSE,"Baltimore Ravens",6,26,12,194,90,104,2,16,277,126,151,0,2003-10-26,-2,0,"den",-20
"9","Mon","November 3","L","","5-4",TRUE,"New England Patriots",26,30,18,277,163,114,1,17,419,350,69,2,2003-11-03,1,0,"den",-4
"11","Sun","November 16","W","","6-4",TRUE,"San Diego Chargers",37,8,26,448,247,201,3,5,96,56,40,4,2003-11-16,1,1,"den",29
"12","Sun","November 23","L","","6-5",TRUE,"Chicago Bears",10,19,18,365,165,200,0,19,217,111,106,0,2003-11-23,0,0,"den",-9
"13","Sun","November 30","W","","7-5",FALSE,"Oakland Raiders",22,8,20,287,94,193,1,12,262,142,120,3,2003-11-30,2,1,"den",14
"14","Sun","December 7","W","","8-5",TRUE,"Kansas City Chiefs",45,27,26,508,238,270,0,28,444,381,63,0,2003-12-07,0,1,"den",18
"15","Sun","December 14","W","OT","9-5",TRUE,"Cleveland Browns",23,20,28,417,252,165,1,12,275,173,102,1,2003-12-14,0,1,"den",3
"16","Sun","December 21","W","","10-5",FALSE,"Indianapolis Colts",31,17,26,465,238,227,1,11,183,136,47,0,2003-12-21,-1,1,"den",14
"17","Sun","December 28","L","","10-6",FALSE,"Green Bay Packers",3,31,13,216,102,114,3,16,366,104,262,1,2003-12-28,-2,0,"den",-28
"WildCard","Sun","January 4","L","","10-7",FALSE,"Indianapolis Colts",10,41,20,322,176,146,3,23,479,394,85,1,2004-01-04,-2,0,"den",-31
"1","Sun","September 12","W","","1-0",TRUE,"Kansas City Chiefs",34,24,24,413,221,192,3,15,318,151,167,1,2004-09-12,-2,1,"den",10
"2","Sun","September 19","L","","1-1",FALSE,"Jacksonville Jaguars",6,7,20,356,250,106,1,8,176,109,67,0,2004-09-19,-1,0,"den",-1
"3","Sun","September 26","W","","2-1",TRUE,"San Diego Chargers",23,13,18,328,291,37,1,16,214,129,85,1,2004-09-26,0,1,"den",10
"4","Sun","October 3","W","","3-1",FALSE,"Tampa Bay Buccaneers",16,13,19,249,138,111,0,12,269,159,110,1,2004-10-03,1,1,"den",3
"5","Sun","October 10","W","","4-1",TRUE,"Carolina Panthers",20,17,23,434,224,210,2,12,227,163,64,0,2004-10-10,-2,1,"den",3
"6","Sun","October 17","W","","5-1",FALSE,"Oakland Raiders",31,3,25,444,190,254,1,9,145,114,31,2,2004-10-17,1,1,"den",28
"7","Mon","October 25","L","","5-2",FALSE,"Cincinnati Bengals",10,23,22,318,195,123,3,13,321,188,133,1,2004-10-25,-2,0,"den",-13
"8","Sun","October 31","L","","5-3",TRUE,"Atlanta Falcons",28,41,27,567,499,68,3,22,467,272,195,1,2004-10-31,-2,0,"den",-13
"9","Sun","November 7","W","","6-3",TRUE,"Houston Texans",31,13,21,364,225,139,0,22,331,228,103,0,2004-11-07,0,1,"den",18
"11","Sun","November 21","W","","7-3",FALSE,"New Orleans Saints",34,13,18,389,224,165,0,20,411,362,49,4,2004-11-21,4,1,"den",21
"12","Sun","November 28","L","","7-4",TRUE,"Oakland Raiders",24,25,16,367,245,122,3,19,395,334,61,3,2004-11-28,0,0,"den",-1
"13","Sun","December 5","L","","7-5",FALSE,"San Diego Chargers",17,20,21,337,263,74,4,14,208,86,122,2,2004-12-05,-2,0,"den",-3
"14","Sun","December 12","W","","8-5",TRUE,"Miami Dolphins",20,17,24,415,219,196,3,13,214,144,70,1,2004-12-12,-2,1,"den",3
"15","Sun","December 19","L","","8-6",FALSE,"Kansas City Chiefs",17,45,24,402,273,129,3,22,410,248,162,0,2004-12-19,-3,0,"den",-28
"16","Sat","December 25","W","","9-6",FALSE,"Tennessee Titans",37,16,26,496,303,193,2,10,153,94,59,2,2004-12-25,0,1,"den",21
"17","Sun","January 2","W","","10-6",TRUE,"Indianapolis Colts",33,14,23,453,239,214,0,8,200,166,34,1,2005-01-02,1,1,"den",19
"WildCard","Sun","January 9","L","","10-7",FALSE,"Indianapolis Colts",24,49,18,338,260,78,1,27,530,454,76,1,2005-01-09,0,0,"den",-25
"1","Sun","September 11","L","","0-1",FALSE,"Miami Dolphins",10,34,19,312,242,70,3,21,426,275,151,3,2005-09-11,0,0,"den",-24
"2","Sun","September 18","W","","1-1",TRUE,"San Diego Chargers",20,17,21,331,233,98,2,15,213,134,79,2,2005-09-18,0,1,"den",3
"3","Mon","September 26","W","","2-1",TRUE,"Kansas City Chiefs",30,10,24,358,137,221,0,18,285,211,74,1,2005-09-26,1,1,"den",20
"4","Sun","October 2","W","","3-1",FALSE,"Jacksonville Jaguars",20,7,24,306,118,188,0,13,241,229,12,4,2005-10-02,4,1,"den",13
"5","Sun","October 9","W","","4-1",TRUE,"Washington Redskins",21,19,11,257,92,165,0,28,447,322,125,1,2005-10-09,1,1,"den",2
"6","Sun","October 16","W","","5-1",TRUE,"New England Patriots",28,20,20,432,254,178,0,22,388,299,89,0,2005-10-16,0,1,"den",8
"7","Sun","October 23","L","","5-2",FALSE,"New York Giants",23,24,20,385,194,191,1,22,311,214,97,2,2005-10-23,1,0,"den",-1
"8","Sun","October 30","W","","6-2",TRUE,"Philadelphia Eagles",49,21,28,564,309,255,0,12,351,272,79,2,2005-10-30,2,1,"den",28
"10","Sun","November 13","W","","7-2",FALSE,"Oakland Raiders",31,17,18,326,205,121,2,20,335,275,60,3,2005-11-13,1,1,"den",14
"11","Sun","November 20","W","","8-2",TRUE,"New York Jets",27,0,28,404,213,191,1,10,195,176,19,5,2005-11-20,4,1,"den",27
"12","Thu","November 24","W","OT","9-2",FALSE,"Dallas Cowboys",24,21,13,293,149,144,2,23,314,229,85,2,2005-11-24,0,1,"den",3
"13","Sun","December 4","L","","9-3",FALSE,"Kansas City Chiefs",27,31,19,388,257,131,2,24,421,253,168,3,2005-12-04,1,0,"den",-4
"14","Sun","December 11","W","","10-3",TRUE,"Baltimore Ravens",12,10,17,318,222,96,1,20,323,251,72,4,2005-12-11,3,1,"den",2
"15","Sat","December 17","W","","11-3",FALSE,"Buffalo Bills",28,17,27,437,259,178,1,17,272,197,75,0,2005-12-17,-1,1,"den",11
"16","Sat","December 24","W","","12-3",TRUE,"Oakland Raiders",22,3,24,414,259,155,1,15,248,161,87,2,2005-12-24,1,1,"den",19
"17","Sat","December 31","W","","13-3",FALSE,"San Diego Chargers",23,7,17,241,84,157,0,15,236,145,91,2,2005-12-31,2,1,"den",16
"Division","Sat","January 14","W","","14-3",TRUE,"New England Patriots",27,13,16,286,190,96,1,15,420,341,79,5,2006-01-14,4,1,"den",14
"ConfChamp","Sun","January 22","L","","14-4",TRUE,"Pittsburgh Steelers",17,34,16,308,211,97,4,20,358,268,90,0,2006-01-22,-4,0,"den",-17
"1","Sun","September 10","L","","0-1",FALSE,"St. Louis Rams",10,18,17,259,98,161,5,16,320,195,125,0,2006-09-10,-5,0,"den",-8
"2","Sun","September 17","W","OT","1-1",TRUE,"Kansas City Chiefs",9,6,18,318,173,145,1,16,276,131,145,2,2006-09-17,1,1,"den",3
"3","Sun","September 24","W","","2-1",FALSE,"New England Patriots",17,7,19,400,256,144,0,22,370,320,50,0,2006-09-24,0,1,"den",10
"5","Mon","October 9","W","","3-1",TRUE,"Baltimore Ravens",13,3,13,222,106,116,2,16,257,154,103,3,2006-10-09,1,1,"den",10
"6","Sun","October 15","W","","4-1",TRUE,"Oakland Raiders",13,3,15,235,91,144,1,14,244,159,85,2,2006-10-15,1,1,"den",10
"7","Sun","October 22","W","","5-1",FALSE,"Cleveland Browns",17,7,22,347,197,150,2,10,165,131,34,3,2006-10-22,1,1,"den",10
"8","Sun","October 29","L","","5-2",TRUE,"Indianapolis Colts",31,34,24,396,169,227,1,23,437,345,92,0,2006-10-29,-1,0,"den",-3
"9","Sun","November 5","W","","6-2",FALSE,"Pittsburgh Steelers",31,20,13,336,221,115,0,27,499,403,96,6,2006-11-05,6,1,"den",11
"10","Sun","November 12","W","","7-2",FALSE,"Oakland Raiders",17,13,13,264,201,63,3,13,244,198,46,2,2006-11-12,-1,1,"den",4
"11","Sun","November 19","L","","7-3",TRUE,"San Diego Chargers",27,35,20,326,168,158,1,21,342,217,125,2,2006-11-19,1,0,"den",-8
"12","Thu","November 23","L","","7-4",FALSE,"Kansas City Chiefs",10,19,16,244,206,38,1,22,382,159,223,1,2006-11-23,0,0,"den",-9
"13","Sun","December 3","L","","7-5",TRUE,"Seattle Seahawks",20,23,14,302,121,181,5,12,270,162,108,1,2006-12-03,-4,0,"den",-3
"14","Sun","December 10","L","","7-6",FALSE,"San Diego Chargers",20,48,19,328,166,162,1,22,419,276,143,1,2006-12-10,0,0,"den",-28
"15","Sun","December 17","W","","8-6",FALSE,"Arizona Cardinals",37,20,26,362,256,106,2,17,295,195,100,2,2006-12-17,0,1,"den",17
"16","Sun","December 24","W","","9-6",TRUE,"Cincinnati Bengals",24,23,17,287,160,127,2,23,343,194,149,4,2006-12-24,2,1,"den",1
"17","Sun","December 31","L","OT","9-7",TRUE,"San Francisco 49ers",23,26,19,325,210,115,3,17,357,168,189,1,2006-12-31,-2,0,"den",-3
"1","Sun","September 9","W","","1-0",FALSE,"Buffalo Bills",15,14,23,470,299,171,1,13,184,72,112,1,2007-09-09,0,1,"den",1
"2","Sun","September 16","W","OT","2-0",TRUE,"Oakland Raiders",23,20,26,441,260,181,2,11,253,53,200,3,2007-09-16,1,1,"den",3
"3","Sun","September 23","L","","2-1",TRUE,"Jacksonville Jaguars",14,23,11,265,218,47,3,21,326,140,186,2,2007-09-23,-1,0,"den",-9
"4","Sun","September 30","L","","2-2",FALSE,"Indianapolis Colts",20,38,22,354,131,223,2,30,419,193,226,0,2007-09-30,-2,0,"den",-18
"5","Sun","October 7","L","","2-3",TRUE,"San Diego Chargers",3,41,17,296,224,72,3,20,484,270,214,0,2007-10-07,-3,0,"den",-38
"7","Sun","October 21","W","","3-3",TRUE,"Pittsburgh Steelers",31,28,21,324,234,90,2,24,379,260,119,3,2007-10-21,1,1,"den",3
"8","Mon","October 29","L","OT","3-4",TRUE,"Green Bay Packers",13,19,24,332,244,88,1,20,430,325,105,0,2007-10-29,-1,0,"den",-6
"9","Sun","November 4","L","","3-5",FALSE,"Detroit Lions",7,44,16,303,256,47,4,20,376,246,130,1,2007-11-04,-3,0,"den",-37
"10","Sun","November 11","W","","4-5",FALSE,"Kansas City Chiefs",27,11,18,327,186,141,1,19,284,217,67,4,2007-11-11,3,1,"den",16
"11","Mon","November 19","W","","5-5",TRUE,"Tennessee Titans",34,20,15,359,193,166,1,28,423,290,133,3,2007-11-19,2,1,"den",14
"12","Sun","November 25","L","OT","5-6",FALSE,"Chicago Bears",34,37,22,430,292,138,2,18,293,171,122,4,2007-11-25,2,0,"den",-3
"13","Sun","December 2","L","","5-7",FALSE,"Oakland Raiders",20,34,14,292,206,86,4,20,372,197,175,1,2007-12-02,-3,0,"den",-14
"14","Sun","December 9","W","","6-7",TRUE,"Kansas City Chiefs",41,7,23,453,238,215,0,7,129,113,16,3,2007-12-09,3,1,"den",34
"15","Thu","December 13","L","","6-8",FALSE,"Houston Texans",13,31,20,308,236,72,0,21,358,200,158,1,2007-12-13,1,0,"den",-18
"16","Mon","December 24","L","","6-9",FALSE,"San Diego Chargers",3,23,12,225,133,92,3,18,334,187,147,1,2007-12-24,-2,0,"den",-20
"17","Sun","December 30","W","OT","7-9",TRUE,"Minnesota Vikings",22,19,21,362,234,128,0,16,332,160,172,3,2007-12-30,3,1,"den",3
"1","Mon","September 8","W","","1-0",FALSE,"Oakland Raiders",41,14,24,441,300,141,0,15,307,157,150,1,2008-09-08,1,1,"den",27
"2","Sun","September 14","W","","2-0",TRUE,"San Diego Chargers",39,38,34,486,341,145,1,19,456,376,80,1,2008-09-14,0,1,"den",1
"3","Sun","September 21","W","","3-0",TRUE,"New Orleans Saints",34,32,20,369,264,105,2,27,502,414,88,1,2008-09-21,-1,1,"den",2
"4","Sun","September 28","L","","3-1",FALSE,"Kansas City Chiefs",19,33,22,446,352,94,4,17,370,157,213,1,2008-09-28,-3,0,"den",-14
"5","Sun","October 5","W","","4-1",TRUE,"Tampa Bay Buccaneers",16,13,17,333,227,106,1,17,307,168,139,1,2008-10-05,0,1,"den",3
"6","Sun","October 12","L","","4-2",TRUE,"Jacksonville Jaguars",17,24,19,323,192,131,3,26,416,261,155,2,2008-10-12,-1,0,"den",-7
"7","Mon","October 20","L","","4-3",FALSE,"New England Patriots",7,41,19,275,169,106,5,25,404,147,257,0,2008-10-20,-5,0,"den",-34
"9","Sun","November 2","L","","4-4",TRUE,"Miami Dolphins",17,26,14,319,305,14,3,21,341,266,75,1,2008-11-02,-2,0,"den",-9
"10","Thu","November 6","W","","5-4",FALSE,"Cleveland Browns",34,30,26,564,441,123,1,20,399,239,160,1,2008-11-06,0,1,"den",4
"11","Sun","November 16","W","","6-4",FALSE,"Atlanta Falcons",24,20,19,332,208,124,0,20,364,250,114,1,2008-11-16,1,1,"den",4
"12","Sun","November 23","L","","6-5",TRUE,"Oakland Raiders",10,31,23,319,204,115,2,18,318,160,158,0,2008-11-23,-2,0,"den",-21
"13","Sun","November 30","W","","7-5",FALSE,"New York Jets",34,17,23,484,357,127,1,22,383,241,142,2,2008-11-30,1,1,"den",17
"14","Sun","December 7","W","","8-5",TRUE,"Kansas City Chiefs",24,17,27,425,286,139,1,14,260,177,83,0,2008-12-07,-1,1,"den",7
"15","Sun","December 14","L","","8-6",FALSE,"Carolina Panthers",10,30,15,279,158,121,2,18,400,253,147,1,2008-12-14,-1,0,"den",-20
"16","Sun","December 21","L","","8-7",TRUE,"Buffalo Bills",23,30,27,532,351,181,2,20,275,188,87,0,2008-12-21,-2,0,"den",-7
"17","Sun","December 28","L","","8-8",FALSE,"San Diego Chargers",21,52,25,406,316,90,2,28,491,202,289,0,2008-12-28,-2,0,"den",-31
"1","Sun","September 13","W","","1-0",FALSE,"Cincinnati Bengals",12,7,10,302,227,75,0,16,307,221,86,2,2009-09-13,2,1,"den",5
"2","Sun","September 20","W","","2-0",TRUE,"Cleveland Browns",27,6,25,449,263,186,1,11,200,146,54,3,2009-09-20,2,1,"den",21
"3","Sun","September 27","W","","3-0",FALSE,"Oakland Raiders",23,3,21,372,157,215,1,9,137,42,95,3,2009-09-27,2,1,"den",20
"4","Sun","October 4","W","","4-0",TRUE,"Dallas Cowboys",17,10,18,337,221,116,1,20,315,241,74,2,2009-10-04,1,1,"den",7
"5","Sun","October 11","W","OT","5-0",TRUE,"New England Patriots",20,17,27,424,321,103,2,18,305,209,96,1,2009-10-11,-1,1,"den",3
"6","Mon","October 19","W","","6-0",FALSE,"San Diego Chargers",34,23,19,328,227,101,0,20,311,238,73,1,2009-10-19,1,1,"den",11
"8","Sun","November 1","L","","6-1",FALSE,"Baltimore Ravens",7,30,17,200,134,66,1,16,292,167,125,0,2009-11-01,-1,0,"den",-23
"9","Mon","November 9","L","","6-2",TRUE,"Pittsburgh Steelers",10,28,12,242,215,27,3,21,375,202,173,2,2009-11-09,-1,0,"den",-18
"10","Sun","November 15","L","","6-3",FALSE,"Washington Redskins",17,27,14,305,185,120,2,22,388,214,174,0,2009-11-15,-2,0,"den",-10
"11","Sun","November 22","L","","6-4",TRUE,"San Diego Chargers",3,32,14,271,156,115,3,21,348,145,203,0,2009-11-22,-3,0,"den",-29
"12","Thu","November 26","W","","7-4",TRUE,"New York Giants",26,6,23,373,235,138,1,15,267,210,57,3,2009-11-26,2,1,"den",20
"13","Sun","December 6","W","","8-4",FALSE,"Kansas City Chiefs",44,13,24,413,168,245,3,14,222,128,94,3,2009-12-06,0,1,"den",31
"14","Sun","December 13","L","","8-5",FALSE,"Indianapolis Colts",16,28,20,357,262,95,1,21,312,220,92,3,2009-12-13,2,0,"den",-12
"15","Sun","December 20","L","","8-6",TRUE,"Oakland Raiders",19,20,19,337,257,80,0,22,343,102,241,2,2009-12-20,2,0,"den",-1
"16","Sun","December 27","L","","8-7",FALSE,"Philadelphia Eagles",27,30,13,241,171,70,1,22,394,289,105,3,2009-12-27,2,0,"den",-3
"17","Sun","January 3","L","","8-8",TRUE,"Kansas City Chiefs",24,44,30,512,428,84,3,22,524,207,317,2,2010-01-03,-1,0,"den",-20
"1","Sun","September 12","L","","0-1",FALSE,"Jacksonville Jaguars",17,24,21,363,274,89,2,18,299,165,134,0,2010-09-12,-2,0,"den",-7
"2","Sun","September 19","W","","1-1",TRUE,"Seattle Seahawks",31,14,23,369,304,65,0,17,339,230,109,4,2010-09-19,4,1,"den",17
"3","Sun","September 26","L","","1-2",TRUE,"Indianapolis Colts",13,27,23,519,472,47,2,18,365,325,40,0,2010-09-26,-2,0,"den",-14
"4","Sun","October 3","W","","2-2",FALSE,"Tennessee Titans",26,20,22,327,308,19,1,13,288,167,121,2,2010-10-03,1,1,"den",6
"5","Sun","October 10","L","","2-3",FALSE,"Baltimore Ravens",17,31,16,346,307,39,1,28,415,182,233,0,2010-10-10,-1,0,"den",-14
"6","Sun","October 17","L","","2-4",TRUE,"New York Jets",20,24,21,346,201,145,2,17,319,190,129,3,2010-10-17,1,0,"den",-4
"7","Sun","October 24","L","","2-5",TRUE,"Oakland Raiders",14,59,11,240,165,75,3,29,508,180,328,0,2010-10-24,-3,0,"den",-45
"8","Sun","October 31","L","","2-6",FALSE,"San Francisco 49ers",16,24,22,398,339,59,2,16,339,196,143,0,2010-10-31,-2,0,"den",-8
"10","Sun","November 14","W","","3-6",TRUE,"Kansas City Chiefs",49,29,25,452,299,153,0,30,484,433,51,1,2010-11-14,1,1,"den",20
"11","Mon","November 22","L","","3-7",FALSE,"San Diego Chargers",14,35,16,235,172,63,1,21,400,253,147,1,2010-11-22,0,0,"den",-21
"12","Sun","November 28","L","","3-8",TRUE,"St. Louis Rams",33,36,24,449,330,119,2,24,431,308,123,0,2010-11-28,-2,0,"den",-3
"13","Sun","December 5","L","","3-9",FALSE,"Kansas City Chiefs",6,10,13,247,86,161,1,21,359,174,185,1,2010-12-05,0,0,"den",-4
"14","Sun","December 12","L","","3-10",FALSE,"Arizona Cardinals",13,43,20,288,156,132,6,21,357,146,211,1,2010-12-12,-5,0,"den",-30
"15","Sun","December 19","L","","3-11",FALSE,"Oakland Raiders",23,39,9,235,129,106,1,20,502,238,264,3,2010-12-19,2,0,"den",-16
"16","Sun","December 26","W","","4-11",TRUE,"Houston Texans",24,23,25,431,305,126,1,21,401,310,91,1,2010-12-26,0,1,"den",1
"17","Sun","January 2","L","","4-12",TRUE,"San Diego Chargers",28,33,18,337,191,146,2,20,447,283,164,1,2011-01-02,-1,0,"den",-5
"1","Mon","September 12","L","","0-1",TRUE,"Oakland Raiders",20,23,25,310,272,38,3,20,289,99,190,1,2011-09-12,-2,0,"den",-3
"2","Sun","September 18","W","","1-1",TRUE,"Cincinnati Bengals",24,22,19,318,187,131,2,18,382,310,72,0,2011-09-18,-2,1,"den",2
"3","Sun","September 25","L","","1-2",FALSE,"Tennessee Titans",14,17,19,231,172,59,2,17,333,295,38,2,2011-09-25,0,0,"den",-3
"4","Sun","October 2","L","","1-3",FALSE,"Green Bay Packers",23,49,18,384,265,119,4,26,507,396,111,2,2011-10-02,-2,0,"den",-26
"5","Sun","October 9","L","","1-4",TRUE,"San Diego Chargers",24,29,13,275,113,162,1,25,418,212,206,2,2011-10-09,1,0,"den",-5
"7","Sun","October 23","W","OT","2-4",FALSE,"Miami Dolphins",18,15,18,308,131,177,1,15,267,173,94,1,2011-10-23,0,1,"den",3
"8","Sun","October 30","L","","2-5",TRUE,"Detroit Lions",10,45,19,312,117,195,3,21,376,263,113,0,2011-10-30,-3,0,"den",-35
"9","Sun","November 6","W","","3-5",FALSE,"Oakland Raiders",38,24,20,412,113,299,0,21,416,316,100,3,2011-11-06,3,1,"den",14
"10","Sun","November 13","W","","4-5",FALSE,"Kansas City Chiefs",17,10,16,313,69,244,0,17,258,124,134,0,2011-11-13,0,1,"den",7
"11","Thu","November 17","W","","5-5",TRUE,"New York Jets",17,13,11,229,104,125,1,22,318,235,83,2,2011-11-17,1,1,"den",4
"12","Sun","November 27","W","OT","6-5",FALSE,"San Diego Chargers",16,13,18,349,141,208,0,20,344,159,185,0,2011-11-27,0,1,"den",3
"13","Sun","December 4","W","","7-5",FALSE,"Minnesota Vikings",35,32,13,336,186,150,2,27,489,360,129,3,2011-12-04,1,1,"den",3
"14","Sun","December 11","W","OT","8-5",TRUE,"Chicago Bears",13,10,22,345,221,124,2,12,245,86,159,1,2011-12-11,-1,1,"den",3
"15","Sun","December 18","L","","8-6",TRUE,"New England Patriots",23,41,25,393,141,252,3,26,451,310,141,0,2011-12-18,-3,0,"den",-18
"16","Sat","December 24","L","","8-7",FALSE,"Buffalo Bills",14,40,18,285,152,133,3,14,351,191,160,0,2011-12-24,-3,0,"den",-26
"17","Sun","January 1","L","","8-8",TRUE,"Kansas City Chiefs",3,7,16,266,50,216,2,14,281,175,106,1,2012-01-01,-1,0,"den",-4
"WildCard","Sun","January 8","W","OT","9-8",TRUE,"Pittsburgh Steelers",29,23,18,447,316,131,1,21,400,244,156,1,2012-01-08,0,1,"den",6
"Division","Sat","January 14","L","","9-9",FALSE,"New England Patriots",10,45,15,252,108,144,1,31,509,363,146,2,2012-01-14,1,0,"den",-35
"1","Sun","September 8","W","","1-0",FALSE,"Buffalo Bills",14,9,17,308,208,100,2,19,455,371,84,3,1985-09-08,1,1,"sdg",5
"2","Sun","September 15","L","","1-1",TRUE,"Seattle Seahawks",35,49,32,557,494,63,4,30,489,293,196,0,1985-09-15,-4,0,"sdg",-14
"3","Sun","September 22","W","","2-1",FALSE,"Cincinnati Bengals",44,41,26,517,344,173,3,32,448,296,152,5,1985-09-22,2,1,"sdg",3
"4","Sun","September 29","L","","2-2",TRUE,"Cleveland Browns",7,21,16,275,219,56,2,23,440,165,275,1,1985-09-29,-1,0,"sdg",-14
"5","Sun","October 6","L","","2-3",FALSE,"Seattle Seahawks",21,26,20,345,305,40,5,17,253,145,108,1,1985-10-06,-4,0,"sdg",-5
"6","Sun","October 13","W","","3-3",TRUE,"Kansas City Chiefs",31,20,22,350,287,63,3,14,325,277,48,3,1985-10-13,0,1,"sdg",11
"7","Sun","October 20","L","","3-4",FALSE,"Minnesota Vikings",17,21,23,295,163,132,4,27,360,298,62,3,1985-10-20,-1,0,"sdg",-4
"8","Mon","October 28","L","","3-5",FALSE,"Los Angeles Raiders",21,34,22,324,274,50,1,22,408,252,156,3,1985-10-28,2,0,"sdg",-13
"9","Sun","November 3","W","","4-5",TRUE,"Denver Broncos",30,10,24,430,285,145,3,17,295,231,64,3,1985-11-03,0,1,"sdg",20
"10","Sun","November 10","W","OT","5-5",TRUE,"Los Angeles Raiders",40,34,29,593,426,167,1,26,454,289,165,3,1985-11-10,2,1,"sdg",6
"11","Sun","November 17","L","OT","5-6",FALSE,"Denver Broncos",24,30,22,340,245,95,4,21,331,240,91,2,1985-11-17,-2,0,"sdg",-6
"12","Sun","November 24","L","","5-7",FALSE,"Houston Oilers",35,37,29,439,323,116,5,26,415,278,137,2,1985-11-24,-3,0,"sdg",-2
"13","Sun","December 1","W","","6-7",TRUE,"Buffalo Bills",40,7,21,365,269,96,3,21,347,238,109,5,1985-12-01,2,1,"sdg",33
"14","Sun","December 8","W","","7-7",TRUE,"Pittsburgh Steelers",54,44,23,448,364,84,3,28,427,275,152,4,1985-12-08,1,1,"sdg",10
"15","Sun","December 15","W","","8-7",TRUE,"Philadelphia Eagles",20,14,22,417,323,94,3,22,382,307,75,3,1985-12-15,0,1,"sdg",6
"16","Sun","December 22","L","","8-8",FALSE,"Kansas City Chiefs",34,38,32,532,341,191,3,19,436,338,98,1,1985-12-22,-2,0,"sdg",-4
"1","Sun","September 7","W","","1-0",TRUE,"Miami Dolphins",50,28,31,500,276,224,0,20,339,294,45,4,1986-09-07,4,1,"sdg",22
"2","Sun","September 14","L","","1-1",FALSE,"New York Giants",7,20,18,262,221,41,7,25,391,257,134,1,1986-09-14,-6,0,"sdg",-13
"3","Sun","September 21","L","","1-2",TRUE,"Washington Redskins",27,30,26,351,204,147,3,19,425,333,92,1,1986-09-21,-2,0,"sdg",-3
"4","Sun","September 28","L","","1-3",FALSE,"Los Angeles Raiders",13,17,16,256,200,56,4,21,377,276,101,5,1986-09-28,1,0,"sdg",-4
"5","Mon","October 6","L","","1-4",FALSE,"Seattle Seahawks",7,33,15,271,222,49,5,29,512,294,218,3,1986-10-06,-2,0,"sdg",-26
"6","Sun","October 12","L","","1-5",TRUE,"Denver Broncos",14,31,19,358,316,42,2,25,403,247,156,1,1986-10-12,-1,0,"sdg",-17
"7","Sun","October 19","L","","1-6",FALSE,"Kansas City Chiefs",41,42,35,512,381,131,5,13,222,158,64,1,1986-10-19,-4,0,"sdg",-1
"8","Sun","October 26","L","","1-7",FALSE,"Philadelphia Eagles",7,23,14,259,187,72,3,15,251,124,127,2,1986-10-26,-1,0,"sdg",-16
"9","Sun","November 2","L","","1-8",TRUE,"Kansas City Chiefs",23,24,14,225,34,191,5,16,282,233,49,3,1986-11-02,-2,0,"sdg",-1
"10","Sun","November 9","W","","2-8",FALSE,"Denver Broncos",9,3,14,225,147,78,2,12,245,184,61,5,1986-11-09,3,1,"sdg",6
"11","Sun","November 16","L","","2-9",TRUE,"Dallas Cowboys",21,24,19,307,242,65,2,20,254,153,101,1,1986-11-16,-1,0,"sdg",-3
"12","Thu","November 20","L","OT","2-10",TRUE,"Los Angeles Raiders",31,37,30,392,263,129,4,25,466,327,139,2,1986-11-20,-2,0,"sdg",-6
"13","Sun","November 30","W","","3-10",FALSE,"Indianapolis Colts",17,3,21,391,290,101,2,11,177,122,55,3,1986-11-30,1,1,"sdg",14
"14","Sun","December 7","W","","4-10",TRUE,"Houston Oilers",27,0,23,409,285,124,0,9,134,55,79,3,1986-12-07,3,1,"sdg",27
"15","Sun","December 14","L","","4-11",TRUE,"Seattle Seahawks",24,34,22,305,220,85,1,24,426,286,140,0,1986-12-14,-1,0,"sdg",-10
"16","Sun","December 21","L","","4-12",FALSE,"Cleveland Browns",17,47,17,333,292,41,4,24,462,345,117,2,1986-12-21,-2,0,"sdg",-30
"1","Sun","September 13","L","","0-1",FALSE,"Kansas City Chiefs",13,20,19,342,258,84,4,15,232,58,174,1,1987-09-13,-3,0,"sdg",-7
"2","Sun","September 20","W","","1-1",TRUE,"St. Louis Cardinals",28,24,17,282,152,130,2,24,471,412,59,2,1987-09-20,0,1,"sdg",4
"3","Sun","October 4","W","","2-1",FALSE,"Cincinnati Bengals",10,9,15,261,169,92,2,11,206,-13,219,0,1987-10-04,-2,1,"sdg",1
"4","Sun","October 11","W","","3-1",FALSE,"Tampa Bay Buccaneers",17,13,22,385,260,125,3,7,201,70,131,1,1987-10-11,-2,1,"sdg",4
"5","Sun","October 18","W","","4-1",FALSE,"Los Angeles Raiders",23,17,14,244,147,97,0,19,314,176,138,3,1987-10-18,3,1,"sdg",6
"6","Sun","October 25","W","","5-1",TRUE,"Kansas City Chiefs",42,21,30,391,277,114,2,21,371,305,66,5,1987-10-25,3,1,"sdg",21
"7","Sun","November 1","W","OT","6-1",TRUE,"Cleveland Browns",27,24,22,414,286,128,2,19,339,267,72,3,1987-11-01,1,1,"sdg",3
"8","Sun","November 8","W","","7-1",FALSE,"Indianapolis Colts",16,13,15,296,214,82,4,18,303,112,191,3,1987-11-08,-1,1,"sdg",3
"9","Sun","November 15","W","","8-1",TRUE,"Los Angeles Raiders",16,14,16,248,134,114,1,12,365,215,150,2,1987-11-15,1,1,"sdg",2
"10","Sun","November 22","L","","8-2",FALSE,"Seattle Seahawks",3,34,6,156,139,17,4,34,496,219,277,1,1987-11-22,-3,0,"sdg",-31
"11","Sun","November 29","L","","8-3",TRUE,"Denver Broncos",17,31,18,378,312,66,2,31,522,347,175,1,1987-11-29,-1,0,"sdg",-14
"12","Sun","December 6","L","","8-4",FALSE,"Houston Oilers",18,33,19,332,289,43,4,21,324,184,140,1,1987-12-06,-3,0,"sdg",-15
"13","Sun","December 13","L","","8-5",TRUE,"Pittsburgh Steelers",16,20,27,435,321,114,5,14,254,150,104,1,1987-12-13,-4,0,"sdg",-4
"14","Sun","December 20","L","","8-6",TRUE,"Indianapolis Colts",7,20,17,273,214,59,3,19,340,194,146,0,1987-12-20,-3,0,"sdg",-13
"15","Sun","December 27","L","","8-7",FALSE,"Denver Broncos",0,24,7,151,108,43,5,15,215,86,129,4,1987-12-27,-1,0,"sdg",-24
"1","Sun","September 4","L","","0-1",FALSE,"Los Angeles Raiders",13,24,15,263,152,111,1,18,277,183,94,1,1988-09-04,0,0,"sdg",-11
"2","Sun","September 11","L","","0-2",FALSE,"Denver Broncos",3,34,13,244,111,133,2,24,443,259,184,0,1988-09-11,-2,0,"sdg",-31
"3","Sun","September 18","W","","1-2",TRUE,"Seattle Seahawks",17,6,14,237,78,159,1,20,299,194,105,4,1988-09-18,3,1,"sdg",11
"4","Sun","September 25","W","","2-2",FALSE,"Kansas City Chiefs",24,23,19,303,138,165,1,20,331,237,94,2,1988-09-25,1,1,"sdg",1
"5","Sun","October 2","L","","2-3",TRUE,"Denver Broncos",0,12,11,190,170,20,2,22,291,162,129,1,1988-10-02,-1,0,"sdg",-12
"6","Sun","October 9","L","","2-4",TRUE,"New Orleans Saints",17,23,12,206,113,93,2,24,365,231,134,1,1988-10-09,-1,0,"sdg",-6
"7","Sun","October 16","L","","2-5",FALSE,"Miami Dolphins",28,31,23,396,283,113,4,25,375,329,46,1,1988-10-16,-3,0,"sdg",-3
"8","Sun","October 23","L","","2-6",TRUE,"Indianapolis Colts",0,16,14,239,121,118,1,28,453,255,198,3,1988-10-23,2,0,"sdg",-16
"9","Sun","October 30","L","","2-7",FALSE,"Seattle Seahawks",14,17,18,299,169,130,3,16,235,109,126,0,1988-10-30,-3,0,"sdg",-3
"10","Sun","November 6","L","","2-8",TRUE,"Los Angeles Raiders",3,13,12,216,153,63,3,18,306,170,136,2,1988-11-06,-1,0,"sdg",-10
"11","Sun","November 13","W","","3-8",FALSE,"Atlanta Falcons",10,7,15,355,170,185,2,13,245,188,57,2,1988-11-13,0,1,"sdg",3
"12","Sun","November 20","W","","4-8",FALSE,"Los Angeles Rams",38,24,17,297,196,101,1,20,363,212,151,2,1988-11-20,1,1,"sdg",14
"13","Sun","November 27","L","","4-9",TRUE,"San Francisco 49ers",10,48,21,312,176,136,3,24,475,272,203,0,1988-11-27,-3,0,"sdg",-38
"14","Sun","December 4","L","","4-10",FALSE,"Cincinnati Bengals",10,27,14,211,123,88,4,21,352,145,207,2,1988-12-04,-2,0,"sdg",-17
"15","Sun","December 11","W","","5-10",TRUE,"Pittsburgh Steelers",20,14,17,324,144,180,0,20,302,172,130,3,1988-12-11,3,1,"sdg",6
"16","Sun","December 18","W","","6-10",TRUE,"Kansas City Chiefs",24,13,20,337,91,246,2,22,306,167,139,2,1988-12-18,0,1,"sdg",11
"1","Sun","September 10","L","","0-1",FALSE,"Los Angeles Raiders",14,40,16,305,134,171,1,23,418,258,160,1,1989-09-10,0,0,"sdg",-26
"2","Sun","September 17","L","","0-2",TRUE,"Houston Oilers",27,34,24,413,372,41,5,26,367,235,132,0,1989-09-17,-5,0,"sdg",-7
"3","Sun","September 24","W","","1-2",TRUE,"Kansas City Chiefs",21,6,18,296,96,200,0,13,272,154,118,5,1989-09-24,5,1,"sdg",15
"4","Sun","October 1","W","","2-2",FALSE,"Phoenix Cardinals",24,13,13,268,165,103,0,17,301,232,69,4,1989-10-01,4,1,"sdg",11
"5","Sun","October 8","L","","2-3",FALSE,"Denver Broncos",10,16,12,211,93,118,2,24,335,179,156,1,1989-10-08,-1,0,"sdg",-6
"6","Sun","October 15","L","","2-4",TRUE,"Seattle Seahawks",16,17,26,362,263,99,4,15,224,139,85,3,1989-10-15,-1,0,"sdg",-1
"7","Sun","October 22","L","","2-5",TRUE,"New York Giants",13,20,9,179,128,51,1,24,327,218,109,2,1989-10-22,1,0,"sdg",-7
"8","Sun","October 29","L","","2-6",FALSE,"Seattle Seahawks",7,10,11,195,103,92,1,23,339,269,70,2,1989-10-29,1,0,"sdg",-3
"9","Sun","November 5","W","","3-6",TRUE,"Philadelphia Eagles",20,17,17,358,254,104,3,24,373,195,178,3,1989-11-05,0,1,"sdg",3
"10","Sun","November 12","W","","4-6",TRUE,"Los Angeles Raiders",14,12,12,202,66,136,2,15,295,161,134,3,1989-11-12,1,1,"sdg",2
"11","Sun","November 19","L","","4-7",FALSE,"Pittsburgh Steelers",17,20,20,359,225,134,3,14,191,103,88,1,1989-11-19,-2,0,"sdg",-3
"12","Sun","November 26","L","","4-8",FALSE,"Indianapolis Colts",6,10,14,314,137,177,1,11,264,205,59,2,1989-11-26,1,0,"sdg",-4
"13","Sun","December 3","L","","4-9",TRUE,"New York Jets",17,20,14,258,187,71,2,19,249,68,181,4,1989-12-03,2,0,"sdg",-3
"14","Sun","December 10","L","","4-10",FALSE,"Washington Redskins",21,26,21,427,350,77,1,20,389,302,87,1,1989-12-10,0,0,"sdg",-5
"15","Sun","December 17","W","","5-10",FALSE,"Kansas City Chiefs",20,13,22,376,159,217,4,11,214,124,90,3,1989-12-17,-1,1,"sdg",7
"16","Sun","December 24","W","","6-10",TRUE,"Denver Broncos",19,16,18,387,305,82,6,16,206,109,97,3,1989-12-24,-3,1,"sdg",3
"1","Sun","September 9","L","","0-1",FALSE,"Dallas Cowboys",14,17,12,212,127,85,2,14,249,161,88,1,1990-09-09,-1,0,"sdg",-3
"2","Sun","September 16","L","","0-2",TRUE,"Cincinnati Bengals",16,21,17,417,278,139,3,18,302,223,79,3,1990-09-16,0,0,"sdg",-5
"3","Sun","September 23","W","","1-2",FALSE,"Cleveland Browns",24,14,16,266,129,137,2,14,262,218,44,4,1990-09-23,2,1,"sdg",10
"4","Sun","September 30","L","","1-3",TRUE,"Houston Oilers",7,17,14,298,167,131,2,29,421,329,92,1,1990-09-30,-1,0,"sdg",-10
"5","Sun","October 7","L","","1-4",FALSE,"Pittsburgh Steelers",14,36,14,188,96,92,3,25,374,191,183,1,1990-10-07,-2,0,"sdg",-22
"6","Sun","October 14","W","","2-4",FALSE,"New York Jets",39,3,22,412,188,224,3,9,148,53,95,2,1990-10-14,-1,1,"sdg",36
"7","Sun","October 21","L","","2-5",TRUE,"Los Angeles Raiders",9,24,16,289,150,139,0,17,289,173,116,1,1990-10-21,1,0,"sdg",-15
"8","Sun","October 28","W","","3-5",TRUE,"Tampa Bay Buccaneers",41,10,17,314,157,157,1,8,157,119,38,7,1990-10-28,6,1,"sdg",31
"9","Sun","November 4","W","","4-5",FALSE,"Seattle Seahawks",31,14,15,289,145,144,0,17,194,129,65,3,1990-11-04,3,1,"sdg",17
"10","Sun","November 11","W","","5-5",TRUE,"Denver Broncos",19,7,17,340,159,181,0,15,211,149,62,2,1990-11-11,2,1,"sdg",12
"11","Sun","November 18","L","","5-6",FALSE,"Kansas City Chiefs",10,27,21,286,187,99,5,16,297,165,132,0,1990-11-18,-5,0,"sdg",-17
"12","Sun","November 25","L","OT","5-7",TRUE,"Seattle Seahawks",10,13,16,304,140,164,5,13,233,175,58,2,1990-11-25,-3,0,"sdg",-3
"13","Sun","December 2","W","","6-7",TRUE,"New York Jets",38,17,20,409,220,189,1,21,352,207,145,3,1990-12-02,2,1,"sdg",21
"15","Sun","December 16","L","","6-8",FALSE,"Denver Broncos",10,20,24,390,298,92,2,16,320,233,87,0,1990-12-16,-2,0,"sdg",-10
"16","Sun","December 23","L","","6-9",TRUE,"Kansas City Chiefs",21,24,17,255,151,104,2,21,368,251,117,0,1990-12-23,-2,0,"sdg",-3
"17","Sun","December 30","L","","6-10",FALSE,"Los Angeles Raiders",12,17,14,271,91,180,1,15,248,134,114,0,1990-12-30,-1,0,"sdg",-5
"1","Sun","September 1","L","","0-1",FALSE,"Pittsburgh Steelers",20,26,20,281,186,95,2,16,390,266,124,2,1991-09-01,0,0,"sdg",-6
"2","Sun","September 8","L","","0-2",FALSE,"San Francisco 49ers",14,34,19,326,170,156,4,24,458,344,114,1,1991-09-08,-3,0,"sdg",-20
"3","Sun","September 15","L","","0-3",TRUE,"Atlanta Falcons",10,13,13,313,129,184,1,18,317,195,122,1,1991-09-15,0,0,"sdg",-3
"4","Sun","September 22","L","","0-4",FALSE,"Denver Broncos",19,27,17,297,126,171,2,18,360,216,144,2,1991-09-22,0,0,"sdg",-8
"5","Sun","September 29","L","","0-5",TRUE,"Kansas City Chiefs",13,14,17,311,155,156,0,12,182,96,86,1,1991-09-29,1,0,"sdg",-1
"6","Sun","October 6","W","","1-5",FALSE,"Los Angeles Raiders",21,13,17,258,100,158,0,16,277,178,99,3,1991-10-06,3,1,"sdg",8
"7","Sun","October 13","L","","1-6",FALSE,"Los Angeles Rams",24,30,17,387,298,89,1,21,284,204,80,0,1991-10-13,-1,0,"sdg",-6
"8","Sun","October 20","L","OT","1-7",TRUE,"Cleveland Browns",24,30,29,437,305,132,3,17,364,294,70,0,1991-10-20,-3,0,"sdg",-6
"9","Sun","October 27","L","","1-8",FALSE,"Seattle Seahawks",9,20,19,320,192,128,0,15,202,127,75,2,1991-10-27,2,0,"sdg",-11
"11","Sun","November 10","W","","2-8",TRUE,"Seattle Seahawks",17,14,16,315,213,102,0,18,387,350,37,3,1991-11-10,3,1,"sdg",3
"12","Sun","November 17","W","","3-8",TRUE,"New Orleans Saints",24,21,15,305,159,146,2,17,285,193,92,4,1991-11-17,2,1,"sdg",3
"13","Sun","November 24","L","","3-9",FALSE,"New York Jets",3,24,18,291,105,186,4,21,314,176,138,1,1991-11-24,-3,0,"sdg",-21
"14","Sun","December 1","L","","3-10",TRUE,"Los Angeles Raiders",7,9,12,199,124,75,3,14,283,122,161,3,1991-12-01,0,0,"sdg",-2
"15","Sun","December 8","L","OT","3-11",FALSE,"Kansas City Chiefs",17,20,23,366,208,158,2,21,349,245,104,2,1991-12-08,0,0,"sdg",-3
"16","Sun","December 15","W","","4-11",TRUE,"Miami Dolphins",38,30,20,368,170,198,0,23,348,273,75,2,1991-12-15,2,1,"sdg",8
"17","Sun","December 22","L","","4-12",TRUE,"Denver Broncos",14,17,13,221,107,114,4,21,311,166,145,1,1991-12-22,-3,0,"sdg",-3
"1","Sun","September 6","L","","0-1",TRUE,"Kansas City Chiefs",10,24,13,155,67,88,3,14,188,127,61,1,1992-09-06,-2,0,"sdg",-14
"2","Sun","September 13","L","","0-2",FALSE,"Denver Broncos",13,21,27,355,187,168,2,12,226,162,64,1,1992-09-13,-1,0,"sdg",-8
"3","Sun","September 20","L","","0-3",TRUE,"Pittsburgh Steelers",6,23,15,330,221,109,3,15,272,205,67,3,1992-09-20,0,0,"sdg",-17
"4","Sun","September 27","L","","0-4",FALSE,"Houston Oilers",0,27,15,262,210,52,3,21,303,197,106,1,1992-09-27,-2,0,"sdg",-27
"5","Sun","October 4","W","","1-4",TRUE,"Seattle Seahawks",17,6,17,302,195,107,0,11,180,70,110,3,1992-10-04,3,1,"sdg",11
"7","Sun","October 18","W","","2-4",FALSE,"Indianapolis Colts",34,14,26,392,180,212,3,22,330,293,37,5,1992-10-18,2,1,"sdg",20
"8","Sun","October 25","W","","3-4",TRUE,"Denver Broncos",24,21,20,441,340,101,3,18,351,260,91,3,1992-10-25,0,1,"sdg",3
"9","Sun","November 1","W","","4-4",TRUE,"Indianapolis Colts",26,0,26,398,247,151,3,8,99,69,30,2,1992-11-01,-1,1,"sdg",26
"10","Sun","November 8","L","","4-5",FALSE,"Kansas City Chiefs",14,16,17,295,238,57,4,11,211,104,107,0,1992-11-08,-4,0,"sdg",-2
"11","Sun","November 15","W","","5-5",FALSE,"Cleveland Browns",14,13,16,312,224,88,3,19,385,298,87,3,1992-11-15,0,1,"sdg",1
"12","Sun","November 22","W","","6-5",TRUE,"Tampa Bay Buccaneers",29,14,17,307,126,181,1,18,287,174,113,0,1992-11-22,-1,1,"sdg",15
"13","Sun","November 29","W","","7-5",TRUE,"Los Angeles Raiders",27,3,20,333,164,169,1,15,324,170,154,2,1992-11-29,1,1,"sdg",24
"14","Sun","December 6","W","","8-5",FALSE,"Phoenix Cardinals",27,21,14,296,267,29,2,20,323,227,96,5,1992-12-06,3,1,"sdg",6
"15","Sun","December 13","W","","9-5",TRUE,"Cincinnati Bengals",27,10,22,370,209,161,2,15,223,156,67,2,1992-12-13,0,1,"sdg",17
"16","Sun","December 20","W","","10-5",FALSE,"Los Angeles Raiders",36,14,19,332,228,104,0,14,167,118,49,3,1992-12-20,3,1,"sdg",22
"17","Sun","December 27","W","","11-5",FALSE,"Seattle Seahawks",31,14,18,341,243,98,0,17,358,202,156,2,1992-12-27,2,1,"sdg",17
"WildCard","Sat","January 2","W","","12-5",TRUE,"Kansas City Chiefs",17,0,18,342,150,192,1,17,251,190,61,3,1993-01-02,2,1,"sdg",17
"Division","Sun","January 10","L","","12-6",FALSE,"Miami Dolphins",0,31,10,202,132,70,5,18,324,167,157,1,1993-01-10,-4,0,"sdg",-31
"1","Sun","September 5","W","","1-0",TRUE,"Seattle Seahawks",18,12,19,269,109,160,2,15,230,141,89,2,1993-09-05,0,1,"sdg",6
"2","Sun","September 12","L","","1-1",FALSE,"Denver Broncos",17,34,26,390,322,68,2,17,342,284,58,2,1993-09-12,0,0,"sdg",-17
"3","Sun","September 19","W","","2-1",TRUE,"Houston Oilers",18,17,19,284,173,111,1,17,295,224,71,5,1993-09-19,4,1,"sdg",1
"5","Sun","October 3","L","","2-2",FALSE,"Seattle Seahawks",14,31,19,315,221,94,2,24,344,287,57,0,1993-10-03,-2,0,"sdg",-17
"6","Sun","October 10","L","","2-3",FALSE,"Pittsburgh Steelers",3,16,12,138,119,19,3,15,304,156,148,0,1993-10-10,-3,0,"sdg",-13
"7","Sun","October 17","L","","2-4",TRUE,"Kansas City Chiefs",14,17,18,269,190,79,1,20,347,264,83,1,1993-10-17,0,0,"sdg",-3
"9","Sun","October 31","W","","3-4",FALSE,"Los Angeles Raiders",30,23,17,336,159,177,0,20,467,402,65,2,1993-10-31,2,1,"sdg",7
"10","Sun","November 7","W","","4-4",FALSE,"Minnesota Vikings",30,17,24,411,263,148,1,21,346,326,20,3,1993-11-07,2,1,"sdg",13
"11","Sun","November 14","L","","4-5",TRUE,"Chicago Bears",13,16,19,256,152,104,0,14,224,140,84,2,1993-11-14,2,0,"sdg",-3
"12","Sun","November 21","L","","4-6",TRUE,"Los Angeles Raiders",7,12,13,154,95,59,1,24,428,270,158,2,1993-11-21,1,0,"sdg",-5
"13","Mon","November 29","W","","5-6",FALSE,"Indianapolis Colts",31,0,31,474,227,247,0,16,262,207,55,3,1993-11-29,3,1,"sdg",31
"14","Sun","December 5","W","","6-6",TRUE,"Denver Broncos",13,10,20,298,203,95,0,14,224,138,86,2,1993-12-05,2,1,"sdg",3
"15","Sun","December 12","L","","6-7",TRUE,"Green Bay Packers",13,20,17,282,225,57,3,17,227,124,103,1,1993-12-12,-2,0,"sdg",-7
"16","Sun","December 19","L","","6-8",FALSE,"Kansas City Chiefs",24,28,20,268,174,94,3,20,321,217,104,3,1993-12-19,0,0,"sdg",-4
"17","Mon","December 27","W","","7-8",TRUE,"Miami Dolphins",45,20,25,459,239,220,0,23,321,260,61,3,1993-12-27,3,1,"sdg",25
"18","Sun","January 2","W","","8-8",FALSE,"Tampa Bay Buccaneers",32,17,16,364,272,92,0,22,384,312,72,3,1994-01-02,3,1,"sdg",15
"1","Sun","September 4","W","","1-0",FALSE,"Denver Broncos",37,34,19,370,232,138,1,30,470,341,129,3,1994-09-04,2,1,"sdg",3
"2","Sun","September 11","W","","2-0",TRUE,"Cincinnati Bengals",27,10,21,465,299,166,0,17,280,167,113,3,1994-09-11,3,1,"sdg",17
"3","Sun","September 18","W","","3-0",FALSE,"Seattle Seahawks",24,10,18,346,251,95,2,23,187,128,59,2,1994-09-18,0,1,"sdg",14
"4","Sun","September 25","W","","4-0",FALSE,"Los Angeles Raiders",26,24,17,263,179,84,2,15,279,220,59,1,1994-09-25,-1,1,"sdg",2
"6","Sun","October 9","W","","5-0",TRUE,"Kansas City Chiefs",20,6,18,322,171,151,1,20,361,297,64,2,1994-10-09,1,1,"sdg",14
"7","Sun","October 16","W","","6-0",FALSE,"New Orleans Saints",36,22,25,378,180,198,0,24,284,180,104,2,1994-10-16,2,1,"sdg",14
"8","Sun","October 23","L","","6-1",TRUE,"Denver Broncos",15,20,18,321,155,166,3,16,294,225,69,3,1994-10-23,0,0,"sdg",-5
"9","Sun","October 30","W","","7-1",TRUE,"Seattle Seahawks",35,15,25,348,187,161,1,14,283,171,112,2,1994-10-30,1,1,"sdg",20
"10","Sun","November 6","L","","7-2",FALSE,"Atlanta Falcons",9,10,20,296,179,117,0,11,219,176,43,2,1994-11-06,2,0,"sdg",-1
"11","Sun","November 13","W","","8-2",FALSE,"Kansas City Chiefs",14,13,13,235,187,48,4,15,249,165,84,2,1994-11-13,-2,1,"sdg",1
"12","Sun","November 20","L","","8-3",FALSE,"New England Patriots",17,23,18,241,169,72,3,21,318,217,101,2,1994-11-20,-1,0,"sdg",-6
"13","Sun","November 27","W","","9-3",TRUE,"Los Angeles Rams",31,17,16,243,129,114,1,17,326,278,48,5,1994-11-27,4,1,"sdg",14
"14","Mon","December 5","L","","9-4",TRUE,"Los Angeles Raiders",17,24,18,261,214,47,1,22,410,322,88,1,1994-12-05,0,0,"sdg",-7
"15","Sun","December 11","L","","9-5",TRUE,"San Francisco 49ers",15,38,20,378,322,56,2,27,417,298,119,1,1994-12-11,-1,0,"sdg",-23
"16","Sun","December 18","W","","10-5",FALSE,"New York Jets",21,6,24,403,251,152,2,14,243,167,76,1,1994-12-18,-1,1,"sdg",15
"17","Sat","December 24","W","","11-5",TRUE,"Pittsburgh Steelers",37,34,21,350,263,87,0,22,442,306,136,0,1994-12-24,0,1,"sdg",3
"Division","Sun","January 8","W","","12-5",TRUE,"Miami Dolphins",22,21,28,466,264,202,3,17,282,256,26,0,1995-01-08,-3,1,"sdg",1
"ConfChamp","Sun","January 15","W","","13-5",FALSE,"Pittsburgh Steelers",17,13,13,226,160,66,1,22,415,349,66,1,1995-01-15,0,1,"sdg",4
"SuperBowl","Sun","January 29","L","","13-6",TRUE,"San Francisco 49ers",26,49,20,354,287,67,3,28,455,316,139,0,1995-01-29,-3,0,"sdg",-23
"1","Sun","September 3","L","","0-1",FALSE,"Oakland Raiders",7,17,20,371,294,77,3,19,247,108,139,0,1995-09-03,-3,0,"sdg",-10
"2","Sun","September 10","W","","1-1",TRUE,"Seattle Seahawks",14,10,25,397,251,146,2,15,209,127,82,2,1995-09-10,0,1,"sdg",4
"3","Sun","September 17","W","","2-1",FALSE,"Philadelphia Eagles",27,21,11,270,139,131,1,18,319,181,138,2,1995-09-17,1,1,"sdg",6
"4","Sun","September 24","W","","3-1",TRUE,"Denver Broncos",17,6,23,334,176,158,1,12,246,181,65,0,1995-09-24,-1,1,"sdg",11
"5","Sun","October 1","L","","3-2",FALSE,"Pittsburgh Steelers",16,31,20,327,232,95,4,21,261,141,120,1,1995-10-01,-3,0,"sdg",-15
"6","Mon","October 9","L","OT","3-3",FALSE,"Kansas City Chiefs",23,29,25,369,318,51,3,21,379,317,62,1,1995-10-09,-2,0,"sdg",-6
"7","Sun","October 15","L","","3-4",TRUE,"Dallas Cowboys",9,23,20,333,174,159,4,22,320,215,105,1,1995-10-15,-3,0,"sdg",-14
"8","Sun","October 22","W","","4-4",FALSE,"Seattle Seahawks",35,25,15,299,146,153,1,24,383,233,150,4,1995-10-22,3,1,"sdg",10
"10","Sun","November 5","L","","4-5",TRUE,"Miami Dolphins",14,24,17,299,229,70,2,24,417,291,126,1,1995-11-05,-1,0,"sdg",-10
"11","Sun","November 12","L","","4-6",TRUE,"Kansas City Chiefs",7,22,17,283,213,70,0,19,286,120,166,1,1995-11-12,1,0,"sdg",-15
"12","Sun","November 19","L","","4-7",FALSE,"Denver Broncos",27,30,20,269,199,70,1,25,463,290,173,2,1995-11-19,1,0,"sdg",-3
"13","Mon","November 27","W","","5-7",TRUE,"Oakland Raiders",12,6,17,282,204,78,0,16,284,164,120,4,1995-11-27,4,1,"sdg",6
"14","Sun","December 3","W","","6-7",TRUE,"Cleveland Browns",31,13,25,416,230,186,0,19,313,287,26,2,1995-12-03,2,1,"sdg",18
"15","Sat","December 9","W","","7-7",TRUE,"Arizona Cardinals",28,25,20,380,288,92,6,13,282,250,32,1,1995-12-09,-5,1,"sdg",3
"16","Sun","December 17","W","","8-7",FALSE,"Indianapolis Colts",27,24,26,379,265,114,1,24,365,276,89,1,1995-12-17,0,1,"sdg",3
"17","Sat","December 23","W","","9-7",FALSE,"New York Giants",27,17,13,205,108,97,1,21,300,202,98,4,1995-12-23,3,1,"sdg",10
"WildCard","Sun","December 31","L","","9-8",TRUE,"Indianapolis Colts",20,35,27,429,284,145,4,19,333,155,178,1,1995-12-31,-3,0,"sdg",-15
"1","Sun","September 1","W","","1-0",TRUE,"Seattle Seahawks",29,7,27,377,191,186,0,16,357,251,106,4,1996-09-01,4,1,"sdg",22
"2","Sun","September 8","W","","2-0",TRUE,"Cincinnati Bengals",27,14,25,383,269,114,2,14,249,187,62,2,1996-09-08,0,1,"sdg",13
"3","Sun","September 15","L","","2-1",FALSE,"Green Bay Packers",10,42,11,141,108,33,3,23,336,204,132,3,1996-09-15,0,0,"sdg",-32
"4","Sun","September 22","W","","3-1",FALSE,"Oakland Raiders",40,34,20,321,218,103,0,28,553,371,182,3,1996-09-22,3,1,"sdg",6
"5","Sun","September 29","W","","4-1",TRUE,"Kansas City Chiefs",22,19,18,313,238,75,2,19,315,257,58,2,1996-09-29,0,1,"sdg",3
"6","Sun","October 6","L","","4-2",FALSE,"Denver Broncos",17,28,14,245,210,35,0,23,406,312,94,1,1996-10-06,1,0,"sdg",-11
"8","Mon","October 21","L","","4-3",TRUE,"Oakland Raiders",14,23,16,282,253,29,3,22,310,179,131,1,1996-10-21,-2,0,"sdg",-9
"9","Sun","October 27","L","","4-4",FALSE,"Seattle Seahawks",13,32,15,322,253,69,5,18,404,196,208,1,1996-10-27,-4,0,"sdg",-19
"10","Sun","November 3","W","","5-4",FALSE,"Indianapolis Colts",26,19,14,312,237,75,0,22,264,173,91,5,1996-11-03,5,1,"sdg",7
"11","Mon","November 11","W","","6-4",TRUE,"Detroit Lions",27,21,27,406,279,127,0,19,222,140,82,1,1996-11-11,1,1,"sdg",6
"12","Sun","November 17","L","","6-5",TRUE,"Tampa Bay Buccaneers",17,25,11,277,183,94,3,23,423,324,99,3,1996-11-17,0,0,"sdg",-8
"13","Sun","November 24","W","","7-5",FALSE,"Kansas City Chiefs",28,14,20,380,252,128,0,26,434,332,102,2,1996-11-24,2,1,"sdg",14
"14","Sun","December 1","L","","7-6",TRUE,"New England Patriots",7,45,15,236,204,32,6,15,313,229,84,0,1996-12-01,-6,0,"sdg",-38
"15","Sun","December 8","L","","7-7",FALSE,"Pittsburgh Steelers",3,16,8,148,83,65,4,21,327,160,167,4,1996-12-08,0,0,"sdg",-13
"16","Sat","December 14","L","","7-8",FALSE,"Chicago Bears",14,27,17,283,217,66,1,19,294,203,91,0,1996-12-14,-1,0,"sdg",-13
"17","Sun","December 22","W","","8-8",TRUE,"Denver Broncos",16,10,14,244,163,81,3,13,214,148,66,4,1996-12-22,1,1,"sdg",6
"1","Sun","August 31","L","","0-1",FALSE,"New England Patriots",7,41,14,227,142,85,3,22,424,340,84,0,1997-08-31,-3,0,"sdg",-34
"2","Sun","September 7","W","","1-1",FALSE,"New Orleans Saints",20,6,11,230,171,59,2,14,243,178,65,6,1997-09-07,4,1,"sdg",14
"3","Sun","September 14","L","","1-2",TRUE,"Carolina Panthers",7,26,17,251,155,96,4,21,279,138,141,1,1997-09-14,-3,0,"sdg",-19
"4","Sun","September 21","L","","1-3",FALSE,"Seattle Seahawks",22,26,20,309,230,79,3,21,343,251,92,3,1997-09-21,0,0,"sdg",-4
"5","Sun","September 28","W","","2-3",TRUE,"Baltimore Ravens",21,17,15,440,352,88,3,18,328,217,111,3,1997-09-28,0,1,"sdg",4
"6","Sun","October 5","W","","3-3",FALSE,"Oakland Raiders",25,10,23,398,218,180,0,11,241,228,13,1,1997-10-05,1,1,"sdg",15
"8","Thu","October 16","L","","3-4",FALSE,"Kansas City Chiefs",3,31,12,258,189,69,2,25,313,224,89,1,1997-10-16,-1,0,"sdg",-28
"9","Sun","October 26","W","","4-4",TRUE,"Indianapolis Colts",35,19,24,424,222,202,0,14,250,219,31,2,1997-10-26,2,1,"sdg",16
"10","Sun","November 2","L","","4-5",FALSE,"Cincinnati Bengals",31,38,14,235,168,67,3,18,336,162,174,1,1997-11-02,-2,0,"sdg",-7
"11","Sun","November 9","L","","4-6",TRUE,"Seattle Seahawks",31,37,13,260,179,81,2,24,373,281,92,2,1997-11-09,0,0,"sdg",-6
"12","Sun","November 16","L","","4-7",TRUE,"Oakland Raiders",13,38,11,248,157,91,2,22,365,225,140,2,1997-11-16,0,0,"sdg",-25
"13","Sun","November 23","L","","4-8",FALSE,"San Francisco 49ers",10,17,8,203,111,92,3,19,339,228,111,2,1997-11-23,-1,0,"sdg",-7
"14","Sun","November 30","L","","4-9",TRUE,"Denver Broncos",28,38,22,269,222,47,2,28,438,240,198,0,1997-11-30,-2,0,"sdg",-10
"15","Sun","December 7","L","","4-10",TRUE,"Atlanta Falcons",3,14,16,268,221,47,3,13,204,108,96,1,1997-12-07,-2,0,"sdg",-11
"16","Sun","December 14","L","","4-11",TRUE,"Kansas City Chiefs",7,29,22,282,219,63,2,14,239,108,131,0,1997-12-14,-2,0,"sdg",-22
"17","Sun","December 21","L","","4-12",FALSE,"Denver Broncos",3,38,9,203,133,70,1,24,451,321,130,1,1997-12-21,0,0,"sdg",-35
"1","Sun","September 6","W","","1-0",TRUE,"Buffalo Bills",16,14,14,254,187,67,2,20,297,207,90,2,1998-09-06,0,1,"sdg",2
"2","Sun","September 13","W","","2-0",FALSE,"Tennessee Oilers",13,7,18,320,179,141,0,18,250,187,63,0,1998-09-13,0,1,"sdg",6
"3","Sun","September 20","L","","2-1",FALSE,"Kansas City Chiefs",7,23,6,152,-19,171,6,16,251,129,122,1,1998-09-20,-5,0,"sdg",-16
"4","Sun","September 27","L","","2-2",TRUE,"New York Giants",16,34,17,355,266,89,4,19,313,208,105,1,1998-09-27,-3,0,"sdg",-18
"5","Sun","October 4","L","","2-3",FALSE,"Indianapolis Colts",12,17,17,295,143,152,3,11,192,137,55,1,1998-10-04,-2,0,"sdg",-5
"6","Sun","October 11","L","","2-4",FALSE,"Oakland Raiders",6,7,9,195,78,117,4,6,159,141,18,1,1998-10-11,-3,0,"sdg",-1
"7","Sun","October 18","W","","3-4",TRUE,"Philadelphia Eagles",13,10,11,168,28,140,1,21,261,210,51,4,1998-10-18,3,1,"sdg",3
"8","Sun","October 25","L","","3-5",TRUE,"Seattle Seahawks",20,27,27,391,280,111,0,14,274,234,40,0,1998-10-25,0,0,"sdg",-7
"10","Sun","November 8","L","","3-6",FALSE,"Denver Broncos",10,27,13,213,136,77,3,19,289,217,72,1,1998-11-08,-2,0,"sdg",-17
"11","Sun","November 15","W","","4-6",TRUE,"Baltimore Ravens",14,13,19,203,146,57,1,8,161,121,40,2,1998-11-15,1,1,"sdg",1
"12","Sun","November 22","W","","5-6",TRUE,"Kansas City Chiefs",38,37,25,366,271,95,3,21,366,297,69,2,1998-11-22,-1,1,"sdg",1
"13","Sun","November 29","L","","5-7",TRUE,"Denver Broncos",16,31,21,367,302,65,6,18,322,226,96,4,1998-11-29,-2,0,"sdg",-15
"14","Sun","December 6","L","","5-8",FALSE,"Washington Redskins",20,24,21,344,217,127,2,17,278,212,66,2,1998-12-06,0,0,"sdg",-4
"15","Sun","December 13","L","","5-9",FALSE,"Seattle Seahawks",17,38,16,277,211,66,8,18,238,130,108,3,1998-12-13,-5,0,"sdg",-21
"16","Sun","December 20","L","","5-10",TRUE,"Oakland Raiders",10,17,16,315,236,79,3,14,287,167,120,3,1998-12-20,0,0,"sdg",-7
"17","Sun","December 27","L","","5-11",FALSE,"Arizona Cardinals",13,16,22,377,203,174,5,16,270,245,25,0,1998-12-27,-5,0,"sdg",-3
"2","Sun","September 19","W","","1-0",FALSE,"Cincinnati Bengals",34,7,14,266,175,91,0,10,180,133,47,5,1999-09-19,5,1,"sdg",27
"3","Sun","September 26","L","","1-1",TRUE,"Indianapolis Colts",19,27,16,274,179,95,1,26,468,404,64,1,1999-09-26,0,0,"sdg",-8
"4","Sun","October 3","W","","2-1",TRUE,"Kansas City Chiefs",21,14,8,132,92,40,2,19,314,193,121,4,1999-10-03,2,1,"sdg",7
"5","Sun","October 10","W","","3-1",FALSE,"Detroit Lions",20,10,15,256,192,64,2,14,229,192,37,3,1999-10-10,1,1,"sdg",10
"6","Sun","October 17","W","","4-1",TRUE,"Seattle Seahawks",13,10,19,330,281,49,4,15,201,140,61,1,1999-10-17,-3,1,"sdg",3
"7","Sun","October 24","L","","4-2",TRUE,"Green Bay Packers",3,31,21,303,227,76,6,19,295,166,129,2,1999-10-24,-4,0,"sdg",-28
"8","Sun","October 31","L","","4-3",FALSE,"Kansas City Chiefs",0,34,10,213,141,72,4,11,283,186,97,0,1999-10-31,-4,0,"sdg",-34
"9","Sun","November 7","L","","4-4",TRUE,"Denver Broncos",17,33,19,273,214,59,4,17,241,127,114,0,1999-11-07,-4,0,"sdg",-16
"10","Sun","November 14","L","","4-5",FALSE,"Oakland Raiders",9,28,12,225,192,33,0,25,417,244,173,0,1999-11-14,0,0,"sdg",-19
"11","Sun","November 21","L","OT","4-6",TRUE,"Chicago Bears",20,23,20,348,264,84,1,19,430,355,75,1,1999-11-21,0,0,"sdg",-3
"12","Sun","November 28","L","","4-7",FALSE,"Minnesota Vikings",27,35,19,458,396,62,3,27,485,356,129,2,1999-11-28,-1,0,"sdg",-8
"13","Sun","December 5","W","","5-7",TRUE,"Cleveland Browns",23,10,20,277,132,145,1,13,202,147,55,2,1999-12-05,1,1,"sdg",13
"14","Sun","December 12","W","","6-7",FALSE,"Seattle Seahawks",19,16,22,329,222,107,1,20,347,271,76,2,1999-12-12,1,1,"sdg",3
"15","Sun","December 19","L","","6-8",FALSE,"Miami Dolphins",9,12,13,186,160,26,1,11,284,231,53,2,1999-12-19,1,0,"sdg",-3
"16","Sun","December 26","W","","7-8",TRUE,"Oakland Raiders",23,20,17,342,293,49,1,18,294,248,46,1,1999-12-26,0,1,"sdg",3
"17","Sun","January 2","W","","8-8",FALSE,"Denver Broncos",12,6,17,377,183,194,4,15,235,191,44,1,2000-01-02,-3,1,"sdg",6
"1","Sun","September 3","L","","0-1",FALSE,"Oakland Raiders",6,9,17,255,179,76,4,13,233,166,67,0,2000-09-03,-4,0,"sdg",-3
"2","Sun","September 10","L","","0-2",TRUE,"New Orleans Saints",27,28,15,188,116,72,2,28,323,259,64,3,2000-09-10,1,0,"sdg",-1
"3","Sun","September 17","L","","0-3",FALSE,"Kansas City Chiefs",10,42,10,187,138,49,2,25,349,232,117,1,2000-09-17,-1,0,"sdg",-32
"4","Sun","September 24","L","","0-4",TRUE,"Seattle Seahawks",12,20,15,303,212,91,2,15,269,161,108,2,2000-09-24,0,0,"sdg",-8
"5","Sun","October 1","L","","0-5",FALSE,"St. Louis Rams",31,57,23,381,333,48,2,29,614,451,163,0,2000-10-01,-2,0,"sdg",-26
"6","Sun","October 8","L","","0-6",TRUE,"Denver Broncos",7,21,17,277,212,65,3,18,304,208,96,0,2000-10-08,-3,0,"sdg",-14
"7","Sun","October 15","L","OT","0-7",FALSE,"Buffalo Bills",24,27,15,303,251,52,4,25,424,329,95,2,2000-10-15,-2,0,"sdg",-3
"9","Sun","October 29","L","","0-8",TRUE,"Oakland Raiders",13,15,18,224,195,29,2,19,228,145,83,1,2000-10-29,-1,0,"sdg",-2
"10","Sun","November 5","L","","0-9",FALSE,"Seattle Seahawks",15,17,22,398,282,116,3,9,128,78,50,1,2000-11-05,-2,0,"sdg",-2
"11","Sun","November 12","L","","0-10",TRUE,"Miami Dolphins",7,17,19,238,156,82,4,15,244,160,84,0,2000-11-12,-4,0,"sdg",-10
"12","Sun","November 19","L","","0-11",FALSE,"Denver Broncos",37,38,14,385,299,86,3,34,536,443,93,5,2000-11-19,2,0,"sdg",-1
"13","Sun","November 26","W","","1-11",TRUE,"Kansas City Chiefs",17,16,14,201,149,52,5,10,161,84,77,1,2000-11-26,-4,1,"sdg",1
"14","Sun","December 3","L","","1-12",TRUE,"San Francisco 49ers",17,45,18,303,254,49,5,19,385,312,73,0,2000-12-03,-5,0,"sdg",-28
"15","Sun","December 10","L","","1-13",FALSE,"Baltimore Ravens",3,24,9,128,64,64,5,19,276,166,110,3,2000-12-10,-2,0,"sdg",-21
"16","Sun","December 17","L","","1-14",FALSE,"Carolina Panthers",22,30,19,358,258,100,2,13,169,158,11,1,2000-12-17,-1,0,"sdg",-8
"17","Sun","December 24","L","","1-15",TRUE,"Pittsburgh Steelers",21,34,6,171,140,31,2,21,316,185,131,2,2000-12-24,0,0,"sdg",-13
"1","Sun","September 9","W","","1-0",TRUE,"Washington Redskins",30,3,19,255,122,133,4,8,161,117,44,4,2001-09-09,0,1,"sdg",27
"2","Sun","September 23","W","","2-0",FALSE,"Dallas Cowboys",32,21,26,475,345,130,1,14,289,188,101,5,2001-09-23,4,1,"sdg",11
"3","Sun","September 30","W","","3-0",TRUE,"Cincinnati Bengals",28,14,16,245,112,133,0,17,237,126,111,4,2001-09-30,4,1,"sdg",14
"4","Sun","October 7","L","","3-1",FALSE,"Cleveland Browns",16,20,15,269,143,126,0,16,278,181,97,1,2001-10-07,1,0,"sdg",-4
"5","Sun","October 14","L","OT","3-2",FALSE,"New England Patriots",26,29,20,343,258,85,1,30,374,345,29,1,2001-10-14,0,0,"sdg",-3
"6","Sun","October 21","W","","4-2",TRUE,"Denver Broncos",27,10,22,379,272,107,2,19,263,182,81,3,2001-10-21,1,1,"sdg",17
"7","Sun","October 28","W","","5-2",TRUE,"Buffalo Bills",27,24,17,338,243,95,0,22,396,291,105,2,2001-10-28,2,1,"sdg",3
"8","Sun","November 4","L","","5-3",TRUE,"Kansas City Chiefs",20,25,22,325,259,66,1,21,378,170,208,1,2001-11-04,0,0,"sdg",-5
"9","Sun","November 11","L","","5-4",FALSE,"Denver Broncos",16,26,9,243,147,96,5,19,338,221,117,1,2001-11-11,-4,0,"sdg",-10
"10","Sun","November 18","L","","5-5",FALSE,"Oakland Raiders",24,34,12,250,98,152,2,21,381,293,88,1,2001-11-18,-1,0,"sdg",-10
"11","Sun","November 25","L","","5-6",TRUE,"Arizona Cardinals",17,20,20,392,308,84,1,18,298,227,71,2,2001-11-25,1,0,"sdg",-3
"12","Sun","December 2","L","OT","5-7",FALSE,"Seattle Seahawks",10,13,19,292,185,107,3,18,309,192,117,0,2001-12-02,-3,0,"sdg",-3
"13","Sun","December 9","L","","5-8",FALSE,"Philadelphia Eagles",14,24,18,393,297,96,4,14,273,210,63,1,2001-12-09,-3,0,"sdg",-10
"14","Sat","December 15","L","","5-9",TRUE,"Oakland Raiders",6,13,14,274,206,68,3,15,299,208,91,3,2001-12-15,0,0,"sdg",-7
"15","Sun","December 23","L","","5-10",FALSE,"Kansas City Chiefs",17,20,20,329,164,165,0,24,323,203,120,2,2001-12-23,2,0,"sdg",-3
"16","Sun","December 30","L","","5-11",TRUE,"Seattle Seahawks",22,25,21,398,346,52,2,14,307,246,61,0,2001-12-30,-2,0,"sdg",-3
"1","Sun","September 8","W","","1-0",FALSE,"Cincinnati Bengals",34,6,27,401,160,241,0,13,203,167,36,1,2002-09-08,1,1,"sdg",28
"2","Sun","September 15","W","","2-0",TRUE,"Houston Texans",24,3,16,267,143,124,1,7,118,29,89,3,2002-09-15,2,1,"sdg",21
"3","Sun","September 22","W","","3-0",FALSE,"Arizona Cardinals",23,15,19,289,164,125,1,15,297,200,97,3,2002-09-22,2,1,"sdg",8
"4","Sun","September 29","W","","4-0",TRUE,"New England Patriots",21,14,14,342,104,238,1,25,440,353,87,3,2002-09-29,2,1,"sdg",7
"5","Sun","October 6","L","","4-1",FALSE,"Denver Broncos",9,26,16,314,235,79,3,20,417,300,117,1,2002-10-06,-2,0,"sdg",-17
"6","Sun","October 13","W","","5-1",TRUE,"Kansas City Chiefs",35,34,27,465,312,153,5,17,319,231,88,2,2002-10-13,-3,1,"sdg",1
"7","Sun","October 20","W","OT","6-1",FALSE,"Oakland Raiders",27,21,24,333,161,172,0,26,390,353,37,1,2002-10-20,1,1,"sdg",6
"9","Sun","November 3","L","","6-2",TRUE,"New York Jets",13,44,15,243,170,73,3,21,413,248,165,0,2002-11-03,-3,0,"sdg",-31
"10","Sun","November 10","L","","6-3",FALSE,"St. Louis Rams",24,28,15,256,130,126,2,25,524,453,71,4,2002-11-10,2,0,"sdg",-4
"11","Sun","November 17","W","OT","7-3",TRUE,"San Francisco 49ers",20,17,26,441,336,105,1,21,467,331,136,1,2002-11-17,0,1,"sdg",3
"12","Sun","November 24","L","","7-4",FALSE,"Miami Dolphins",3,30,12,144,80,64,2,24,413,191,222,0,2002-11-24,-2,0,"sdg",-27
"13","Sun","December 1","W","OT","8-4",TRUE,"Denver Broncos",30,27,25,434,214,220,0,20,417,261,156,3,2002-12-01,3,1,"sdg",3
"14","Sun","December 8","L","","8-5",TRUE,"Oakland Raiders",7,27,19,291,226,65,3,22,393,326,67,0,2002-12-08,-3,0,"sdg",-20
"15","Sun","December 15","L","","8-6",FALSE,"Buffalo Bills",13,20,14,308,192,116,0,17,256,101,155,1,2002-12-15,1,0,"sdg",-7
"16","Sun","December 22","L","","8-7",FALSE,"Kansas City Chiefs",22,24,20,383,235,148,1,19,376,323,53,1,2002-12-22,0,0,"sdg",-2
"17","Sun","December 29","L","OT","8-8",TRUE,"Seattle Seahawks",28,31,24,414,326,88,1,34,591,428,163,3,2002-12-29,2,0,"sdg",-3
"1","Sun","September 7","L","","0-1",FALSE,"Kansas City Chiefs",14,27,13,232,168,64,2,19,390,259,131,2,2003-09-07,0,0,"sdg",-13
"2","Sun","September 14","L","","0-2",TRUE,"Denver Broncos",13,37,19,303,182,121,1,24,382,185,197,0,2003-09-14,-1,0,"sdg",-24
"3","Sun","September 21","L","","0-3",TRUE,"Baltimore Ravens",10,24,25,389,257,132,3,16,249,97,152,1,2003-09-21,-2,0,"sdg",-14
"4","Sun","September 28","L","OT","0-4",FALSE,"Oakland Raiders",31,34,22,430,208,222,1,23,448,328,120,2,2003-09-28,1,0,"sdg",-3
"5","Sun","October 5","L","","0-5",FALSE,"Jacksonville Jaguars",21,27,21,346,277,69,2,21,436,313,123,1,2003-10-05,-1,0,"sdg",-6
"7","Sun","October 19","W","","1-5",FALSE,"Cleveland Browns",26,20,15,289,61,228,2,20,277,176,101,2,2003-10-19,0,1,"sdg",6
"8","Mon","October 27","L","","1-6",TRUE,"Miami Dolphins",10,26,18,250,146,104,3,14,264,183,81,1,2003-10-27,-2,0,"sdg",-16
"9","Sun","November 2","L","","1-7",FALSE,"Chicago Bears",7,20,11,199,119,80,1,19,341,216,125,1,2003-11-02,0,0,"sdg",-13
"10","Sun","November 9","W","","2-7",TRUE,"Minnesota Vikings",42,28,26,458,247,211,0,27,460,350,110,2,2003-11-09,2,1,"sdg",14
"11","Sun","November 16","L","","2-8",FALSE,"Denver Broncos",8,37,5,96,56,40,4,26,448,247,201,3,2003-11-16,-1,0,"sdg",-29
"12","Sun","November 23","L","","2-9",TRUE,"Cincinnati Bengals",27,34,17,325,207,118,0,33,444,234,210,1,2003-11-23,1,0,"sdg",-7
"13","Sun","November 30","L","","2-10",TRUE,"Kansas City Chiefs",24,28,17,370,211,159,3,23,335,141,194,2,2003-11-30,-1,0,"sdg",-4
"14","Sun","December 7","W","","3-10",FALSE,"Detroit Lions",14,7,17,375,244,131,2,14,276,208,68,0,2003-12-07,-2,1,"sdg",7
"15","Sun","December 14","L","","3-11",TRUE,"Green Bay Packers",21,38,23,424,336,88,4,17,361,278,83,1,2003-12-14,-3,0,"sdg",-17
"16","Sun","December 21","L","","3-12",FALSE,"Pittsburgh Steelers",24,40,21,344,228,116,3,21,341,160,181,0,2003-12-21,-3,0,"sdg",-16
"17","Sun","December 28","W","","4-12",TRUE,"Oakland Raiders",21,14,20,337,74,263,0,9,141,0,141,1,2003-12-28,1,1,"sdg",7
"1","Sun","September 12","W","","1-0",FALSE,"Houston Texans",27,20,17,324,202,122,0,20,336,226,110,4,2004-09-12,4,1,"sdg",7
"2","Sun","September 19","L","","1-1",TRUE,"New York Jets",28,34,21,327,216,111,4,22,380,258,122,0,2004-09-19,-4,0,"sdg",-6
"3","Sun","September 26","L","","1-2",FALSE,"Denver Broncos",13,23,16,214,129,85,1,18,328,291,37,1,2004-09-26,0,0,"sdg",-10
"4","Sun","October 3","W","","2-2",TRUE,"Tennessee Titans",38,17,16,393,198,195,0,21,330,258,72,0,2004-10-03,0,1,"sdg",21
"5","Sun","October 10","W","","3-2",TRUE,"Jacksonville Jaguars",34,21,18,386,210,176,0,28,429,349,80,3,2004-10-10,3,1,"sdg",13
"6","Sun","October 17","L","","3-3",FALSE,"Atlanta Falcons",20,21,18,318,223,95,1,15,299,206,93,2,2004-10-17,1,0,"sdg",-1
"7","Sun","October 24","W","","4-3",FALSE,"Carolina Panthers",17,6,19,302,188,114,1,20,263,147,116,1,2004-10-24,0,1,"sdg",11
"8","Sun","October 31","W","","5-3",TRUE,"Oakland Raiders",42,14,33,448,273,175,1,15,281,259,22,3,2004-10-31,2,1,"sdg",28
"9","Sun","November 7","W","","6-3",TRUE,"New Orleans Saints",43,17,28,402,250,152,0,18,220,165,55,2,2004-11-07,2,1,"sdg",26
"11","Sun","November 21","W","","7-3",FALSE,"Oakland Raiders",23,17,26,402,226,176,1,14,273,220,53,1,2004-11-21,0,1,"sdg",6
"12","Sun","November 28","W","","8-3",FALSE,"Kansas City Chiefs",34,31,25,498,371,127,0,20,310,200,110,2,2004-11-28,2,1,"sdg",3
"13","Sun","December 5","W","","9-3",TRUE,"Denver Broncos",20,17,14,208,86,122,2,21,337,263,74,4,2004-12-05,2,1,"sdg",3
"14","Sun","December 12","W","","10-3",TRUE,"Tampa Bay Buccaneers",31,24,18,336,206,130,3,21,436,373,63,4,2004-12-12,1,1,"sdg",7
"15","Sun","December 19","W","","11-3",FALSE,"Cleveland Browns",21,0,16,257,83,174,1,11,231,105,126,1,2004-12-19,0,1,"sdg",21
"16","Sun","December 26","L","OT","11-4",FALSE,"Indianapolis Colts",31,34,22,374,281,93,1,30,464,360,104,1,2004-12-26,0,0,"sdg",-3
"17","Sun","January 2","W","","12-4",TRUE,"Kansas City Chiefs",24,17,21,353,215,138,2,26,443,373,70,4,2005-01-02,2,1,"sdg",7
"WildCard","Sat","January 8","L","OT","12-5",TRUE,"New York Jets",17,20,24,408,308,100,1,20,396,270,126,0,2005-01-08,-1,0,"sdg",-3
"1","Sun","September 11","L","","0-1",TRUE,"Dallas Cowboys",24,28,19,291,188,103,2,23,301,192,109,1,2005-09-11,-1,0,"sdg",-4
"2","Sun","September 18","L","","0-2",FALSE,"Denver Broncos",17,20,15,213,134,79,2,21,331,233,98,2,2005-09-18,0,0,"sdg",-3
"3","Sun","September 25","W","","1-2",TRUE,"New York Giants",45,23,25,485,217,268,1,23,424,338,86,1,2005-09-25,0,1,"sdg",22
"4","Sun","October 2","W","","2-2",FALSE,"New England Patriots",41,17,26,431,248,183,0,18,303,231,72,2,2005-10-02,2,1,"sdg",24
"5","Mon","October 10","L","","2-3",TRUE,"Pittsburgh Steelers",22,24,20,279,213,66,2,25,311,207,104,1,2005-10-10,-1,0,"sdg",-2
"6","Sun","October 16","W","","3-3",FALSE,"Oakland Raiders",27,14,22,346,156,190,0,19,310,271,39,1,2005-10-16,1,1,"sdg",13
"7","Sun","October 23","L","","3-4",FALSE,"Philadelphia Eagles",17,20,15,291,270,21,3,22,286,262,24,2,2005-10-23,-1,0,"sdg",-3
"8","Sun","October 30","W","","4-4",TRUE,"Kansas City Chiefs",28,20,22,424,341,83,2,21,418,323,95,1,2005-10-30,-1,1,"sdg",8
"9","Sun","November 6","W","","5-4",FALSE,"New York Jets",31,26,27,395,262,133,2,19,269,180,89,0,2005-11-06,-2,1,"sdg",5
"11","Sun","November 20","W","","6-4",TRUE,"Buffalo Bills",48,10,28,478,337,141,0,12,202,137,65,2,2005-11-20,2,1,"sdg",38
"12","Sun","November 27","W","OT","7-4",FALSE,"Washington Redskins",23,17,24,397,195,202,3,15,282,191,91,0,2005-11-27,-3,1,"sdg",6
"13","Sun","December 4","W","","8-4",TRUE,"Oakland Raiders",34,10,19,274,144,130,0,16,291,210,81,2,2005-12-04,2,1,"sdg",24
"14","Sun","December 11","L","","8-5",TRUE,"Miami Dolphins",21,23,27,341,245,96,3,14,300,229,71,2,2005-12-11,-1,0,"sdg",-2
"15","Sun","December 18","W","","9-5",FALSE,"Indianapolis Colts",26,17,18,453,247,206,4,21,338,314,24,3,2005-12-18,-1,1,"sdg",9
"16","Sat","December 24","L","","9-6",FALSE,"Kansas City Chiefs",7,20,15,233,153,80,2,20,341,197,144,0,2005-12-24,-2,0,"sdg",-13
"17","Sat","December 31","L","","9-7",TRUE,"Denver Broncos",7,23,15,236,145,91,2,17,241,84,157,0,2005-12-31,-2,0,"sdg",-16
"1","Mon","September 11","W","","1-0",FALSE,"Oakland Raiders",27,0,14,302,108,194,0,9,129,42,87,1,2006-09-11,1,1,"sdg",27
"2","Sun","September 17","W","","2-0",TRUE,"Tennessee Titans",40,7,26,476,235,241,0,14,218,163,55,2,2006-09-17,2,1,"sdg",33
"4","Sun","October 1","L","","2-1",FALSE,"Baltimore Ravens",13,16,13,284,134,150,1,14,206,150,56,3,2006-10-01,2,0,"sdg",-3
"5","Sun","October 8","W","","3-1",TRUE,"Pittsburgh Steelers",23,13,22,341,222,119,1,16,265,197,68,2,2006-10-08,1,1,"sdg",10
"6","Sun","October 15","W","","4-1",FALSE,"San Francisco 49ers",48,19,30,421,334,87,0,15,274,182,92,2,2006-10-15,2,1,"sdg",29
"7","Sun","October 22","L","","4-2",FALSE,"Kansas City Chiefs",27,30,22,349,252,97,3,19,355,221,134,1,2006-10-22,-2,0,"sdg",-3
"8","Sun","October 29","W","","5-2",TRUE,"St. Louis Rams",38,24,21,419,203,216,0,23,412,311,101,1,2006-10-29,1,1,"sdg",14
"9","Sun","November 5","W","","6-2",TRUE,"Cleveland Browns",32,25,19,381,191,190,1,23,293,209,84,2,2006-11-05,1,1,"sdg",7
"10","Sun","November 12","W","","7-2",FALSE,"Cincinnati Bengals",49,41,25,431,324,107,0,29,545,417,128,1,2006-11-12,1,1,"sdg",8
"11","Sun","November 19","W","","8-2",FALSE,"Denver Broncos",35,27,21,342,217,125,2,20,326,168,158,1,2006-11-19,-1,1,"sdg",8
"12","Sun","November 26","W","","9-2",TRUE,"Oakland Raiders",21,14,15,260,150,110,1,15,245,161,84,2,2006-11-26,1,1,"sdg",7
"13","Sun","December 3","W","","10-2",FALSE,"Buffalo Bills",24,21,18,335,138,197,2,16,230,167,63,4,2006-12-03,2,1,"sdg",3
"14","Sun","December 10","W","","11-2",TRUE,"Denver Broncos",48,20,22,419,276,143,1,19,328,166,162,1,2006-12-10,0,1,"sdg",28
"15","Sun","December 17","W","","12-2",TRUE,"Kansas City Chiefs",20,9,16,353,88,265,2,16,241,151,90,2,2006-12-17,0,1,"sdg",11
"16","Sun","December 24","W","","13-2",FALSE,"Seattle Seahawks",20,17,14,340,172,168,0,18,314,161,153,2,2006-12-24,2,1,"sdg",3
"17","Sun","December 31","W","","14-2",TRUE,"Arizona Cardinals",27,20,23,387,218,169,1,19,444,346,98,1,2006-12-31,0,1,"sdg",7
"Division","Sun","January 14","L","","14-3",TRUE,"New England Patriots",21,24,21,352,204,148,4,18,327,276,51,3,2007-01-14,-1,0,"sdg",-3
"1","Sun","September 9","W","","1-0",TRUE,"Chicago Bears",14,3,19,263,186,77,2,11,202,122,80,4,2007-09-09,2,1,"sdg",11
"2","Sun","September 16","L","","1-1",FALSE,"New England Patriots",14,38,14,201,149,52,3,25,407,263,144,2,2007-09-16,-1,0,"sdg",-24
"3","Sun","September 23","L","","1-2",FALSE,"Green Bay Packers",24,31,25,364,291,73,1,20,405,363,42,0,2007-09-23,-1,0,"sdg",-7
"4","Sun","September 30","L","","1-3",TRUE,"Kansas City Chiefs",16,30,19,333,200,133,4,17,390,264,126,2,2007-09-30,-2,0,"sdg",-14
"5","Sun","October 7","W","","2-3",FALSE,"Denver Broncos",41,3,20,484,270,214,0,17,296,224,72,3,2007-10-07,3,1,"sdg",38
"6","Sun","October 14","W","","3-3",TRUE,"Oakland Raiders",28,14,18,362,156,206,1,18,245,202,43,3,2007-10-14,2,1,"sdg",14
"8","Sun","October 28","W","","4-3",TRUE,"Houston Texans",35,10,11,237,128,109,0,22,367,252,115,5,2007-10-28,5,1,"sdg",25
"9","Sun","November 4","L","","4-4",FALSE,"Minnesota Vikings",17,35,14,229,187,42,2,26,528,150,378,2,2007-11-04,0,0,"sdg",-18
"10","Sun","November 11","W","","5-4",TRUE,"Indianapolis Colts",23,21,11,177,86,91,3,25,386,311,75,6,2007-11-11,3,1,"sdg",2
"11","Sun","November 18","L","","5-5",FALSE,"Jacksonville Jaguars",17,24,18,388,309,79,2,18,311,189,122,0,2007-11-18,-2,0,"sdg",-7
"12","Sun","November 25","W","","6-5",TRUE,"Baltimore Ravens",32,14,18,332,249,83,0,19,210,154,56,2,2007-11-25,2,1,"sdg",18
"13","Sun","December 2","W","","7-5",FALSE,"Kansas City Chiefs",24,10,12,330,139,191,1,18,268,180,88,4,2007-12-02,3,1,"sdg",14
"14","Sun","December 9","W","OT","8-5",FALSE,"Tennessee Titans",23,17,20,341,193,148,3,13,240,109,131,2,2007-12-09,-1,1,"sdg",6
"15","Sun","December 16","W","","9-5",TRUE,"Detroit Lions",51,14,26,416,142,274,0,19,328,302,26,6,2007-12-16,6,1,"sdg",37
"16","Mon","December 24","W","","10-5",TRUE,"Denver Broncos",23,3,18,334,187,147,1,12,225,133,92,3,2007-12-24,2,1,"sdg",20
"17","Sun","December 30","W","","11-5",FALSE,"Oakland Raiders",30,17,15,253,133,120,1,17,316,194,122,4,2007-12-30,3,1,"sdg",13
"WildCard","Sun","January 6","W","","12-5",TRUE,"Tennessee Titans",17,6,17,350,282,68,1,15,248,129,119,2,2008-01-06,1,1,"sdg",11
"Division","Sun","January 13","W","","13-5",FALSE,"Indianapolis Colts",28,24,20,411,312,99,1,29,446,402,44,3,2008-01-13,2,1,"sdg",4
"ConfChamp","Sun","January 20","L","","13-6",FALSE,"New England Patriots",12,21,17,311,207,104,2,25,347,198,149,3,2008-01-20,1,0,"sdg",-9
"1","Sun","September 7","L","","0-1",TRUE,"Carolina Panthers",24,26,17,316,211,105,1,20,388,246,142,1,2008-09-07,0,0,"sdg",-2
"2","Sun","September 14","L","","0-2",FALSE,"Denver Broncos",38,39,19,456,376,80,1,34,486,341,145,1,2008-09-14,0,0,"sdg",-1
"3","Mon","September 22","W","","1-2",TRUE,"New York Jets",48,29,20,357,250,107,1,21,308,267,41,4,2008-09-22,3,1,"sdg",19
"4","Sun","September 28","W","","2-2",FALSE,"Oakland Raiders",28,18,18,295,154,141,2,15,323,251,72,2,2008-09-28,0,1,"sdg",10
"5","Sun","October 5","L","","2-3",FALSE,"Miami Dolphins",10,17,10,202,142,60,0,23,390,223,167,1,2008-10-05,1,0,"sdg",-7
"6","Sun","October 12","W","","3-3",TRUE,"New England Patriots",30,10,19,404,306,98,1,18,299,193,106,1,2008-10-12,0,1,"sdg",20
"7","Sun","October 19","L","","3-4",FALSE,"Buffalo Bills",14,23,15,263,191,72,3,22,370,261,109,0,2008-10-19,-3,0,"sdg",-9
"8","Sun","October 26","L","","3-5",FALSE,"New Orleans Saints",32,37,22,451,341,110,2,28,409,339,70,0,2008-10-26,-2,0,"sdg",-5
"10","Sun","November 9","W","","4-5",TRUE,"Kansas City Chiefs",20,19,23,400,308,92,2,19,339,263,76,0,2008-11-09,-2,1,"sdg",1
"11","Sun","November 16","L","","4-6",FALSE,"Pittsburgh Steelers",10,11,16,218,152,66,2,24,410,286,124,0,2008-11-16,-2,0,"sdg",-1
"12","Sun","November 23","L","","4-7",TRUE,"Indianapolis Colts",20,23,21,394,274,120,1,19,341,250,91,1,2008-11-23,0,0,"sdg",-3
"13","Sun","November 30","L","","4-8",TRUE,"Atlanta Falcons",16,22,12,201,131,70,0,20,348,207,141,3,2008-11-30,3,0,"sdg",-6
"14","Thu","December 4","W","","5-8",TRUE,"Oakland Raiders",34,7,18,372,214,158,1,9,163,109,54,4,2008-12-04,3,1,"sdg",27
"15","Sun","December 14","W","","6-8",FALSE,"Kansas City Chiefs",22,21,22,394,326,68,3,22,277,175,102,2,2008-12-14,-1,1,"sdg",1
"16","Sun","December 21","W","","7-8",FALSE,"Tampa Bay Buccaneers",41,24,8,370,280,90,0,20,342,231,111,3,2008-12-21,3,1,"sdg",17
"17","Sun","December 28","W","","8-8",TRUE,"Denver Broncos",52,21,28,491,202,289,0,25,406,316,90,2,2008-12-28,2,1,"sdg",31
"WildCard","Sat","January 3","W","OT","9-8",TRUE,"Indianapolis Colts",23,17,26,357,190,167,2,17,366,302,64,0,2009-01-03,-2,1,"sdg",6
"Division","Sun","January 11","L","","9-9",FALSE,"Pittsburgh Steelers",24,35,15,290,275,15,2,22,342,177,165,0,2009-01-11,-2,0,"sdg",-11
"1","Mon","September 14","W","","1-0",FALSE,"Oakland Raiders",24,20,19,317,240,77,2,19,366,218,148,3,2009-09-14,1,1,"sdg",4
"2","Sun","September 20","L","","1-1",TRUE,"Baltimore Ravens",26,31,20,474,421,53,2,22,311,181,130,1,2009-09-20,-1,0,"sdg",-5
"3","Sun","September 27","W","","2-1",TRUE,"Miami Dolphins",23,13,19,355,286,69,1,19,289,140,149,2,2009-09-27,1,1,"sdg",10
"4","Sun","October 4","L","","2-2",FALSE,"Pittsburgh Steelers",28,38,17,251,235,16,1,32,497,320,177,1,2009-10-04,0,0,"sdg",-10
"6","Mon","October 19","L","","2-3",TRUE,"Denver Broncos",23,34,20,311,238,73,1,19,328,227,101,0,2009-10-19,-1,0,"sdg",-11
"7","Sun","October 25","W","","3-3",FALSE,"Kansas City Chiefs",37,7,17,403,268,135,0,10,203,82,121,3,2009-10-25,3,1,"sdg",30
"8","Sun","November 1","W","","4-3",TRUE,"Oakland Raiders",24,16,20,346,246,100,2,13,180,81,99,1,2009-11-01,-1,1,"sdg",8
"9","Sun","November 8","W","","5-3",FALSE,"New York Giants",21,20,18,226,192,34,2,19,304,188,116,1,2009-11-08,-1,1,"sdg",1
"10","Sun","November 15","W","","6-3",TRUE,"Philadelphia Eagles",31,23,22,331,212,119,0,26,462,433,29,1,2009-11-15,1,1,"sdg",8
"11","Sun","November 22","W","","7-3",FALSE,"Denver Broncos",32,3,21,348,145,203,0,14,271,156,115,3,2009-11-22,3,1,"sdg",29
"12","Sun","November 29","W","","8-3",TRUE,"Kansas City Chiefs",43,14,26,426,332,94,1,16,284,170,114,4,2009-11-29,3,1,"sdg",29
"13","Sun","December 6","W","","9-3",FALSE,"Cleveland Browns",30,23,21,477,386,91,0,24,372,257,115,1,2009-12-06,1,1,"sdg",7
"14","Sun","December 13","W","","10-3",FALSE,"Dallas Cowboys",20,17,21,341,268,73,1,22,347,239,108,0,2009-12-13,-1,1,"sdg",3
"15","Sun","December 20","W","","11-3",TRUE,"Cincinnati Bengals",27,24,20,366,296,70,2,19,407,293,114,1,2009-12-20,-1,1,"sdg",3
"16","Fri","December 25","W","","12-3",FALSE,"Tennessee Titans",42,17,30,425,259,166,1,17,270,88,182,3,2009-12-25,2,1,"sdg",25
"17","Sun","January 3","W","","13-3",TRUE,"Washington Redskins",23,20,19,364,314,50,1,18,341,275,66,0,2010-01-03,-1,1,"sdg",3
"Division","Sun","January 17","L","","13-4",TRUE,"New York Jets",14,17,18,344,283,61,2,14,262,93,169,1,2010-01-17,-1,0,"sdg",-3
"1","Mon","September 13","L","","0-1",FALSE,"Kansas City Chiefs",14,21,18,389,280,109,1,9,197,62,135,0,2010-09-13,-1,0,"sdg",-7
"2","Sun","September 19","W","","1-1",TRUE,"Jacksonville Jaguars",38,13,25,477,326,151,3,20,350,279,71,6,2010-09-19,3,1,"sdg",25
"3","Sun","September 26","L","","1-2",FALSE,"Seattle Seahawks",20,27,27,518,429,89,5,13,271,203,68,2,2010-09-26,-3,0,"sdg",-7
"4","Sun","October 3","W","","2-2",TRUE,"Arizona Cardinals",41,10,23,419,239,180,1,10,134,87,47,3,2010-10-03,2,1,"sdg",31
"5","Sun","October 10","L","","2-3",FALSE,"Oakland Raiders",27,35,29,506,415,91,3,14,279,168,111,0,2010-10-10,-3,0,"sdg",-8
"6","Sun","October 17","L","","2-4",FALSE,"St. Louis Rams",17,20,22,287,208,79,1,20,300,183,117,0,2010-10-17,-1,0,"sdg",-3
"7","Sun","October 24","L","","2-5",TRUE,"New England Patriots",20,23,23,363,325,38,4,15,179,128,51,0,2010-10-24,-4,0,"sdg",-3
"8","Sun","October 31","W","","3-5",TRUE,"Tennessee Titans",33,25,23,456,300,156,1,15,370,305,65,0,2010-10-31,-1,1,"sdg",8
"9","Sun","November 7","W","","4-5",FALSE,"Houston Texans",29,23,18,367,290,77,2,25,392,252,140,1,2010-11-07,-1,1,"sdg",6
"11","Mon","November 22","W","","5-5",TRUE,"Denver Broncos",35,14,21,400,253,147,1,16,235,172,63,1,2010-11-22,0,1,"sdg",21
"12","Sun","November 28","W","","6-5",FALSE,"Indianapolis Colts",36,14,18,301,172,129,0,16,303,279,24,5,2010-11-28,5,1,"sdg",22
"13","Sun","December 5","L","","6-6",TRUE,"Oakland Raiders",13,28,18,286,265,21,2,22,368,117,251,1,2010-12-05,-1,0,"sdg",-15
"14","Sun","December 12","W","","7-6",TRUE,"Kansas City Chiefs",31,0,25,426,219,207,2,5,67,19,48,0,2010-12-12,-2,1,"sdg",31
"15","Thu","December 16","W","","8-6",TRUE,"San Francisco 49ers",34,7,24,374,266,108,0,11,192,131,61,1,2010-12-16,1,1,"sdg",27
"16","Sun","December 26","L","","8-7",FALSE,"Cincinnati Bengals",20,34,23,313,249,64,2,18,371,269,102,1,2010-12-26,-1,0,"sdg",-14
"17","Sun","January 2","W","","9-7",FALSE,"Denver Broncos",33,28,20,447,283,164,1,18,337,191,146,2,2011-01-02,1,1,"sdg",5
"1","Sun","September 11","W","","1-0",TRUE,"Minnesota Vikings",24,17,31,407,330,77,2,10,187,28,159,1,2011-09-11,-1,1,"sdg",7
"2","Sun","September 18","L","","1-1",FALSE,"New England Patriots",21,35,29,470,372,98,4,28,504,410,94,0,2011-09-18,-4,0,"sdg",-14
"3","Sun","September 25","W","","2-1",TRUE,"Kansas City Chiefs",20,17,22,375,258,117,2,13,252,171,81,1,2011-09-25,-1,1,"sdg",3
"4","Sun","October 2","W","","3-1",TRUE,"Miami Dolphins",26,16,21,411,295,116,0,16,248,176,72,2,2011-10-02,2,1,"sdg",10
"5","Sun","October 9","W","","4-1",FALSE,"Denver Broncos",29,24,25,418,212,206,2,13,275,113,162,1,2011-10-09,-1,1,"sdg",5
"7","Sun","October 23","L","","4-2",FALSE,"New York Jets",21,27,16,268,172,96,2,25,318,156,162,2,2011-10-23,0,0,"sdg",-6
"8","Mon","October 31","L","OT","4-3",FALSE,"Kansas City Chiefs",20,23,22,447,345,102,4,19,341,247,94,4,2011-10-31,0,0,"sdg",-3
"9","Sun","November 6","L","","4-4",TRUE,"Green Bay Packers",38,45,28,460,375,85,3,21,368,232,136,0,2011-11-06,-3,0,"sdg",-7
"10","Thu","November 10","L","","4-5",TRUE,"Oakland Raiders",17,24,20,314,239,75,2,20,489,298,191,2,2011-11-10,0,0,"sdg",-7
"11","Sun","November 20","L","","4-6",FALSE,"Chicago Bears",20,31,15,332,280,52,3,23,378,286,92,1,2011-11-20,-2,0,"sdg",-11
"12","Sun","November 27","L","OT","4-7",TRUE,"Denver Broncos",13,16,20,344,159,185,0,18,349,141,208,0,2011-11-27,0,0,"sdg",-3
"13","Mon","December 5","W","","5-7",FALSE,"Jacksonville Jaguars",38,14,19,433,294,139,0,17,306,177,129,1,2011-12-05,1,1,"sdg",24
"14","Sun","December 11","W","","6-7",TRUE,"Buffalo Bills",37,10,23,366,216,150,1,17,281,185,96,3,2011-12-11,2,1,"sdg",27
"15","Sun","December 18","W","","7-7",TRUE,"Baltimore Ravens",34,14,23,415,270,145,0,19,290,201,89,2,2011-12-18,2,1,"sdg",20
"16","Sat","December 24","L","","7-8",FALSE,"Detroit Lions",10,38,20,367,299,68,2,24,440,353,87,0,2011-12-24,-2,0,"sdg",-28
"17","Sun","January 1","W","","8-8",FALSE,"Oakland Raiders",38,26,25,463,310,153,1,28,520,417,103,1,2012-01-01,0,1,"sdg",12
"1","Sun","September 8","W","","1-0",TRUE,"New York Jets",31,0,19,356,234,122,0,14,193,131,62,2,1985-09-08,2,1,"rai",31
"2","Thu","September 12","L","","1-1",FALSE,"Kansas City Chiefs",20,36,22,340,273,67,5,18,325,241,84,1,1985-09-12,-4,0,"rai",-16
"3","Sun","September 22","L","","1-2",TRUE,"San Francisco 49ers",10,34,20,280,197,83,3,17,352,237,115,2,1985-09-22,-1,0,"rai",-24
"4","Sun","September 29","W","","2-2",FALSE,"New England Patriots",35,20,15,296,152,144,2,13,287,190,97,4,1985-09-29,2,1,"rai",15
"5","Sun","October 6","W","","3-2",TRUE,"Kansas City Chiefs",19,10,17,361,220,141,0,14,262,181,81,1,1985-10-06,1,1,"rai",9
"6","Sun","October 13","W","","4-2",TRUE,"New Orleans Saints",23,13,16,278,165,113,1,15,277,163,114,4,1985-10-13,3,1,"rai",10
"7","Sun","October 20","W","","5-2",FALSE,"Cleveland Browns",21,20,20,319,199,120,2,18,232,123,109,0,1985-10-20,-2,1,"rai",1
"8","Mon","October 28","W","","6-2",TRUE,"San Diego Chargers",34,21,22,408,252,156,3,22,324,274,50,1,1985-10-28,-2,1,"rai",13
"9","Sun","November 3","L","","6-3",FALSE,"Seattle Seahawks",3,33,18,282,131,151,5,15,234,133,101,1,1985-11-03,-4,0,"rai",-30
"10","Sun","November 10","L","OT","6-4",FALSE,"San Diego Chargers",34,40,26,454,289,165,3,29,593,426,167,1,1985-11-10,-2,0,"rai",-6
"11","Sun","November 17","W","","7-4",TRUE,"Cincinnati Bengals",13,6,19,284,132,152,1,13,240,146,94,0,1985-11-17,-1,1,"rai",7
"12","Sun","November 24","W","OT","8-4",TRUE,"Denver Broncos",31,28,21,424,223,201,3,25,291,138,153,1,1985-11-24,-2,1,"rai",3
"13","Sun","December 1","W","","9-4",FALSE,"Atlanta Falcons",34,24,20,388,211,177,1,16,365,235,130,3,1985-12-01,2,1,"rai",10
"14","Sun","December 8","W","OT","10-4",FALSE,"Denver Broncos",17,14,20,274,93,181,5,17,207,120,87,4,1985-12-08,-1,1,"rai",3
"15","Sun","December 15","W","","11-4",TRUE,"Seattle Seahawks",13,3,16,349,195,154,2,12,201,150,51,4,1985-12-15,2,1,"rai",10
"16","Mon","December 23","W","","12-4",FALSE,"Los Angeles Rams",16,6,13,315,180,135,2,15,220,110,110,1,1985-12-23,-1,1,"rai",10
"Division","Sun","January 5","L","","12-5",TRUE,"New England Patriots",20,27,17,287,124,163,6,15,254,98,156,2,1986-01-05,-4,0,"rai",-7
"1","Sun","September 7","L","","0-1",FALSE,"Denver Broncos",36,38,22,431,315,116,3,20,290,235,55,1,1986-09-07,-2,0,"rai",-2
"2","Sun","September 14","L","","0-2",FALSE,"Washington Redskins",6,10,18,266,128,138,3,14,271,175,96,2,1986-09-14,-1,0,"rai",-4
"3","Sun","September 21","L","","0-3",TRUE,"New York Giants",9,14,14,318,260,58,2,18,334,205,129,2,1986-09-21,0,0,"rai",-5
"4","Sun","September 28","W","","1-3",TRUE,"San Diego Chargers",17,13,21,377,276,101,5,16,256,200,56,4,1986-09-28,-1,1,"rai",4
"5","Sun","October 5","W","","2-3",FALSE,"Kansas City Chiefs",24,17,18,270,168,102,2,15,181,84,97,2,1986-10-05,0,1,"rai",7
"6","Sun","October 12","W","","3-3",TRUE,"Seattle Seahawks",14,10,18,323,185,138,2,12,211,120,91,0,1986-10-12,-2,1,"rai",4
"7","Sun","October 19","W","","4-3",FALSE,"Miami Dolphins",30,28,19,315,101,214,0,17,330,273,57,4,1986-10-19,4,1,"rai",2
"8","Sun","October 26","W","","5-3",FALSE,"Houston Oilers",28,17,21,352,218,134,2,18,335,253,82,5,1986-10-26,3,1,"rai",11
"9","Sun","November 2","L","","5-4",TRUE,"Denver Broncos",10,21,25,407,326,81,6,11,246,132,114,1,1986-11-02,-5,0,"rai",-11
"10","Sun","November 9","W","","6-4",FALSE,"Dallas Cowboys",17,13,15,246,116,130,4,20,313,147,166,6,1986-11-09,2,1,"rai",4
"11","Sun","November 16","W","","7-4",TRUE,"Cleveland Browns",27,14,16,323,202,121,1,8,217,145,72,2,1986-11-16,1,1,"rai",13
"12","Thu","November 20","W","OT","8-4",FALSE,"San Diego Chargers",37,31,25,466,327,139,2,30,392,263,129,4,1986-11-20,2,1,"rai",6
"13","Sun","November 30","L","OT","8-5",TRUE,"Philadelphia Eagles",27,33,16,379,318,61,4,22,347,241,106,2,1986-11-30,-2,0,"rai",-6
"14","Mon","December 8","L","","8-6",FALSE,"Seattle Seahawks",0,37,10,138,98,40,3,21,407,224,183,1,1986-12-08,-2,0,"rai",-37
"15","Sun","December 14","L","","8-7",TRUE,"Kansas City Chiefs",17,20,19,265,137,128,7,18,263,164,99,0,1986-12-14,-7,0,"rai",-3
"16","Sun","December 21","L","","8-8",TRUE,"Indianapolis Colts",24,30,25,423,334,89,3,23,411,215,196,2,1986-12-21,-1,0,"rai",-6
"1","Sun","September 13","W","","1-0",FALSE,"Green Bay Packers",20,0,21,293,100,193,0,9,147,81,66,3,1987-09-13,3,1,"rai",20
"2","Sun","September 20","W","","2-0",TRUE,"Detroit Lions",27,7,25,405,234,171,1,16,291,244,47,3,1987-09-20,2,1,"rai",20
"3","Sun","October 4","W","","3-0",TRUE,"Kansas City Chiefs",35,17,21,500,248,252,2,22,268,137,131,3,1987-10-04,1,1,"rai",18
"4","Mon","October 12","L","","3-1",FALSE,"Denver Broncos",14,30,16,270,168,102,5,24,346,142,204,2,1987-10-12,-3,0,"rai",-16
"5","Sun","October 18","L","","3-2",TRUE,"San Diego Chargers",17,23,19,314,176,138,3,14,244,147,97,0,1987-10-18,-3,0,"rai",-6
"6","Sun","October 25","L","","3-3",TRUE,"Seattle Seahawks",13,35,18,250,206,44,3,21,293,149,144,2,1987-10-25,-1,0,"rai",-22
"7","Sun","November 1","L","","3-4",FALSE,"New England Patriots",23,26,19,330,249,81,2,20,406,296,110,1,1987-11-01,-1,0,"rai",-3
"8","Sun","November 8","L","","3-5",FALSE,"Minnesota Vikings",20,31,19,376,219,157,5,13,200,84,116,1,1987-11-08,-4,0,"rai",-11
"9","Sun","November 15","L","","3-6",FALSE,"San Diego Chargers",14,16,12,365,215,150,2,16,248,134,114,1,1987-11-15,-1,0,"rai",-2
"10","Sun","November 22","L","","3-7",TRUE,"Denver Broncos",17,23,17,271,122,149,1,20,403,276,127,1,1987-11-22,0,0,"rai",-6
"11","Mon","November 30","W","","4-7",FALSE,"Seattle Seahawks",37,14,24,507,151,356,1,14,167,130,37,3,1987-11-30,2,1,"rai",23
"12","Sun","December 6","W","","5-7",TRUE,"Buffalo Bills",34,21,29,494,350,144,0,19,387,303,84,1,1987-12-06,1,1,"rai",13
"13","Sun","December 13","L","","5-8",FALSE,"Kansas City Chiefs",10,16,26,400,312,88,4,17,276,164,112,2,1987-12-13,-2,0,"rai",-6
"14","Sun","December 20","L","","5-9",TRUE,"Cleveland Browns",17,24,20,299,228,71,1,24,421,294,127,2,1987-12-20,1,0,"rai",-7
"15","Sun","December 27","L","","5-10",TRUE,"Chicago Bears",3,6,14,193,92,101,1,18,267,146,121,3,1987-12-27,2,0,"rai",-3
"1","Sun","September 4","W","","1-0",TRUE,"San Diego Chargers",24,13,18,277,183,94,1,15,263,152,111,1,1988-09-04,0,1,"rai",11
"2","Sun","September 11","L","","1-1",FALSE,"Houston Oilers",35,38,17,158,84,74,2,29,406,250,156,3,1988-09-11,1,0,"rai",-3
"3","Sun","September 18","L","","1-2",TRUE,"Los Angeles Rams",17,22,18,408,305,103,1,16,313,173,140,1,1988-09-18,0,0,"rai",-5
"4","Mon","September 26","W","OT","2-2",FALSE,"Denver Broncos",30,27,20,363,235,128,1,23,398,209,189,5,1988-09-26,4,1,"rai",3
"5","Sun","October 2","L","","2-3",TRUE,"Cincinnati Bengals",21,45,20,405,309,96,5,28,496,332,164,1,1988-10-02,-4,0,"rai",-24
"6","Sun","October 9","L","","2-4",TRUE,"Miami Dolphins",14,24,19,344,266,78,5,19,266,175,91,1,1988-10-09,-4,0,"rai",-10
"7","Sun","October 16","W","","3-4",FALSE,"Kansas City Chiefs",27,17,20,233,119,114,0,16,334,241,93,4,1988-10-16,4,1,"rai",10
"8","Sun","October 23","L","","3-5",FALSE,"New Orleans Saints",6,20,16,367,182,185,3,14,317,127,190,0,1988-10-23,-3,0,"rai",-14
"9","Sun","October 30","W","","4-5",TRUE,"Kansas City Chiefs",17,10,23,404,248,156,2,17,208,63,145,0,1988-10-30,-2,1,"rai",7
"10","Sun","November 6","W","","5-5",FALSE,"San Diego Chargers",13,3,18,306,170,136,2,12,216,153,63,3,1988-11-06,1,1,"rai",10
"11","Sun","November 13","W","","6-5",FALSE,"San Francisco 49ers",9,3,17,251,92,159,1,15,219,136,83,2,1988-11-13,1,1,"rai",6
"12","Sun","November 20","L","","6-6",TRUE,"Atlanta Falcons",6,12,9,212,147,65,2,17,280,150,130,2,1988-11-20,0,0,"rai",-6
"13","Mon","November 28","L","","6-7",FALSE,"Seattle Seahawks",27,35,15,257,144,113,2,25,459,212,247,5,1988-11-28,3,0,"rai",-8
"14","Sun","December 4","W","","7-7",TRUE,"Denver Broncos",21,20,14,216,87,129,2,20,347,297,50,3,1988-12-04,1,1,"rai",1
"15","Sun","December 11","L","","7-8",FALSE,"Buffalo Bills",21,37,17,318,207,111,3,24,367,112,255,0,1988-12-11,-3,0,"rai",-16
"16","Sun","December 18","L","","7-9",TRUE,"Seattle Seahawks",37,43,22,442,331,111,1,20,490,389,101,3,1988-12-18,2,0,"rai",-6
"1","Sun","September 10","W","","1-0",TRUE,"San Diego Chargers",40,14,23,418,258,160,1,16,305,134,171,1,1989-09-10,0,1,"rai",26
"2","Sun","September 17","L","","1-1",FALSE,"Kansas City Chiefs",19,24,18,268,153,115,1,23,323,171,152,1,1989-09-17,0,0,"rai",-5
"3","Sun","September 24","L","","1-2",FALSE,"Denver Broncos",21,31,15,360,270,90,6,18,283,113,170,3,1989-09-24,-3,0,"rai",-10
"4","Sun","October 1","L","","1-3",TRUE,"Seattle Seahawks",20,24,16,311,197,114,2,25,354,194,160,2,1989-10-01,0,0,"rai",-4
"5","Mon","October 9","W","","2-3",FALSE,"New York Jets",14,7,14,315,185,130,1,20,392,302,90,2,1989-10-09,1,1,"rai",7
"6","Sun","October 15","W","","3-3",TRUE,"Kansas City Chiefs",20,14,13,246,89,157,2,17,305,227,78,4,1989-10-15,2,1,"rai",6
"7","Sun","October 22","L","","3-4",FALSE,"Philadelphia Eagles",7,10,20,268,142,126,2,13,195,63,132,0,1989-10-22,-2,0,"rai",-3
"8","Sun","October 29","W","","4-4",TRUE,"Washington Redskins",37,24,18,342,155,187,4,22,441,420,21,8,1989-10-29,4,1,"rai",13
"9","Sun","November 5","W","","5-4",TRUE,"Cincinnati Bengals",28,7,12,429,223,206,1,20,350,196,154,3,1989-11-05,2,1,"rai",21
"10","Sun","November 12","L","","5-5",FALSE,"San Diego Chargers",12,14,15,295,161,134,3,12,202,66,136,2,1989-11-12,-1,0,"rai",-2
"11","Sun","November 19","L","","5-6",FALSE,"Houston Oilers",7,23,12,243,169,74,5,23,419,249,170,2,1989-11-19,-3,0,"rai",-16
"12","Sun","November 26","W","","6-6",TRUE,"New England Patriots",24,21,19,268,136,132,0,13,224,194,30,3,1989-11-26,3,1,"rai",3
"13","Sun","December 3","W","OT","7-6",TRUE,"Denver Broncos",16,13,11,257,178,79,1,26,332,176,156,2,1989-12-03,1,1,"rai",3
"14","Sun","December 10","W","","8-6",TRUE,"Phoenix Cardinals",16,14,19,384,230,154,1,18,248,126,122,2,1989-12-10,1,1,"rai",2
"15","Sun","December 17","L","","8-7",FALSE,"Seattle Seahawks",17,23,15,273,175,98,1,22,350,268,82,0,1989-12-17,-1,0,"rai",-6
"16","Sun","December 24","L","","8-8",FALSE,"New York Giants",17,34,19,312,230,82,3,20,280,164,116,1,1989-12-24,-2,0,"rai",-17
"1","Sun","September 9","W","","1-0",TRUE,"Denver Broncos",14,9,12,194,71,123,2,13,196,157,39,4,1990-09-09,2,1,"rai",5
"2","Sun","September 16","W","","2-0",FALSE,"Seattle Seahawks",17,13,16,326,235,91,0,23,344,222,122,1,1990-09-16,1,1,"rai",4
"3","Sun","September 23","W","","3-0",TRUE,"Pittsburgh Steelers",20,3,16,273,148,125,1,18,208,118,90,3,1990-09-23,2,1,"rai",17
"4","Sun","September 30","W","","4-0",TRUE,"Chicago Bears",24,10,18,326,170,156,2,11,229,128,101,1,1990-09-30,-1,1,"rai",14
"5","Sun","October 7","L","","4-1",FALSE,"Buffalo Bills",24,38,22,347,225,122,4,14,280,182,98,2,1990-10-07,-2,0,"rai",-14
"6","Sun","October 14","W","","5-1",TRUE,"Seattle Seahawks",24,17,19,305,227,78,1,19,342,265,77,2,1990-10-14,1,1,"rai",7
"7","Sun","October 21","W","","6-1",FALSE,"San Diego Chargers",24,9,17,289,173,116,1,16,289,150,139,0,1990-10-21,-1,1,"rai",15
"9","Sun","November 4","L","","6-2",FALSE,"Kansas City Chiefs",7,9,12,234,138,96,3,11,169,45,124,1,1990-11-04,-2,0,"rai",-2
"10","Sun","November 11","L","","6-3",TRUE,"Green Bay Packers",16,29,12,165,112,53,4,20,256,155,101,1,1990-11-11,-3,0,"rai",-13
"11","Mon","November 19","W","","7-3",FALSE,"Miami Dolphins",13,10,18,293,116,177,0,16,213,199,14,0,1990-11-19,0,1,"rai",3
"12","Sun","November 25","L","","7-4",TRUE,"Kansas City Chiefs",24,27,20,366,211,155,3,16,239,142,97,0,1990-11-25,-3,0,"rai",-3
"13","Sun","December 2","W","","8-4",FALSE,"Denver Broncos",23,20,17,293,145,148,0,20,357,216,141,1,1990-12-02,1,1,"rai",3
"14","Mon","December 10","W","","9-4",FALSE,"Detroit Lions",38,31,16,350,186,164,2,19,368,171,197,2,1990-12-10,0,1,"rai",7
"15","Sun","December 16","W","","10-4",TRUE,"Cincinnati Bengals",24,7,13,348,163,185,1,11,251,142,109,2,1990-12-16,1,1,"rai",17
"16","Sat","December 22","W","","11-4",FALSE,"Minnesota Vikings",28,24,15,359,234,125,0,25,401,314,87,1,1990-12-22,1,1,"rai",4
"17","Sun","December 30","W","","12-4",TRUE,"San Diego Chargers",17,12,15,248,134,114,0,14,271,91,180,1,1990-12-30,1,1,"rai",5
"Division","Sun","January 13","W","","13-4",TRUE,"Cincinnati Bengals",20,10,20,389,154,235,1,12,182,58,124,0,1991-01-13,-1,1,"rai",10
"ConfChamp","Sun","January 20","L","","13-5",FALSE,"Buffalo Bills",3,51,21,320,169,151,7,30,502,300,202,1,1991-01-20,-6,0,"rai",-48
"1","Sun","September 1","L","","0-1",FALSE,"Houston Oilers",17,47,11,286,224,62,4,25,459,240,219,1,1991-09-01,-3,0,"rai",-30
"2","Sun","September 8","W","","1-1",TRUE,"Denver Broncos",16,13,16,273,140,133,0,12,247,214,33,1,1991-09-08,1,1,"rai",3
"3","Sun","September 15","W","","2-1",TRUE,"Indianapolis Colts",16,0,15,268,153,115,0,16,266,193,73,2,1991-09-15,2,1,"rai",16
"4","Sun","September 22","L","","2-2",FALSE,"Atlanta Falcons",17,21,12,159,87,72,3,16,320,240,80,4,1991-09-22,1,0,"rai",-4
"5","Sun","September 29","W","","3-2",TRUE,"San Francisco 49ers",12,6,18,220,127,93,1,17,339,213,126,2,1991-09-29,1,1,"rai",6
"6","Sun","October 6","L","","3-3",TRUE,"San Diego Chargers",13,21,16,277,178,99,3,17,258,100,158,0,1991-10-06,-3,0,"rai",-8
"7","Sun","October 13","W","OT","4-3",FALSE,"Seattle Seahawks",23,20,25,420,274,146,5,12,264,145,119,3,1991-10-13,-2,1,"rai",3
"8","Sun","October 20","W","","5-3",TRUE,"Los Angeles Rams",20,17,18,339,255,84,2,21,347,294,53,3,1991-10-20,1,1,"rai",3
"9","Mon","October 28","L","","5-4",FALSE,"Kansas City Chiefs",21,24,15,322,249,73,3,19,267,148,119,1,1991-10-28,-2,0,"rai",-3
"11","Sun","November 10","W","","6-4",FALSE,"Denver Broncos",17,16,13,244,126,118,0,23,383,183,200,3,1991-11-10,3,1,"rai",1
"12","Sun","November 17","W","","7-4",TRUE,"Seattle Seahawks",31,7,20,342,226,116,1,13,185,162,23,1,1991-11-17,0,1,"rai",24
"13","Sun","November 24","W","","8-4",FALSE,"Cincinnati Bengals",38,14,14,176,19,157,1,21,279,114,165,5,1991-11-24,4,1,"rai",24
"14","Sun","December 1","W","","9-4",FALSE,"San Diego Chargers",9,7,14,283,122,161,3,12,199,124,75,3,1991-12-01,0,1,"rai",2
"15","Sun","December 8","L","OT","9-5",TRUE,"Buffalo Bills",27,30,18,386,250,136,3,25,409,330,79,1,1991-12-08,-2,0,"rai",-3
"16","Mon","December 16","L","","9-6",FALSE,"New Orleans Saints",0,27,6,117,46,71,2,26,475,314,161,1,1991-12-16,-1,0,"rai",-27
"17","Sun","December 22","L","","9-7",TRUE,"Kansas City Chiefs",21,27,17,313,243,70,0,30,468,262,206,0,1991-12-22,0,0,"rai",-6
"WildCard","Sat","December 28","L","","9-8",FALSE,"Kansas City Chiefs",6,10,16,276,124,152,6,16,204,73,131,2,1991-12-28,-4,0,"rai",-4
"1","Sun","September 6","L","","0-1",FALSE,"Denver Broncos",13,17,20,313,161,152,5,12,200,153,47,3,1992-09-06,-2,0,"rai",-4
"2","Sun","September 13","L","OT","0-2",FALSE,"Cincinnati Bengals",21,24,22,454,367,87,3,19,332,154,178,0,1992-09-13,-3,0,"rai",-3
"3","Sun","September 20","L","","0-3",TRUE,"Cleveland Browns",16,28,27,464,354,110,5,7,231,200,31,0,1992-09-20,-5,0,"rai",-12
"4","Mon","September 28","L","","0-4",FALSE,"Kansas City Chiefs",7,27,13,218,128,90,2,17,241,61,180,1,1992-09-28,-1,0,"rai",-20
"5","Sun","October 4","W","","1-4",TRUE,"New York Giants",13,10,14,300,219,81,1,20,278,173,105,1,1992-10-04,0,1,"rai",3
"6","Sun","October 11","W","","2-4",TRUE,"Buffalo Bills",20,3,16,248,156,92,2,22,350,258,92,2,1992-10-11,0,1,"rai",17
"7","Sun","October 18","W","","3-4",FALSE,"Seattle Seahawks",19,0,11,248,69,179,1,14,237,196,41,2,1992-10-18,1,1,"rai",19
"8","Sun","October 25","L","","3-5",TRUE,"Dallas Cowboys",13,28,12,165,94,71,1,23,369,207,162,0,1992-10-25,-1,0,"rai",-15
"10","Sun","November 8","L","","3-6",FALSE,"Philadelphia Eagles",10,31,14,215,125,90,5,16,267,139,128,1,1992-11-08,-4,0,"rai",-21
"11","Sun","November 15","W","","4-6",TRUE,"Seattle Seahawks",20,3,12,188,88,100,1,10,159,46,113,2,1992-11-15,1,1,"rai",17
"12","Sun","November 22","W","","5-6",TRUE,"Denver Broncos",24,0,20,317,150,167,0,15,267,182,85,3,1992-11-22,3,1,"rai",24
"13","Sun","November 29","L","","5-7",FALSE,"San Diego Chargers",3,27,15,324,170,154,2,20,333,164,169,1,1992-11-29,-1,0,"rai",-24
"14","Sun","December 6","W","","6-7",TRUE,"Kansas City Chiefs",28,7,15,230,79,151,2,12,265,248,17,2,1992-12-06,0,1,"rai",21
"15","Mon","December 14","L","","6-8",FALSE,"Miami Dolphins",7,20,9,151,78,73,2,20,360,228,132,1,1992-12-14,-1,0,"rai",-13
"16","Sun","December 20","L","","6-9",TRUE,"San Diego Chargers",14,36,14,167,118,49,3,19,332,228,104,0,1992-12-20,-3,0,"rai",-22
"17","Sat","December 26","W","","7-9",FALSE,"Washington Redskins",21,20,25,382,234,148,3,18,295,196,99,0,1992-12-26,-3,1,"rai",1
"1","Sun","September 5","W","","1-0",TRUE,"Minnesota Vikings",24,7,19,312,214,98,1,18,205,147,58,3,1993-09-05,2,1,"rai",17
"2","Sun","September 12","W","","2-0",FALSE,"Seattle Seahawks",17,13,16,264,181,83,1,14,232,120,112,3,1993-09-12,2,1,"rai",4
"3","Sun","September 19","L","","2-1",TRUE,"Cleveland Browns",16,19,11,156,85,71,0,20,316,203,113,4,1993-09-19,4,0,"rai",-3
"5","Sun","October 3","L","","2-2",FALSE,"Kansas City Chiefs",9,24,15,222,146,76,1,26,242,127,115,0,1993-10-03,-1,0,"rai",-15
"6","Sun","October 10","W","","3-2",TRUE,"New York Jets",24,20,22,414,309,105,5,21,286,190,96,2,1993-10-10,-3,1,"rai",4
"7","Mon","October 18","W","","4-2",FALSE,"Denver Broncos",23,20,12,308,255,53,2,18,253,121,132,2,1993-10-18,0,1,"rai",3
"9","Sun","October 31","L","","4-3",TRUE,"San Diego Chargers",23,30,20,467,402,65,2,17,336,159,177,0,1993-10-31,-2,0,"rai",-7
"10","Sun","November 7","W","","5-3",FALSE,"Chicago Bears",16,14,20,274,95,179,0,19,261,137,124,1,1993-11-07,1,1,"rai",2
"11","Sun","November 14","L","","5-4",TRUE,"Kansas City Chiefs",20,31,22,280,178,102,2,21,338,174,164,1,1993-11-14,-1,0,"rai",-11
"12","Sun","November 21","W","","6-4",FALSE,"San Diego Chargers",12,7,24,428,270,158,2,13,154,95,59,1,1993-11-21,-1,1,"rai",5
"13","Sun","November 28","L","","6-5",FALSE,"Cincinnati Bengals",10,16,16,283,202,81,2,14,264,133,131,0,1993-11-28,-2,0,"rai",-6
"14","Sun","December 5","W","","7-5",FALSE,"Buffalo Bills",25,24,25,399,261,138,0,19,367,276,91,2,1993-12-05,2,1,"rai",1
"15","Sun","December 12","W","","8-5",TRUE,"Seattle Seahawks",27,23,18,362,303,59,2,21,303,169,134,1,1993-12-12,-1,1,"rai",4
"16","Sun","December 19","W","","9-5",TRUE,"Tampa Bay Buccaneers",27,20,17,265,248,17,0,24,366,265,101,2,1993-12-19,2,1,"rai",7
"17","Sun","December 26","L","","9-6",FALSE,"Green Bay Packers",0,28,11,182,136,46,4,17,329,181,148,1,1993-12-26,-3,0,"rai",-28
"18","Sun","January 2","W","OT","10-6",TRUE,"Denver Broncos",33,30,24,398,304,94,1,22,471,361,110,0,1994-01-02,-1,1,"rai",3
"WildCard","Sun","January 9","W","","11-6",TRUE,"Denver Broncos",42,24,19,427,291,136,0,26,387,331,56,1,1994-01-09,1,1,"rai",18
"Division","Sat","January 15","L","","11-7",FALSE,"Buffalo Bills",23,29,15,325,215,110,1,25,355,280,75,1,1994-01-15,0,0,"rai",-6
"1","Mon","September 5","L","","0-1",FALSE,"San Francisco 49ers",14,44,12,181,147,34,2,24,448,292,156,1,1994-09-05,-1,0,"rai",-30
"2","Sun","September 11","L","","0-2",TRUE,"Seattle Seahawks",9,38,20,297,198,99,4,22,332,235,97,1,1994-09-11,-3,0,"rai",-29
"3","Sun","September 18","W","","1-2",FALSE,"Denver Broncos",48,16,20,424,322,102,1,21,292,223,69,3,1994-09-18,2,1,"rai",32
"4","Sun","September 25","L","","1-3",TRUE,"San Diego Chargers",24,26,15,279,220,59,1,17,263,179,84,2,1994-09-25,1,0,"rai",-2
"6","Sun","October 9","W","","2-3",FALSE,"New England Patriots",21,17,14,328,242,86,4,25,359,305,54,4,1994-10-09,0,1,"rai",4
"7","Sun","October 16","L","OT","2-4",FALSE,"Miami Dolphins",17,20,12,210,86,124,1,19,344,175,169,3,1994-10-16,2,0,"rai",-3
"8","Sun","October 23","W","","3-4",TRUE,"Atlanta Falcons",30,17,21,313,197,116,1,15,255,185,70,2,1994-10-23,1,1,"rai",13
"9","Sun","October 30","W","","4-4",TRUE,"Houston Oilers",17,14,16,278,144,134,4,21,302,203,99,3,1994-10-30,-1,1,"rai",3
"10","Sun","November 6","L","","4-5",FALSE,"Kansas City Chiefs",3,13,15,248,148,100,3,11,252,159,93,0,1994-11-06,-3,0,"rai",-10
"11","Sun","November 13","W","","5-5",FALSE,"Los Angeles Rams",20,17,18,303,208,95,1,20,290,268,22,1,1994-11-13,0,1,"rai",3
"12","Sun","November 20","W","","6-5",TRUE,"New Orleans Saints",24,19,22,428,307,121,4,16,246,230,16,1,1994-11-20,-3,1,"rai",5
"13","Sun","November 27","L","","6-6",TRUE,"Pittsburgh Steelers",3,21,14,179,122,57,2,19,306,131,175,0,1994-11-27,-2,0,"rai",-18
"14","Mon","December 5","W","","7-6",FALSE,"San Diego Chargers",24,17,22,410,322,88,1,18,261,214,47,1,1994-12-05,0,1,"rai",7
"15","Sun","December 11","W","","8-6",TRUE,"Denver Broncos",23,13,16,305,177,128,0,16,291,228,63,2,1994-12-11,2,1,"rai",10
"16","Sun","December 18","W","","9-6",FALSE,"Seattle Seahawks",17,16,16,322,206,116,0,15,280,155,125,0,1994-12-18,0,1,"rai",1
"17","Sat","December 24","L","","9-7",TRUE,"Kansas City Chiefs",9,19,14,274,221,53,1,24,422,218,204,1,1994-12-24,0,0,"rai",-10
"1","Sun","September 3","W","","1-0",TRUE,"San Diego Chargers",17,7,19,247,108,139,0,20,371,294,77,3,1995-09-03,3,1,"rai",10
"2","Sun","September 10","W","","2-0",FALSE,"Washington Redskins",20,8,25,358,205,153,1,15,358,260,98,3,1995-09-10,2,1,"rai",12
"3","Sun","September 17","L","OT","2-1",FALSE,"Kansas City Chiefs",17,23,21,344,193,151,3,14,262,141,121,1,1995-09-17,-2,0,"rai",-6
"4","Sun","September 24","W","","3-1",TRUE,"Philadelphia Eagles",48,17,28,439,331,108,4,17,236,129,107,5,1995-09-24,1,1,"rai",31
"5","Sun","October 1","W","","4-1",FALSE,"New York Jets",47,10,25,457,237,220,0,15,241,147,94,3,1995-10-01,3,1,"rai",37
"6","Sun","October 8","W","","5-1",TRUE,"Seattle Seahawks",34,14,24,530,335,195,0,19,343,227,116,2,1995-10-08,2,1,"rai",20
"7","Mon","October 16","L","","5-2",FALSE,"Denver Broncos",0,27,10,169,148,21,4,24,475,351,124,3,1995-10-16,-1,0,"rai",-27
"8","Sun","October 22","W","","6-2",TRUE,"Indianapolis Colts",30,17,18,396,322,74,2,13,254,163,91,2,1995-10-22,0,1,"rai",13
"10","Sun","November 5","W","","7-2",FALSE,"Cincinnati Bengals",20,17,16,352,168,184,1,14,240,121,119,3,1995-11-05,2,1,"rai",3
"11","Sun","November 12","W","","8-2",FALSE,"New York Giants",17,13,20,299,146,153,1,15,267,191,76,1,1995-11-12,0,1,"rai",4
"12","Sun","November 19","L","","8-3",TRUE,"Dallas Cowboys",21,34,32,449,309,140,3,25,336,223,113,1,1995-11-19,-2,0,"rai",-13
"13","Mon","November 27","L","","8-4",FALSE,"San Diego Chargers",6,12,16,284,164,120,4,17,282,204,78,0,1995-11-27,-4,0,"rai",-6
"14","Sun","December 3","L","","8-5",TRUE,"Kansas City Chiefs",23,29,20,333,325,8,4,16,308,121,187,1,1995-12-03,-3,0,"rai",-6
"15","Sun","December 10","L","","8-6",TRUE,"Pittsburgh Steelers",10,29,9,190,162,28,4,21,355,211,144,2,1995-12-10,-2,0,"rai",-19
"16","Sun","December 17","L","","8-7",FALSE,"Seattle Seahawks",10,44,15,322,182,140,1,18,339,220,119,0,1995-12-17,-1,0,"rai",-34
"17","Sun","December 24","L","","8-8",TRUE,"Denver Broncos",28,31,19,336,238,98,2,30,437,307,130,3,1995-12-24,1,0,"rai",-3
"1","Sun","September 1","L","","0-1",FALSE,"Baltimore Ravens",14,19,13,238,178,60,2,21,314,219,95,1,1996-09-01,-1,0,"rai",-5
"2","Sun","September 8","L","","0-2",FALSE,"Kansas City Chiefs",3,19,22,296,160,136,2,16,246,121,125,0,1996-09-08,-2,0,"rai",-16
"3","Sun","September 15","W","","1-2",TRUE,"Jacksonville Jaguars",17,3,18,331,197,134,3,14,270,201,69,2,1996-09-15,-1,1,"rai",14
"4","Sun","September 22","L","","1-3",TRUE,"San Diego Chargers",34,40,28,553,371,182,3,20,321,218,103,0,1996-09-22,-3,0,"rai",-6
"5","Sun","September 29","L","","1-4",FALSE,"Chicago Bears",17,19,17,283,166,117,4,15,296,188,108,0,1996-09-29,-4,0,"rai",-2
"6","Sun","October 6","W","","2-4",FALSE,"New York Jets",34,13,26,404,182,222,1,20,282,171,111,2,1996-10-06,1,1,"rai",21
"7","Sun","October 13","W","","3-4",TRUE,"Detroit Lions",37,21,20,419,295,124,0,23,396,333,63,2,1996-10-13,2,1,"rai",16
"8","Mon","October 21","W","","4-4",FALSE,"San Diego Chargers",23,14,22,310,179,131,1,16,282,253,29,3,1996-10-21,2,1,"rai",9
"10","Mon","November 4","L","","4-5",TRUE,"Denver Broncos",21,22,17,321,216,105,0,18,312,160,152,1,1996-11-04,1,0,"rai",-1
"11","Sun","November 10","L","OT","4-6",FALSE,"Tampa Bay Buccaneers",17,20,17,271,182,89,1,27,339,177,162,2,1996-11-10,1,0,"rai",-3
"12","Sun","November 17","L","OT","4-7",TRUE,"Minnesota Vikings",13,16,13,237,112,125,1,20,445,263,182,2,1996-11-17,1,0,"rai",-3
"13","Sun","November 24","W","","5-7",FALSE,"Seattle Seahawks",27,21,19,349,149,200,1,17,296,166,130,1,1996-11-24,0,1,"rai",6
"14","Sun","December 1","W","","6-7",TRUE,"Miami Dolphins",17,7,20,314,158,156,1,21,315,281,34,4,1996-12-01,3,1,"rai",10
"15","Mon","December 9","W","","7-7",TRUE,"Kansas City Chiefs",26,7,15,315,145,170,0,13,169,71,98,1,1996-12-09,1,1,"rai",19
"16","Sun","December 15","L","","7-8",FALSE,"Denver Broncos",19,24,18,255,150,105,4,23,285,186,99,3,1996-12-15,-1,0,"rai",-5
"17","Sun","December 22","L","","7-9",TRUE,"Seattle Seahawks",21,28,21,356,238,118,7,8,129,13,116,2,1996-12-22,-5,0,"rai",-7
"1","Sun","August 31","L","OT","0-1",FALSE,"Tennessee Oilers",21,24,17,332,287,45,1,20,419,164,255,2,1997-08-31,1,0,"rai",-3
"2","Mon","September 8","L","","0-2",TRUE,"Kansas City Chiefs",27,28,22,389,281,108,2,21,428,300,128,3,1997-09-08,1,0,"rai",-1
"3","Sun","September 14","W","","1-2",FALSE,"Atlanta Falcons",36,31,11,414,265,149,1,24,366,250,116,2,1997-09-14,1,1,"rai",5
"4","Sun","September 21","L","","1-3",FALSE,"New York Jets",22,23,26,468,339,129,0,16,303,220,83,1,1997-09-21,1,0,"rai",-1
"5","Sun","September 28","W","","2-3",TRUE,"St. Louis Rams",35,17,20,383,213,170,2,20,374,255,119,3,1997-09-28,1,1,"rai",18
"6","Sun","October 5","L","","2-4",TRUE,"San Diego Chargers",10,25,11,241,228,13,1,23,398,218,180,0,1997-10-05,-1,0,"rai",-15
"8","Sun","October 19","W","","3-4",TRUE,"Denver Broncos",28,25,12,324,81,243,2,25,441,294,147,1,1997-10-19,-1,1,"rai",3
"9","Sun","October 26","L","","3-5",FALSE,"Seattle Seahawks",34,45,19,354,235,119,1,26,554,409,145,2,1997-10-26,1,0,"rai",-11
"10","Sun","November 2","L","","3-6",FALSE,"Carolina Panthers",14,38,20,357,319,38,2,27,408,192,216,0,1997-11-02,-2,0,"rai",-24
"11","Sun","November 9","L","","3-7",TRUE,"New Orleans Saints",10,13,12,221,189,32,2,17,213,154,59,1,1997-11-09,-1,0,"rai",-3
"12","Sun","November 16","W","","4-7",FALSE,"San Diego Chargers",38,13,22,365,225,140,2,11,248,157,91,2,1997-11-16,0,1,"rai",25
"13","Mon","November 24","L","","4-8",FALSE,"Denver Broncos",3,31,14,260,150,110,2,23,370,260,110,1,1997-11-24,-1,0,"rai",-28
"14","Sun","November 30","L","","4-9",TRUE,"Miami Dolphins",16,34,18,326,212,114,2,23,378,241,137,2,1997-11-30,0,0,"rai",-18
"15","Sun","December 7","L","","4-10",FALSE,"Kansas City Chiefs",0,30,5,93,57,36,1,27,418,204,214,0,1997-12-07,-1,0,"rai",-30
"16","Sun","December 14","L","","4-11",TRUE,"Seattle Seahawks",21,22,15,275,241,34,2,22,381,278,103,2,1997-12-14,0,0,"rai",-1
"17","Sun","December 21","L","","4-12",TRUE,"Jacksonville Jaguars",9,20,19,300,192,108,1,20,417,274,143,0,1997-12-21,-1,0,"rai",-11
"1","Sun","September 6","L","","0-1",FALSE,"Kansas City Chiefs",8,28,18,264,212,52,5,18,300,157,143,0,1998-09-06,-5,0,"rai",-20
"2","Sun","September 13","W","","1-1",TRUE,"New York Giants",20,17,21,414,252,162,1,15,233,162,71,1,1998-09-13,0,1,"rai",3
"3","Sun","September 20","L","","1-2",TRUE,"Denver Broncos",17,34,13,258,164,94,3,25,338,193,145,2,1998-09-20,-1,0,"rai",-17
"4","Sun","September 27","W","","2-2",FALSE,"Dallas Cowboys",13,12,13,288,159,129,0,16,275,207,68,3,1998-09-27,3,1,"rai",1
"5","Sun","October 4","W","","3-2",FALSE,"Arizona Cardinals",23,20,14,222,110,112,3,16,236,187,49,4,1998-10-04,1,1,"rai",3
"6","Sun","October 11","W","","4-2",TRUE,"San Diego Chargers",7,6,6,159,141,18,1,9,195,78,117,4,1998-10-11,3,1,"rai",1
"8","Sun","October 25","W","","5-2",TRUE,"Cincinnati Bengals",27,10,23,411,160,251,0,14,170,108,62,3,1998-10-25,3,1,"rai",17
"9","Sun","November 1","W","","6-2",FALSE,"Seattle Seahawks",31,18,14,293,220,73,1,22,333,253,80,5,1998-11-01,4,1,"rai",13
"10","Sun","November 8","L","","6-3",FALSE,"Baltimore Ravens",10,13,20,356,245,111,3,15,213,87,126,1,1998-11-08,-2,0,"rai",-3
"11","Sun","November 15","W","","7-3",TRUE,"Seattle Seahawks",20,17,21,380,249,131,3,15,293,192,101,3,1998-11-15,0,1,"rai",3
"12","Sun","November 22","L","","7-4",FALSE,"Denver Broncos",14,40,15,294,245,49,3,28,397,201,196,1,1998-11-22,-2,0,"rai",-26
"13","Sun","November 29","L","","7-5",TRUE,"Washington Redskins",19,29,23,376,189,187,4,17,303,209,94,1,1998-11-29,-3,0,"rai",-10
"14","Sun","December 6","L","","7-6",TRUE,"Miami Dolphins",17,27,20,314,207,107,7,9,260,170,90,1,1998-12-06,-6,0,"rai",-10
"15","Sun","December 13","L","","7-7",FALSE,"Buffalo Bills",21,44,13,178,87,91,4,18,316,182,134,0,1998-12-13,-4,0,"rai",-23
"16","Sun","December 20","W","","8-7",FALSE,"San Diego Chargers",17,10,14,287,167,120,3,16,315,236,79,3,1998-12-20,0,1,"rai",7
"17","Sat","December 26","L","","8-8",TRUE,"Kansas City Chiefs",24,31,25,321,281,40,2,20,373,254,119,3,1998-12-26,1,0,"rai",-7
"1","Sun","September 12","L","","0-1",FALSE,"Green Bay Packers",24,28,20,363,210,153,1,25,409,318,91,4,1999-09-12,3,0,"rai",-4
"2","Sun","September 19","W","","1-1",FALSE,"Minnesota Vikings",22,17,22,402,240,162,1,19,354,320,34,3,1999-09-19,2,1,"rai",5
"3","Sun","September 26","W","","2-1",TRUE,"Chicago Bears",24,17,22,392,283,109,5,11,232,198,34,3,1999-09-26,-2,1,"rai",7
"4","Sun","October 3","L","","2-2",FALSE,"Seattle Seahawks",21,22,21,383,217,166,1,15,276,201,75,1,1999-10-03,0,0,"rai",-1
"5","Sun","October 10","L","","2-3",TRUE,"Denver Broncos",13,16,17,265,210,55,2,16,302,221,81,2,1999-10-10,0,0,"rai",-3
"6","Sun","October 17","W","","3-3",FALSE,"Buffalo Bills",20,14,23,343,148,195,0,14,310,201,109,3,1999-10-17,3,1,"rai",6
"7","Sun","October 24","W","","4-3",TRUE,"New York Jets",24,23,24,461,344,117,4,14,324,147,177,2,1999-10-24,-2,1,"rai",1
"8","Sun","October 31","L","","4-4",TRUE,"Miami Dolphins",9,16,13,187,107,80,2,19,325,184,141,0,1999-10-31,-2,0,"rai",-7
"10","Sun","November 14","W","","5-4",TRUE,"San Diego Chargers",28,9,25,417,244,173,0,12,225,192,33,0,1999-11-14,0,1,"rai",19
"11","Mon","November 22","L","OT","5-5",FALSE,"Denver Broncos",21,27,16,284,205,79,3,17,291,171,120,2,1999-11-22,-1,0,"rai",-6
"12","Sun","November 28","L","","5-6",TRUE,"Kansas City Chiefs",34,37,18,315,207,108,3,16,293,195,98,3,1999-11-28,0,0,"rai",-3
"13","Sun","December 5","W","","6-6",TRUE,"Seattle Seahawks",30,21,24,415,253,162,1,20,324,234,90,4,1999-12-05,3,1,"rai",9
"14","Thu","December 9","L","","6-7",FALSE,"Tennessee Titans",14,21,21,364,253,111,3,17,307,103,204,1,1999-12-09,-2,0,"rai",-7
"15","Sun","December 19","W","","7-7",TRUE,"Tampa Bay Buccaneers",45,0,21,400,138,262,0,9,137,103,34,3,1999-12-19,3,1,"rai",45
"16","Sun","December 26","L","","7-8",FALSE,"San Diego Chargers",20,23,18,294,248,46,1,17,342,293,49,1,1999-12-26,0,0,"rai",-3
"17","Sun","January 2","W","OT","8-8",FALSE,"Kansas City Chiefs",41,38,21,408,302,106,2,25,429,240,189,1,2000-01-02,-1,1,"rai",3
"1","Sun","September 3","W","","1-0",TRUE,"San Diego Chargers",9,6,13,233,166,67,0,17,255,179,76,4,2000-09-03,4,1,"rai",3
"2","Sun","September 10","W","","2-0",FALSE,"Indianapolis Colts",38,31,21,359,207,152,0,28,462,351,111,3,2000-09-10,3,1,"rai",7
"3","Sun","September 17","L","","2-1",TRUE,"Denver Broncos",24,33,16,263,140,123,4,25,387,207,180,1,2000-09-17,-3,0,"rai",-9
"4","Sun","September 24","W","","3-1",TRUE,"Cleveland Browns",36,10,18,292,179,113,0,14,230,141,89,2,2000-09-24,2,1,"rai",26
"6","Sun","October 8","W","OT","4-1",FALSE,"San Francisco 49ers",34,28,31,471,307,164,2,28,472,336,136,2,2000-10-08,0,1,"rai",6
"7","Sun","October 15","W","","5-1",FALSE,"Kansas City Chiefs",20,17,23,391,230,161,1,20,346,288,58,1,2000-10-15,0,1,"rai",3
"8","Sun","October 22","W","","6-1",TRUE,"Seattle Seahawks",31,3,17,380,174,206,1,17,283,146,137,3,2000-10-22,2,1,"rai",28
"9","Sun","October 29","W","","7-1",FALSE,"San Diego Chargers",15,13,19,228,145,83,1,18,224,195,29,2,2000-10-29,1,1,"rai",2
"10","Sun","November 5","W","","8-1",TRUE,"Kansas City Chiefs",49,31,31,473,242,231,0,31,513,474,39,3,2000-11-05,3,1,"rai",18
"11","Mon","November 13","L","","8-2",FALSE,"Denver Broncos",24,27,25,411,373,38,3,18,329,258,71,2,2000-11-13,-1,0,"rai",-3
"12","Sun","November 19","W","","9-2",FALSE,"New Orleans Saints",31,22,19,293,134,159,1,19,333,200,133,1,2000-11-19,0,1,"rai",9
"13","Sun","November 26","W","","10-2",TRUE,"Atlanta Falcons",41,14,24,492,222,270,1,15,181,150,31,2,2000-11-26,1,1,"rai",27
"14","Sun","December 3","L","","10-3",FALSE,"Pittsburgh Steelers",20,21,20,390,273,117,2,19,311,112,199,1,2000-12-03,-1,0,"rai",-1
"15","Sun","December 10","W","","11-3",TRUE,"New York Jets",31,7,17,330,150,180,1,14,300,290,10,4,2000-12-10,3,1,"rai",24
"16","Sat","December 16","L","","11-4",FALSE,"Seattle Seahawks",24,27,15,361,134,227,3,18,326,153,173,2,2000-12-16,-1,0,"rai",-3
"17","Sun","December 24","W","","12-4",TRUE,"Carolina Panthers",52,9,28,409,230,179,0,19,297,218,79,4,2000-12-24,4,1,"rai",43
"Division","Sat","January 6","W","","13-4",TRUE,"Miami Dolphins",27,0,20,267,127,140,1,10,204,164,40,4,2001-01-06,3,1,"rai",27
"ConfChamp","Sun","January 14","L","","13-5",TRUE,"Baltimore Ravens",3,16,12,191,167,24,5,12,282,172,110,2,2001-01-14,-3,0,"rai",-13
"1","Sun","September 9","W","","1-0",FALSE,"Kansas City Chiefs",27,24,23,427,327,100,3,16,254,219,35,3,2001-09-09,0,1,"rai",3
"2","Sun","September 23","L","","1-1",FALSE,"Miami Dolphins",15,18,12,216,120,96,0,19,359,215,144,2,2001-09-23,2,0,"rai",-3
"3","Sun","September 30","W","","2-1",TRUE,"Seattle Seahawks",38,14,17,344,251,93,1,21,348,306,42,3,2001-09-30,2,1,"rai",24
"4","Sun","October 7","W","","3-1",TRUE,"Dallas Cowboys",28,21,23,308,207,101,2,17,231,123,108,0,2001-10-07,-2,1,"rai",7
"5","Sun","October 14","W","","4-1",FALSE,"Indianapolis Colts",23,18,18,317,216,101,1,26,352,234,118,2,2001-10-14,1,1,"rai",5
"7","Sun","October 28","W","","5-1",FALSE,"Philadelphia Eagles",20,10,22,354,152,202,0,11,195,117,78,0,2001-10-28,0,1,"rai",10
"8","Mon","November 5","W","","6-1",TRUE,"Denver Broncos",38,28,27,356,242,114,1,26,366,247,119,2,2001-11-05,1,1,"rai",10
"9","Sun","November 11","L","","6-2",FALSE,"Seattle Seahawks",27,34,20,338,250,88,1,26,497,178,319,0,2001-11-11,-1,0,"rai",-7
"10","Sun","November 18","W","","7-2",TRUE,"San Diego Chargers",34,24,21,381,293,88,1,12,250,98,152,2,2001-11-18,1,1,"rai",10
"11","Sun","November 25","W","","8-2",FALSE,"New York Giants",28,10,15,339,220,119,0,18,313,160,153,0,2001-11-25,0,1,"rai",18
"12","Sun","December 2","L","OT","8-3",TRUE,"Arizona Cardinals",31,34,26,436,301,135,3,24,390,245,145,1,2001-12-02,-2,0,"rai",-3
"13","Sun","December 9","W","","9-3",TRUE,"Kansas City Chiefs",28,26,16,264,185,79,5,23,447,243,204,1,2001-12-09,-4,1,"rai",2
"14","Sat","December 15","W","","10-3",FALSE,"San Diego Chargers",13,6,15,299,208,91,3,14,274,206,68,3,2001-12-15,0,1,"rai",7
"15","Sat","December 22","L","","10-4",TRUE,"Tennessee Titans",10,13,20,311,234,77,1,14,262,159,103,2,2001-12-22,1,0,"rai",-3
"16","Sun","December 30","L","","10-5",FALSE,"Denver Broncos",17,23,24,334,283,51,3,15,231,125,106,0,2001-12-30,-3,0,"rai",-6
"17","Sun","January 6","L","","10-6",TRUE,"New York Jets",22,24,17,337,218,119,0,14,302,208,94,3,2002-01-06,3,0,"rai",-2
"WildCard","Sat","January 12","W","","11-6",TRUE,"New York Jets",38,24,23,502,287,215,0,23,410,265,145,2,2002-01-12,2,1,"rai",14
"Division","Sat","January 19","L","OT","11-7",FALSE,"New England Patriots",13,16,14,230,153,77,0,22,365,297,68,1,2002-01-19,1,0,"rai",-3
"1","Sun","September 8","W","","1-0",TRUE,"Seattle Seahawks",31,17,27,423,202,221,2,14,186,143,43,0,2002-09-08,-2,1,"rai",14
"2","Sun","September 15","W","","2-0",FALSE,"Pittsburgh Steelers",30,17,27,464,369,95,2,14,273,201,72,5,2002-09-15,3,1,"rai",13
"4","Sun","September 29","W","","3-0",TRUE,"Tennessee Titans",52,25,24,464,374,90,1,23,430,387,43,4,2002-09-29,3,1,"rai",27
"5","Sun","October 6","W","","4-0",FALSE,"Buffalo Bills",49,31,24,495,353,142,0,29,479,399,80,3,2002-10-06,3,1,"rai",18
"6","Sun","October 13","L","","4-1",FALSE,"St. Louis Rams",13,28,20,367,302,65,3,19,322,164,158,1,2002-10-13,-2,0,"rai",-15
"7","Sun","October 20","L","OT","4-2",TRUE,"San Diego Chargers",21,27,26,390,353,37,1,24,333,161,172,0,2002-10-20,-1,0,"rai",-6
"8","Sun","October 27","L","","4-3",FALSE,"Kansas City Chiefs",10,20,26,417,334,83,2,22,323,190,133,2,2002-10-27,0,0,"rai",-10
"9","Sun","November 3","L","OT","4-4",TRUE,"San Francisco 49ers",20,23,15,239,158,81,1,30,434,282,152,1,2002-11-03,0,0,"rai",-3
"10","Mon","November 11","W","","5-4",FALSE,"Denver Broncos",34,10,20,374,347,27,0,27,342,265,77,1,2002-11-11,1,1,"rai",24
"11","Sun","November 17","W","","6-4",TRUE,"New England Patriots",27,20,22,386,289,97,1,12,195,147,48,1,2002-11-17,0,1,"rai",7
"12","Sun","November 24","W","","7-4",FALSE,"Arizona Cardinals",41,20,28,520,333,187,1,15,263,131,132,3,2002-11-24,2,1,"rai",21
"13","Mon","December 2","W","","8-4",TRUE,"New York Jets",26,20,25,411,313,98,0,18,274,242,32,2,2002-12-02,2,1,"rai",6
"14","Sun","December 8","W","","9-4",FALSE,"San Diego Chargers",27,7,22,393,326,67,0,19,291,226,65,3,2002-12-08,3,1,"rai",20
"15","Sun","December 15","L","","9-5",FALSE,"Miami Dolphins",17,23,14,218,162,56,2,21,334,213,121,1,2002-12-15,-1,0,"rai",-6
"16","Sun","December 22","W","","10-5",TRUE,"Denver Broncos",28,16,20,322,186,136,2,21,324,243,81,3,2002-12-22,1,1,"rai",12
"17","Sat","December 28","W","","11-5",TRUE,"Kansas City Chiefs",24,0,26,354,74,280,1,11,176,132,44,1,2002-12-28,0,1,"rai",24
"Division","Sun","January 12","W","","12-5",TRUE,"New York Jets",30,10,20,399,272,127,1,20,287,167,120,4,2003-01-12,3,1,"rai",20
"ConfChamp","Sun","January 19","W","","13-5",TRUE,"Tennessee Titans",41,24,25,375,286,89,1,28,312,174,138,2,2003-01-19,1,1,"rai",17
"SuperBowl","Sun","January 26","L","","13-6",TRUE,"Tampa Bay Buccaneers",21,48,11,269,250,19,5,24,365,215,150,1,2003-01-26,-4,0,"rai",-27
"1","Sun","September 7","L","","0-1",FALSE,"Tennessee Titans",20,25,13,280,246,34,1,20,334,258,76,2,2003-09-07,1,0,"rai",-5
"2","Sun","September 14","W","","1-1",TRUE,"Cincinnati Bengals",23,20,12,237,103,134,0,27,416,287,129,2,2003-09-14,2,1,"rai",3
"3","Mon","September 22","L","","1-2",FALSE,"Denver Broncos",10,31,11,195,156,39,1,20,383,193,190,1,2003-09-22,0,0,"rai",-21
"4","Sun","September 28","W","OT","2-2",TRUE,"San Diego Chargers",34,31,23,448,328,120,2,22,430,208,222,1,2003-09-28,-1,1,"rai",3
"5","Sun","October 5","L","","2-3",FALSE,"Chicago Bears",21,24,18,301,182,119,2,18,344,144,200,3,2003-10-05,1,0,"rai",-3
"6","Sun","October 12","L","","2-4",FALSE,"Cleveland Browns",7,13,12,254,164,90,0,20,284,113,171,1,2003-10-12,1,0,"rai",-6
"7","Mon","October 20","L","","2-5",TRUE,"Kansas City Chiefs",10,17,25,357,257,100,3,16,319,194,125,1,2003-10-20,-2,0,"rai",-7
"9","Sun","November 2","L","","2-6",FALSE,"Detroit Lions",13,23,18,265,171,94,4,14,229,117,112,2,2003-11-02,-2,0,"rai",-10
"10","Sun","November 9","L","OT","2-7",TRUE,"New York Jets",24,27,24,355,186,169,1,16,424,269,155,0,2003-11-09,-1,0,"rai",-3
"11","Sun","November 16","W","","3-7",TRUE,"Minnesota Vikings",28,18,19,375,184,191,2,24,467,373,94,6,2003-11-16,4,1,"rai",10
"12","Sun","November 23","L","","3-8",FALSE,"Kansas City Chiefs",24,27,20,379,213,166,0,22,384,242,142,0,2003-11-23,0,0,"rai",-3
"13","Sun","November 30","L","","3-9",TRUE,"Denver Broncos",8,22,12,262,142,120,3,20,287,94,193,1,2003-11-30,-2,0,"rai",-14
"14","Sun","December 7","L","","3-10",FALSE,"Pittsburgh Steelers",7,27,9,161,39,122,3,21,399,266,133,2,2003-12-07,-1,0,"rai",-20
"15","Sun","December 14","W","","4-10",TRUE,"Baltimore Ravens",20,12,15,265,186,79,0,14,319,170,149,3,2003-12-14,3,1,"rai",8
"16","Mon","December 22","L","","4-11",TRUE,"Green Bay Packers",7,41,18,298,194,104,3,23,548,392,156,0,2003-12-22,-3,0,"rai",-34
"17","Sun","December 28","L","","4-12",FALSE,"San Diego Chargers",14,21,9,141,0,141,1,20,337,74,263,0,2003-12-28,-1,0,"rai",-7
"1","Sun","September 12","L","","0-1",FALSE,"Pittsburgh Steelers",21,24,18,358,297,61,4,17,237,130,107,1,2004-09-12,-3,0,"rai",-3
"2","Sun","September 19","W","","1-1",TRUE,"Buffalo Bills",13,10,12,273,200,73,0,14,243,176,67,1,2004-09-19,1,1,"rai",3
"3","Sun","September 26","W","","2-1",TRUE,"Tampa Bay Buccaneers",30,20,23,399,226,173,2,19,389,297,92,1,2004-09-26,-1,1,"rai",10
"4","Sun","October 3","L","","2-2",FALSE,"Houston Texans",17,30,18,375,224,151,5,20,386,228,158,1,2004-10-03,-4,0,"rai",-13
"5","Sun","October 10","L","","2-3",FALSE,"Indianapolis Colts",14,35,18,269,216,53,3,25,338,188,150,1,2004-10-10,-2,0,"rai",-21
"6","Sun","October 17","L","","2-4",TRUE,"Denver Broncos",3,31,9,145,114,31,2,25,444,190,254,1,2004-10-17,-1,0,"rai",-28
"7","Sun","October 24","L","","2-5",TRUE,"New Orleans Saints",26,31,20,432,350,82,2,20,322,280,42,0,2004-10-24,-2,0,"rai",-5
"8","Sun","October 31","L","","2-6",FALSE,"San Diego Chargers",14,42,15,281,259,22,3,33,448,273,175,1,2004-10-31,-2,0,"rai",-28
"9","Sun","November 7","W","","3-6",FALSE,"Carolina Panthers",27,24,21,297,228,69,1,24,304,267,37,0,2004-11-07,-1,1,"rai",3
"11","Sun","November 21","L","","3-7",TRUE,"San Diego Chargers",17,23,14,273,220,53,1,26,402,226,176,1,2004-11-21,0,0,"rai",-6
"12","Sun","November 28","W","","4-7",FALSE,"Denver Broncos",25,24,19,395,334,61,3,16,367,245,122,3,2004-11-28,0,1,"rai",1
"13","Sun","December 5","L","","4-8",TRUE,"Kansas City Chiefs",27,34,16,364,333,31,0,29,500,340,160,1,2004-12-05,1,0,"rai",-7
"14","Sun","December 12","L","","4-9",FALSE,"Atlanta Falcons",10,35,18,296,165,131,3,23,354,135,219,0,2004-12-12,-3,0,"rai",-25
"15","Sun","December 19","W","","5-9",TRUE,"Tennessee Titans",40,35,20,415,358,57,1,31,527,466,61,2,2004-12-19,1,1,"rai",5
"16","Sat","December 25","L","","5-10",FALSE,"Kansas City Chiefs",30,31,18,300,200,100,1,32,433,334,99,2,2004-12-25,1,0,"rai",-1
"17","Sun","January 2","L","","5-11",TRUE,"Jacksonville Jaguars",6,13,16,281,134,147,4,13,242,149,93,2,2005-01-02,-2,0,"rai",-7
"1","Thu","September 8","L","","0-1",FALSE,"New England Patriots",20,30,19,338,246,92,1,22,379,306,73,0,2005-09-08,-1,0,"rai",-10
"2","Sun","September 18","L","","0-2",TRUE,"Kansas City Chiefs",17,23,16,327,255,72,2,17,354,229,125,1,2005-09-18,-1,0,"rai",-6
"3","Sun","September 25","L","","0-3",FALSE,"Philadelphia Eagles",20,23,18,365,344,21,0,26,448,365,83,2,2005-09-25,2,0,"rai",-3
"4","Sun","October 2","W","","1-3",TRUE,"Dallas Cowboys",19,13,16,333,204,129,0,16,303,187,116,1,2005-10-02,1,1,"rai",6
"6","Sun","October 16","L","","1-4",TRUE,"San Diego Chargers",14,27,19,310,271,39,1,22,346,156,190,0,2005-10-16,-1,0,"rai",-13
"7","Sun","October 23","W","","2-4",TRUE,"Buffalo Bills",38,17,26,416,254,162,1,15,210,126,84,1,2005-10-23,0,1,"rai",21
"8","Sun","October 30","W","","3-4",FALSE,"Tennessee Titans",34,25,17,324,232,92,1,19,326,186,140,2,2005-10-30,1,1,"rai",9
"9","Sun","November 6","L","","3-5",FALSE,"Kansas City Chiefs",23,27,21,263,162,101,1,18,321,207,114,1,2005-11-06,0,0,"rai",-4
"10","Sun","November 13","L","","3-6",TRUE,"Denver Broncos",17,31,20,335,275,60,3,18,326,205,121,2,2005-11-13,-1,0,"rai",-14
"11","Sun","November 20","W","","4-6",FALSE,"Washington Redskins",16,13,16,336,286,50,1,13,246,138,108,3,2005-11-20,2,1,"rai",3
"12","Sun","November 27","L","","4-7",TRUE,"Miami Dolphins",21,33,24,305,185,120,3,21,394,249,145,3,2005-11-27,0,0,"rai",-12
"13","Sun","December 4","L","","4-8",FALSE,"San Diego Chargers",10,34,16,291,210,81,2,19,274,144,130,0,2005-12-04,-2,0,"rai",-24
"14","Sun","December 11","L","","4-9",FALSE,"New York Jets",10,26,14,179,84,95,4,23,294,110,184,0,2005-12-11,-4,0,"rai",-16
"15","Sun","December 18","L","","4-10",TRUE,"Cleveland Browns",7,9,16,256,113,143,1,13,255,185,70,2,2005-12-18,1,0,"rai",-2
"16","Sat","December 24","L","","4-11",FALSE,"Denver Broncos",3,22,15,248,161,87,2,24,414,259,155,1,2005-12-24,-1,0,"rai",-19
"17","Sat","December 31","L","","4-12",TRUE,"New York Giants",21,30,21,325,300,25,0,13,402,191,211,0,2005-12-31,0,0,"rai",-9
"1","Mon","September 11","L","","0-1",TRUE,"San Diego Chargers",0,27,9,129,42,87,1,14,302,108,194,0,2006-09-11,-1,0,"rai",-27
"2","Sun","September 17","L","","0-2",FALSE,"Baltimore Ravens",6,28,14,162,123,39,6,14,264,126,138,1,2006-09-17,-5,0,"rai",-22
"4","Sun","October 1","L","","0-3",TRUE,"Cleveland Browns",21,24,14,240,46,194,1,21,283,179,104,3,2006-10-01,2,0,"rai",-3
"5","Sun","October 8","L","","0-4",FALSE,"San Francisco 49ers",20,34,18,370,216,154,5,18,330,165,165,1,2006-10-08,-4,0,"rai",-14
"6","Sun","October 15","L","","0-5",FALSE,"Denver Broncos",3,13,14,244,159,85,2,15,235,91,144,1,2006-10-15,-1,0,"rai",-10
"7","Sun","October 22","W","","1-5",TRUE,"Arizona Cardinals",22,9,21,395,258,137,5,9,224,174,50,2,2006-10-22,-3,1,"rai",13
"8","Sun","October 29","W","","2-5",TRUE,"Pittsburgh Steelers",20,13,9,98,17,81,1,15,360,271,89,4,2006-10-29,3,1,"rai",7
"9","Mon","November 6","L","","2-6",FALSE,"Seattle Seahawks",0,16,13,185,121,64,0,20,371,164,207,0,2006-11-06,0,0,"rai",-16
"10","Sun","November 12","L","","2-7",TRUE,"Denver Broncos",13,17,13,244,198,46,2,13,264,201,63,3,2006-11-12,1,0,"rai",-4
"11","Sun","November 19","L","","2-8",FALSE,"Kansas City Chiefs",13,17,18,326,193,133,1,21,292,92,200,0,2006-11-19,-1,0,"rai",-4
"12","Sun","November 26","L","","2-9",FALSE,"San Diego Chargers",14,21,15,245,161,84,2,15,260,150,110,1,2006-11-26,-1,0,"rai",-7
"13","Sun","December 3","L","","2-10",TRUE,"Houston Texans",14,23,21,302,189,113,5,10,124,-5,129,2,2006-12-03,-3,0,"rai",-9
"14","Sun","December 10","L","","2-11",FALSE,"Cincinnati Bengals",10,27,14,223,178,45,2,28,439,303,136,4,2006-12-10,2,0,"rai",-17
"15","Sun","December 17","L","","2-12",TRUE,"St. Louis Rams",0,20,20,260,203,57,5,16,251,103,148,0,2006-12-17,-5,0,"rai",-20
"16","Sat","December 23","L","","2-13",TRUE,"Kansas City Chiefs",9,20,18,307,195,112,5,19,292,142,150,1,2006-12-23,-4,0,"rai",-11
"17","Sun","December 31","L","","2-14",FALSE,"New York Jets",3,23,12,209,121,88,3,19,266,149,117,0,2006-12-31,-3,0,"rai",-20
"1","Sun","September 9","L","","0-1",TRUE,"Detroit Lions",21,36,24,375,283,92,3,21,392,284,108,2,2007-09-09,-1,0,"rai",-15
"2","Sun","September 16","L","OT","0-2",FALSE,"Denver Broncos",20,23,11,253,53,200,3,26,441,260,181,2,2007-09-16,-1,0,"rai",-3
"3","Sun","September 23","W","","1-2",TRUE,"Cleveland Browns",26,24,19,396,210,186,2,17,312,224,88,2,2007-09-23,0,1,"rai",2
"4","Sun","September 30","W","","2-2",FALSE,"Miami Dolphins",35,17,21,369,70,299,1,13,278,137,141,2,2007-09-30,1,1,"rai",18
"6","Sun","October 14","L","","2-3",FALSE,"San Diego Chargers",14,28,18,245,202,43,3,18,362,156,206,1,2007-10-14,-2,0,"rai",-14
"7","Sun","October 21","L","","2-4",TRUE,"Kansas City Chiefs",10,12,10,268,213,55,2,14,290,164,126,1,2007-10-21,-1,0,"rai",-2
"8","Sun","October 28","L","","2-5",FALSE,"Tennessee Titans",9,13,14,235,143,92,2,11,218,26,192,0,2007-10-28,-2,0,"rai",-4
"9","Sun","November 4","L","","2-6",TRUE,"Houston Texans",17,24,23,310,157,153,3,17,359,181,178,1,2007-11-04,-2,0,"rai",-7
"10","Sun","November 11","L","","2-7",TRUE,"Chicago Bears",6,17,12,193,86,107,3,16,295,217,78,0,2007-11-11,-3,0,"rai",-11
"11","Sun","November 18","L","","2-8",FALSE,"Minnesota Vikings",22,29,18,372,307,65,2,25,478,250,228,5,2007-11-18,3,0,"rai",-7
"12","Sun","November 25","W","","3-8",FALSE,"Kansas City Chiefs",20,17,19,312,159,153,1,18,292,128,164,1,2007-11-25,0,1,"rai",3
"13","Sun","December 2","W","","4-8",TRUE,"Denver Broncos",34,20,20,372,197,175,1,14,292,206,86,4,2007-12-02,3,1,"rai",14
"14","Sun","December 9","L","","4-9",FALSE,"Green Bay Packers",7,38,10,233,148,85,3,21,445,266,179,1,2007-12-09,-2,0,"rai",-31
"15","Sun","December 16","L","","4-10",TRUE,"Indianapolis Colts",14,21,18,253,104,149,0,20,322,264,58,1,2007-12-16,1,0,"rai",-7
"16","Sun","December 23","L","","4-11",FALSE,"Jacksonville Jaguars",11,49,13,215,105,110,4,26,437,236,201,2,2007-12-23,-2,0,"rai",-38
"17","Sun","December 30","L","","4-12",TRUE,"San Diego Chargers",17,30,17,316,194,122,4,15,253,133,120,1,2007-12-30,-3,0,"rai",-13
"1","Mon","September 8","L","","0-1",TRUE,"Denver Broncos",14,41,15,307,157,150,1,24,441,300,141,0,2008-09-08,-1,0,"rai",-27
"2","Sun","September 14","W","","1-1",FALSE,"Kansas City Chiefs",23,8,18,355,55,300,2,15,190,135,55,2,2008-09-14,0,1,"rai",15
"3","Sun","September 21","L","","1-2",FALSE,"Buffalo Bills",23,24,10,247,149,98,1,25,378,262,116,3,2008-09-21,2,0,"rai",-1
"4","Sun","September 28","L","","1-3",TRUE,"San Diego Chargers",18,28,15,323,251,72,2,18,295,154,141,2,2008-09-28,0,0,"rai",-10
"6","Sun","October 12","L","","1-4",FALSE,"New Orleans Saints",3,34,12,226,141,85,2,23,441,319,122,0,2008-10-12,-2,0,"rai",-31
"7","Sun","October 19","W","OT","2-4",TRUE,"New York Jets",16,13,19,344,191,153,0,23,418,176,242,3,2008-10-19,3,1,"rai",3
"8","Sun","October 26","L","","2-5",FALSE,"Baltimore Ravens",10,29,10,234,187,47,1,18,375,183,192,1,2008-10-26,0,0,"rai",-19
"9","Sun","November 2","L","","2-6",TRUE,"Atlanta Falcons",0,24,3,77,10,67,2,30,453,201,252,1,2008-11-02,-1,0,"rai",-24
"10","Sun","November 9","L","","2-7",TRUE,"Carolina Panthers",6,17,17,259,112,147,3,10,219,57,162,4,2008-11-09,1,0,"rai",-11
"11","Sun","November 16","L","","2-8",FALSE,"Miami Dolphins",15,17,11,199,129,70,0,20,382,160,222,1,2008-11-16,1,0,"rai",-2
"12","Sun","November 23","W","","3-8",FALSE,"Denver Broncos",31,10,18,318,160,158,0,23,319,204,115,2,2008-11-23,2,1,"rai",21
"13","Sun","November 30","L","","3-9",TRUE,"Kansas City Chiefs",13,20,14,271,132,139,2,17,301,156,145,1,2008-11-30,-1,0,"rai",-7
"14","Thu","December 4","L","","3-10",FALSE,"San Diego Chargers",7,34,9,163,109,54,4,18,372,214,158,1,2008-12-04,-3,0,"rai",-27
"15","Sun","December 14","L","","3-11",TRUE,"New England Patriots",26,49,19,334,218,116,1,29,487,210,277,1,2008-12-14,0,0,"rai",-23
"16","Sun","December 21","W","","4-11",TRUE,"Houston Texans",27,16,17,362,223,139,1,17,324,234,90,1,2008-12-21,0,1,"rai",11
"17","Sun","December 28","W","","5-11",FALSE,"Tampa Bay Buccaneers",31,24,18,337,145,192,1,15,380,255,125,1,2008-12-28,0,1,"rai",7
"1","Mon","September 14","L","","0-1",TRUE,"San Diego Chargers",20,24,19,366,218,148,3,19,317,240,77,2,2009-09-14,-1,0,"rai",-4
"2","Sun","September 20","W","","1-1",FALSE,"Kansas City Chiefs",13,10,11,166,99,67,0,25,409,236,173,2,2009-09-20,2,1,"rai",3
"3","Sun","September 27","L","","1-2",TRUE,"Denver Broncos",3,23,9,137,42,95,3,21,372,157,215,1,2009-09-27,-2,0,"rai",-20
"4","Sun","October 4","L","","1-3",FALSE,"Houston Texans",6,29,8,165,120,45,3,16,329,209,120,2,2009-10-04,-1,0,"rai",-23
"5","Sun","October 11","L","","1-4",FALSE,"New York Giants",7,44,7,124,64,60,3,27,483,263,220,1,2009-10-11,-2,0,"rai",-37
"6","Sun","October 18","W","","2-4",TRUE,"Philadelphia Eagles",13,9,18,325,209,116,2,14,283,216,67,0,2009-10-18,-2,1,"rai",4
"7","Sun","October 25","L","","2-5",TRUE,"New York Jets",0,38,13,263,144,119,4,26,447,131,316,0,2009-10-25,-4,0,"rai",-38
"8","Sun","November 1","L","","2-6",FALSE,"San Diego Chargers",16,24,13,180,81,99,1,20,346,246,100,2,2009-11-01,1,0,"rai",-8
"10","Sun","November 15","L","","2-7",TRUE,"Kansas City Chiefs",10,16,11,272,90,182,2,14,318,206,112,3,2009-11-15,1,0,"rai",-6
"11","Sun","November 22","W","","3-7",TRUE,"Cincinnati Bengals",20,17,16,275,183,92,3,23,348,171,177,4,2009-11-22,1,1,"rai",3
"12","Thu","November 26","L","","3-8",FALSE,"Dallas Cowboys",7,24,14,305,181,124,1,18,494,299,195,0,2009-11-26,-1,0,"rai",-17
"13","Sun","December 6","W","","4-8",FALSE,"Pittsburgh Steelers",27,24,19,396,287,109,0,19,401,269,132,1,2009-12-06,1,1,"rai",3
"14","Sun","December 13","L","","4-9",TRUE,"Washington Redskins",13,34,15,227,162,65,1,21,295,195,100,1,2009-12-13,0,0,"rai",-21
"15","Sun","December 20","W","","5-9",FALSE,"Denver Broncos",20,19,22,343,102,241,2,19,337,257,80,0,2009-12-20,-2,1,"rai",1
"16","Sun","December 27","L","","5-10",FALSE,"Cleveland Browns",9,23,19,389,301,88,3,16,282,118,164,1,2009-12-27,-2,0,"rai",-14
"17","Sun","January 3","L","","5-11",TRUE,"Baltimore Ravens",13,21,20,325,274,51,2,16,330,90,240,0,2010-01-03,-2,0,"rai",-8
"1","Sun","September 12","L","","0-1",FALSE,"Tennessee Titans",13,38,21,286,150,136,2,17,345,140,205,1,2010-09-12,-1,0,"rai",-25
"2","Sun","September 19","W","","1-1",TRUE,"St. Louis Rams",16,14,25,404,231,173,2,16,210,135,75,1,2010-09-19,-1,1,"rai",2
"3","Sun","September 26","L","","1-2",FALSE,"Arizona Cardinals",23,24,20,364,231,133,1,18,227,108,119,3,2010-09-26,2,0,"rai",-1
"4","Sun","October 3","L","","1-3",TRUE,"Houston Texans",24,31,24,363,245,118,3,21,441,192,249,0,2010-10-03,-3,0,"rai",-7
"5","Sun","October 10","W","","2-3",TRUE,"San Diego Chargers",35,27,14,279,168,111,0,29,506,415,91,3,2010-10-10,3,1,"rai",8
"6","Sun","October 17","L","","2-4",FALSE,"San Francisco 49ers",9,17,10,179,69,110,2,17,349,191,158,0,2010-10-17,-2,0,"rai",-8
"7","Sun","October 24","W","","3-4",FALSE,"Denver Broncos",59,14,29,508,180,328,0,11,240,165,75,3,2010-10-24,3,1,"rai",45
"8","Sun","October 31","W","","4-4",TRUE,"Seattle Seahawks",33,3,18,545,306,239,0,10,164,117,47,1,2010-10-31,1,1,"rai",30
"9","Sun","November 7","W","OT","5-4",TRUE,"Kansas City Chiefs",23,20,17,321,209,112,3,21,304,200,104,2,2010-11-07,-1,1,"rai",3
"11","Sun","November 21","L","","5-5",FALSE,"Pittsburgh Steelers",3,35,17,182,121,61,3,18,431,269,162,1,2010-11-21,-2,0,"rai",-32
"12","Sun","November 28","L","","5-6",TRUE,"Miami Dolphins",17,33,11,263,247,16,3,24,471,285,186,1,2010-11-28,-2,0,"rai",-16
"13","Sun","December 5","W","","6-6",FALSE,"San Diego Chargers",28,13,22,368,117,251,1,18,286,265,21,2,2010-12-05,1,1,"rai",15
"14","Sun","December 12","L","","6-7",FALSE,"Jacksonville Jaguars",31,38,21,476,323,153,2,19,385,151,234,1,2010-12-12,-1,0,"rai",-7
"15","Sun","December 19","W","","7-7",TRUE,"Denver Broncos",39,23,20,502,238,264,3,9,235,129,106,1,2010-12-19,-2,1,"rai",16
"16","Sun","December 26","L","","7-8",TRUE,"Indianapolis Colts",26,31,16,290,210,80,0,27,370,179,191,2,2010-12-26,2,0,"rai",-5
"17","Sun","January 2","W","","8-8",FALSE,"Kansas City Chiefs",31,10,21,344,135,209,1,17,201,86,115,2,2011-01-02,1,1,"rai",21
"1","Mon","September 12","W","","1-0",FALSE,"Denver Broncos",23,20,20,289,99,190,1,25,310,272,38,3,2011-09-12,2,1,"rai",3
"2","Sun","September 18","L","","1-1",FALSE,"Buffalo Bills",35,38,26,454,323,131,2,34,481,258,223,1,2011-09-18,-1,0,"rai",-3
"3","Sun","September 25","W","","2-1",TRUE,"New York Jets",34,24,23,383,149,234,0,25,439,339,100,2,2011-09-25,2,1,"rai",10
"4","Sun","October 2","L","","2-2",TRUE,"New England Patriots",19,31,24,504,344,160,2,25,409,226,183,0,2011-10-02,-2,0,"rai",-12
"5","Sun","October 9","W","","3-2",FALSE,"Houston Texans",25,20,11,278,184,94,1,21,473,403,70,2,2011-10-09,1,1,"rai",5
"6","Sun","October 16","W","","4-2",TRUE,"Cleveland Browns",24,17,18,329,178,151,1,18,268,203,65,1,2011-10-16,0,1,"rai",7
"7","Sun","October 23","L","","4-3",TRUE,"Kansas City Chiefs",0,28,18,322,167,155,6,22,300,161,139,2,2011-10-23,-4,0,"rai",-28
"9","Sun","November 6","L","","4-4",TRUE,"Denver Broncos",24,38,21,416,316,100,3,20,412,113,299,0,2011-11-06,-3,0,"rai",-14
"10","Thu","November 10","W","","5-4",FALSE,"San Diego Chargers",24,17,20,489,298,191,2,20,314,239,75,2,2011-11-10,0,1,"rai",7
"11","Sun","November 20","W","","6-4",FALSE,"Minnesota Vikings",27,21,22,301,139,162,1,20,311,187,124,5,2011-11-20,4,1,"rai",6
"12","Sun","November 27","W","","7-4",TRUE,"Chicago Bears",25,20,17,341,268,73,1,18,401,229,172,3,2011-11-27,2,1,"rai",5
"13","Sun","December 4","L","","7-5",FALSE,"Miami Dolphins",14,34,18,304,258,46,1,23,362,153,209,0,2011-12-04,-1,0,"rai",-20
"14","Sun","December 11","L","","7-6",FALSE,"Green Bay Packers",16,46,23,357,240,117,5,22,391,255,136,1,2011-12-11,-4,0,"rai",-30
"15","Sun","December 18","L","","7-7",TRUE,"Detroit Lions",27,28,26,477,345,132,1,25,432,375,57,1,2011-12-18,0,0,"rai",-1
"16","Sat","December 24","W","OT","8-7",FALSE,"Kansas City Chiefs",16,13,13,308,237,71,2,26,435,300,135,2,2011-12-24,0,1,"rai",3
"17","Sun","January 1","L","","8-8",TRUE,"San Diego Chargers",26,38,28,520,417,103,1,25,463,310,153,1,2012-01-01,0,0,"rai",-12
"1","Sun","September 8","W","","1-0",FALSE,"New Orleans Saints",47,27,22,504,395,109,3,19,304,168,136,4,1985-09-08,1,1,"kan",20
"2","Thu","September 12","W","","2-0",TRUE,"Los Angeles Raiders",36,20,18,325,241,84,1,22,340,273,67,5,1985-09-12,4,1,"kan",16
"3","Sun","September 22","L","","2-1",FALSE,"Miami Dolphins",0,31,15,284,187,97,2,27,391,258,133,2,1985-09-22,0,0,"kan",-31
"4","Sun","September 29","W","","3-1",TRUE,"Seattle Seahawks",28,7,10,165,88,77,4,21,369,301,68,7,1985-09-29,3,1,"kan",21
"5","Sun","October 6","L","","3-2",FALSE,"Los Angeles Raiders",10,19,14,262,181,81,1,17,361,220,141,0,1985-10-06,-1,0,"kan",-9
"6","Sun","October 13","L","","3-3",FALSE,"San Diego Chargers",20,31,14,325,277,48,3,22,350,287,63,3,1985-10-13,0,0,"kan",-11
"7","Sun","October 20","L","","3-4",TRUE,"Los Angeles Rams",0,16,15,245,143,102,7,12,184,54,130,0,1985-10-20,-7,0,"kan",-16
"8","Sun","October 27","L","","3-5",TRUE,"Denver Broncos",10,30,13,257,180,77,0,25,324,118,206,0,1985-10-27,0,0,"kan",-20
"9","Sun","November 3","L","","3-6",FALSE,"Houston Oilers",20,23,26,389,236,153,3,24,377,241,136,1,1985-11-03,-2,0,"kan",-3
"10","Sun","November 10","L","","3-7",TRUE,"Pittsburgh Steelers",28,36,13,295,259,36,2,17,396,251,145,1,1985-11-10,-1,0,"kan",-8
"11","Sun","November 17","L","","3-8",FALSE,"San Francisco 49ers",3,31,12,200,125,75,1,24,417,254,163,2,1985-11-17,1,0,"kan",-28
"12","Sun","November 24","W","","4-8",TRUE,"Indianapolis Colts",20,7,21,358,231,127,1,11,211,86,125,1,1985-11-24,0,1,"kan",13
"13","Sun","December 1","L","","4-9",FALSE,"Seattle Seahawks",6,24,11,201,149,52,3,22,337,243,94,3,1985-12-01,0,0,"kan",-18
"14","Sun","December 8","W","","5-9",TRUE,"Atlanta Falcons",38,10,21,369,205,164,1,21,354,93,261,3,1985-12-08,2,1,"kan",28
"15","Sat","December 14","L","","5-10",FALSE,"Denver Broncos",13,14,14,262,156,106,1,20,411,301,110,6,1985-12-14,5,0,"kan",-1
"16","Sun","December 22","W","","6-10",TRUE,"San Diego Chargers",38,34,19,436,338,98,1,32,532,341,191,3,1985-12-22,2,1,"kan",4
"1","Sun","September 7","W","","1-0",TRUE,"Cincinnati Bengals",24,14,21,325,145,180,3,17,283,223,60,3,1986-09-07,0,1,"kan",10
"2","Sun","September 14","L","","1-1",FALSE,"Seattle Seahawks",17,23,13,265,167,98,3,19,331,203,128,1,1986-09-14,-2,0,"kan",-6
"3","Sun","September 21","W","","2-1",TRUE,"Houston Oilers",27,13,12,223,117,106,1,16,284,187,97,3,1986-09-21,2,1,"kan",14
"4","Sun","September 28","W","","3-1",FALSE,"Buffalo Bills",20,17,20,327,201,126,1,24,366,269,97,4,1986-09-28,3,1,"kan",3
"5","Sun","October 5","L","","3-2",TRUE,"Los Angeles Raiders",17,24,15,181,84,97,2,18,270,168,102,2,1986-10-05,0,0,"kan",-7
"6","Sun","October 12","L","","3-3",FALSE,"Cleveland Browns",7,20,10,126,83,43,2,20,356,285,71,1,1986-10-12,-1,0,"kan",-13
"7","Sun","October 19","W","","4-3",TRUE,"San Diego Chargers",42,41,13,222,158,64,1,35,512,381,131,5,1986-10-19,4,1,"kan",1
"8","Sun","October 26","W","","5-3",TRUE,"Tampa Bay Buccaneers",27,20,20,355,222,133,2,16,216,86,130,2,1986-10-26,0,1,"kan",7
"9","Sun","November 2","W","","6-3",FALSE,"San Diego Chargers",24,23,16,282,233,49,3,14,225,34,191,5,1986-11-02,2,1,"kan",1
"10","Sun","November 9","W","","7-3",TRUE,"Seattle Seahawks",27,7,24,375,248,127,4,8,133,108,25,3,1986-11-09,-1,1,"kan",20
"11","Sun","November 16","L","","7-4",FALSE,"Denver Broncos",17,38,16,297,220,77,4,18,265,198,67,2,1986-11-16,-2,0,"kan",-21
"12","Sun","November 23","L","","7-5",FALSE,"St. Louis Cardinals",14,23,20,291,209,82,4,17,254,162,92,2,1986-11-23,-2,0,"kan",-9
"13","Sun","November 30","L","","7-6",TRUE,"Buffalo Bills",14,17,26,346,273,73,3,25,336,172,164,2,1986-11-30,-1,0,"kan",-3
"14","Sun","December 7","W","","8-6",TRUE,"Denver Broncos",37,10,12,169,93,76,1,16,323,242,81,5,1986-12-07,4,1,"kan",27
"15","Sun","December 14","W","","9-6",FALSE,"Los Angeles Raiders",20,17,18,263,164,99,0,19,265,137,128,7,1986-12-14,7,1,"kan",3
"16","Sun","December 21","W","","10-6",FALSE,"Pittsburgh Steelers",24,19,8,171,133,38,1,28,515,340,175,2,1986-12-21,1,1,"kan",5
"WildCard","Sun","December 28","L","","10-7",FALSE,"New York Jets",15,35,15,241,174,67,3,19,306,141,165,0,1986-12-28,-3,0,"kan",-20
"1","Sun","September 13","W","","1-0",TRUE,"San Diego Chargers",20,13,15,232,58,174,1,19,342,258,84,4,1987-09-13,3,1,"kan",7
"2","Sun","September 20","L","","1-1",FALSE,"Seattle Seahawks",14,43,12,182,107,75,5,23,360,137,223,0,1987-09-20,-5,0,"kan",-29
"3","Sun","October 4","L","","1-2",FALSE,"Los Angeles Raiders",17,35,22,268,137,131,3,21,500,248,252,2,1987-10-04,-1,0,"kan",-18
"4","Sun","October 11","L","","1-3",FALSE,"Miami Dolphins",0,42,8,132,42,90,4,25,344,142,202,1,1987-10-11,-3,0,"kan",-42
"5","Sun","October 18","L","","1-4",TRUE,"Denver Broncos",17,26,16,247,125,122,3,23,373,275,98,4,1987-10-18,1,0,"kan",-9
"6","Sun","October 25","L","","1-5",FALSE,"San Diego Chargers",21,42,21,371,305,66,5,30,391,277,114,2,1987-10-25,-3,0,"kan",-21
"7","Sun","November 1","L","","1-6",FALSE,"Chicago Bears",28,31,20,367,256,111,2,20,343,263,80,2,1987-11-01,0,0,"kan",-3
"8","Sun","November 8","L","","1-7",TRUE,"Pittsburgh Steelers",16,17,15,224,123,101,5,25,391,141,250,4,1987-11-08,-1,0,"kan",-1
"9","Sun","November 15","L","","1-8",TRUE,"New York Jets",9,16,18,299,195,104,3,19,329,102,227,0,1987-11-15,-3,0,"kan",-7
"10","Sun","November 22","L","","1-9",TRUE,"Green Bay Packers",3,23,10,201,85,116,3,14,273,165,108,1,1987-11-22,-2,0,"kan",-20
"11","Thu","November 26","W","","2-9",FALSE,"Detroit Lions",27,20,22,408,246,162,2,22,357,206,151,0,1987-11-26,-2,1,"kan",7
"12","Sun","December 6","L","OT","2-10",FALSE,"Cincinnati Bengals",27,30,21,322,209,113,1,31,503,359,144,0,1987-12-06,-1,0,"kan",-3
"13","Sun","December 13","W","","3-10",TRUE,"Los Angeles Raiders",16,10,17,276,164,112,2,26,400,312,88,4,1987-12-13,2,1,"kan",6
"14","Sat","December 19","L","","3-11",FALSE,"Denver Broncos",17,20,20,377,254,123,1,22,369,226,143,2,1987-12-19,1,0,"kan",-3
"15","Sun","December 27","W","","4-11",TRUE,"Seattle Seahawks",41,20,28,512,313,199,1,24,364,195,169,2,1987-12-27,1,1,"kan",21
"1","Sun","September 4","L","","0-1",TRUE,"Cleveland Browns",3,6,9,149,89,60,2,20,337,195,142,1,1988-09-04,-1,0,"kan",-3
"2","Sun","September 11","L","","0-2",FALSE,"Seattle Seahawks",10,31,19,286,236,50,6,19,263,107,156,1,1988-09-11,-5,0,"kan",-21
"3","Sun","September 18","W","","1-2",TRUE,"Denver Broncos",20,13,22,380,250,130,0,17,283,213,70,3,1988-09-18,3,1,"kan",7
"4","Sun","September 25","L","","1-3",TRUE,"San Diego Chargers",23,24,20,331,237,94,2,19,303,138,165,1,1988-09-25,-1,0,"kan",-1
"5","Sun","October 2","T","OT","1-3-1",FALSE,"New York Jets",17,17,17,385,261,124,2,31,542,270,272,4,1988-10-02,2,0,"kan",0
"6","Sun","October 9","L","","1-4-1",FALSE,"Houston Oilers",6,7,11,184,119,65,3,16,230,24,206,4,1988-10-09,1,0,"kan",-1
"7","Sun","October 16","L","","1-5-1",TRUE,"Los Angeles Raiders",17,27,16,334,241,93,4,20,233,119,114,0,1988-10-16,-4,0,"kan",-10
"8","Sun","October 23","L","","1-6-1",TRUE,"Detroit Lions",6,7,12,171,110,61,2,14,215,88,127,3,1988-10-23,1,0,"kan",-1
"9","Sun","October 30","L","","1-7-1",FALSE,"Los Angeles Raiders",10,17,17,208,63,145,0,23,404,248,156,2,1988-10-30,2,0,"kan",-7
"10","Sun","November 6","L","","1-8-1",FALSE,"Denver Broncos",11,17,16,273,183,90,3,23,308,177,131,2,1988-11-06,-1,0,"kan",-6
"11","Sun","November 13","W","","2-8-1",TRUE,"Cincinnati Bengals",31,28,24,418,276,142,0,19,307,157,150,2,1988-11-13,2,1,"kan",3
"12","Sun","November 20","W","","3-8-1",TRUE,"Seattle Seahawks",27,24,23,365,203,162,2,20,313,208,105,2,1988-11-20,0,1,"kan",3
"13","Sun","November 27","L","","3-9-1",FALSE,"Pittsburgh Steelers",10,16,19,366,278,88,2,19,336,122,214,1,1988-11-27,-1,0,"kan",-6
"14","Sun","December 4","W","","4-9-1",TRUE,"New York Jets",38,34,26,430,267,163,2,21,371,192,179,2,1988-12-04,0,1,"kan",4
"15","Sun","December 11","L","","4-10-1",FALSE,"New York Giants",12,28,16,258,151,107,1,17,244,85,159,1,1988-12-11,0,0,"kan",-16
"16","Sun","December 18","L","","4-11-1",FALSE,"San Diego Chargers",13,24,22,306,167,139,2,20,337,91,246,2,1988-12-18,0,0,"kan",-11
"1","Sun","September 10","L","","0-1",FALSE,"Denver Broncos",20,34,14,287,242,45,4,14,250,150,100,2,1989-09-10,-2,0,"kan",-14
"2","Sun","September 17","W","","1-1",TRUE,"Los Angeles Raiders",24,19,23,323,171,152,1,18,268,153,115,1,1989-09-17,0,1,"kan",5
"3","Sun","September 24","L","","1-2",FALSE,"San Diego Chargers",6,21,13,272,154,118,5,18,296,96,200,0,1989-09-24,-5,0,"kan",-15
"4","Sun","October 1","L","","1-3",TRUE,"Cincinnati Bengals",17,21,16,292,153,139,6,14,277,114,163,3,1989-10-01,-3,0,"kan",-4
"5","Sun","October 8","W","","2-3",FALSE,"Seattle Seahawks",20,16,17,303,104,199,1,16,288,236,52,2,1989-10-08,1,1,"kan",4
"6","Sun","October 15","L","","2-4",FALSE,"Los Angeles Raiders",14,20,17,305,227,78,4,13,246,89,157,2,1989-10-15,-2,0,"kan",-6
"7","Sun","October 22","W","","3-4",TRUE,"Dallas Cowboys",36,28,26,423,221,202,0,14,282,166,116,1,1989-10-22,1,1,"kan",8
"8","Sun","October 29","L","","3-5",FALSE,"Pittsburgh Steelers",17,23,23,438,318,120,2,19,312,232,80,1,1989-10-29,-1,0,"kan",-6
"9","Sun","November 5","W","","4-5",TRUE,"Seattle Seahawks",20,10,18,315,69,246,2,10,129,90,39,4,1989-11-05,2,1,"kan",10
"10","Sun","November 12","L","","4-6",TRUE,"Denver Broncos",13,16,20,312,171,141,2,12,213,112,101,1,1989-11-12,-1,0,"kan",-3
"11","Sun","November 19","T","OT","4-6-1",FALSE,"Cleveland Browns",10,10,17,307,188,119,3,17,261,183,78,5,1989-11-19,2,0,"kan",0
"12","Sun","November 26","W","","5-6-1",TRUE,"Houston Oilers",34,0,20,313,229,84,1,12,215,112,103,1,1989-11-26,0,1,"kan",34
"13","Sun","December 3","W","","6-6-1",TRUE,"Miami Dolphins",26,21,25,438,239,199,3,15,291,218,73,3,1989-12-03,0,1,"kan",5
"14","Sun","December 10","W","","7-6-1",FALSE,"Green Bay Packers",21,3,21,381,203,178,3,11,208,98,110,2,1989-12-10,-1,1,"kan",18
"15","Sun","December 17","L","","7-7-1",TRUE,"San Diego Chargers",13,20,11,214,124,90,3,22,376,159,217,4,1989-12-17,1,0,"kan",-7
"16","Sun","December 24","W","","8-7-1",FALSE,"Miami Dolphins",27,24,23,342,225,117,1,27,381,319,62,1,1989-12-24,0,1,"kan",3
"1","Sun","September 9","W","","1-0",TRUE,"Minnesota Vikings",24,21,18,304,190,114,1,20,354,224,130,3,1990-09-09,2,1,"kan",3
"2","Mon","September 17","L","","1-1",FALSE,"Denver Broncos",23,24,22,441,363,78,1,18,399,250,149,2,1990-09-17,1,0,"kan",-1
"3","Sun","September 23","W","","2-1",FALSE,"Green Bay Packers",17,3,14,271,118,153,1,17,257,136,121,4,1990-09-23,3,1,"kan",14
"4","Sun","September 30","W","","3-1",TRUE,"Cleveland Browns",34,0,14,259,182,77,1,13,270,202,68,3,1990-09-30,2,1,"kan",34
"5","Sun","October 7","L","","3-2",FALSE,"Indianapolis Colts",19,23,13,255,177,78,4,15,231,143,88,3,1990-10-07,-1,0,"kan",-4
"6","Sun","October 14","W","","4-2",TRUE,"Detroit Lions",43,24,25,566,256,310,1,20,328,192,136,2,1990-10-14,1,1,"kan",19
"7","Sun","October 21","L","","4-3",FALSE,"Seattle Seahawks",7,19,15,248,179,69,3,16,260,124,136,4,1990-10-21,1,0,"kan",-12
"9","Sun","November 4","W","","5-3",TRUE,"Los Angeles Raiders",9,7,11,169,45,124,1,12,234,138,96,3,1990-11-04,2,1,"kan",2
"10","Sun","November 11","L","","5-4",TRUE,"Seattle Seahawks",16,17,16,229,115,114,0,13,297,236,61,2,1990-11-11,2,0,"kan",-1
"11","Sun","November 18","W","","6-4",TRUE,"San Diego Chargers",27,10,16,297,165,132,0,21,286,187,99,5,1990-11-18,5,1,"kan",17
"12","Sun","November 25","W","","7-4",FALSE,"Los Angeles Raiders",27,24,16,239,142,97,0,20,366,211,155,3,1990-11-25,3,1,"kan",3
"13","Sun","December 2","W","","8-4",FALSE,"New England Patriots",37,7,20,471,321,150,1,12,231,167,64,2,1990-12-02,1,1,"kan",30
"14","Sun","December 9","W","","9-4",TRUE,"Denver Broncos",31,20,19,365,254,111,1,26,374,300,74,3,1990-12-09,2,1,"kan",11
"15","Sun","December 16","L","","9-5",TRUE,"Houston Oilers",10,27,17,350,249,101,2,22,563,505,58,1,1990-12-16,-1,0,"kan",-17
"16","Sun","December 23","W","","10-5",FALSE,"San Diego Chargers",24,21,21,368,251,117,0,17,255,151,104,2,1990-12-23,2,1,"kan",3
"17","Sat","December 29","W","","11-5",FALSE,"Chicago Bears",21,10,23,383,260,123,2,6,176,75,101,3,1990-12-29,1,1,"kan",11
"WildCard","Sat","January 5","L","","11-6",FALSE,"Miami Dolphins",16,17,16,367,264,103,1,23,311,213,98,2,1991-01-05,1,0,"kan",-1
"1","Sun","September 1","W","","1-0",TRUE,"Atlanta Falcons",14,3,17,291,139,152,1,13,243,102,141,6,1991-09-01,5,1,"kan",11
"2","Sun","September 8","L","","1-1",TRUE,"New Orleans Saints",10,17,17,272,205,67,2,15,259,187,72,1,1991-09-08,-1,0,"kan",-7
"3","Mon","September 16","L","","1-2",FALSE,"Houston Oilers",7,17,15,230,85,145,2,22,275,227,48,1,1991-09-16,-1,0,"kan",-10
"4","Sun","September 22","W","","2-2",TRUE,"Seattle Seahawks",20,13,16,312,214,98,0,24,378,208,170,4,1991-09-22,4,1,"kan",7
"5","Sun","September 29","W","","3-2",FALSE,"San Diego Chargers",14,13,12,182,96,86,1,17,311,155,156,0,1991-09-29,-1,1,"kan",1
"6","Mon","October 7","W","","4-2",TRUE,"Buffalo Bills",33,6,26,389,150,239,2,11,211,146,65,5,1991-10-07,3,1,"kan",27
"7","Sun","October 13","W","","5-2",TRUE,"Miami Dolphins",42,7,25,452,231,221,0,19,345,253,92,2,1991-10-13,2,1,"kan",35
"8","Sun","October 20","L","","5-3",FALSE,"Denver Broncos",16,19,22,328,209,119,0,14,324,229,95,0,1991-10-20,0,0,"kan",-3
"9","Mon","October 28","W","","6-3",TRUE,"Los Angeles Raiders",24,21,19,267,148,119,1,15,322,249,73,3,1991-10-28,2,1,"kan",3
"11","Sun","November 10","W","","7-3",FALSE,"Los Angeles Rams",27,20,22,354,190,164,0,25,430,319,111,4,1991-11-10,4,1,"kan",7
"12","Sun","November 17","L","","7-4",TRUE,"Denver Broncos",20,24,21,417,292,125,4,14,259,87,172,0,1991-11-17,-4,0,"kan",-4
"13","Sun","November 24","L","","7-5",FALSE,"Cleveland Browns",15,20,21,389,311,78,5,9,281,158,123,2,1991-11-24,-3,0,"kan",-5
"14","Sun","December 1","W","","8-5",FALSE,"Seattle Seahawks",19,6,21,311,154,157,0,13,273,226,47,2,1991-12-01,2,1,"kan",13
"15","Sun","December 8","W","OT","9-5",TRUE,"San Diego Chargers",20,17,21,349,245,104,2,23,366,208,158,2,1991-12-08,0,1,"kan",3
"16","Sat","December 14","L","","9-6",FALSE,"San Francisco 49ers",14,28,17,310,173,137,2,24,408,231,177,1,1991-12-14,-1,0,"kan",-14
"17","Sun","December 22","W","","10-6",FALSE,"Los Angeles Raiders",27,21,30,468,262,206,0,17,313,243,70,0,1991-12-22,0,1,"kan",6
"WildCard","Sat","December 28","W","","11-6",TRUE,"Los Angeles Raiders",10,6,16,204,73,131,2,16,276,124,152,6,1991-12-28,4,1,"kan",4
"Division","Sun","January 5","L","","11-7",FALSE,"Buffalo Bills",14,37,14,213,136,77,4,29,448,268,180,3,1992-01-05,-1,0,"kan",-23
"1","Sun","September 6","W","","1-0",FALSE,"San Diego Chargers",24,10,14,188,127,61,1,13,155,67,88,3,1992-09-06,2,1,"kan",14
"2","Sun","September 13","W","","2-0",TRUE,"Seattle Seahawks",26,7,16,321,206,115,1,11,189,98,91,4,1992-09-13,3,1,"kan",19
"3","Sun","September 20","L","OT","2-1",FALSE,"Houston Oilers",20,23,21,345,158,187,1,18,342,265,77,3,1992-09-20,2,0,"kan",-3
"4","Mon","September 28","W","","3-1",TRUE,"Los Angeles Raiders",27,7,17,241,61,180,1,13,218,128,90,2,1992-09-28,1,1,"kan",20
"5","Sun","October 4","L","","3-2",FALSE,"Denver Broncos",19,20,20,369,279,90,0,20,347,279,68,1,1992-10-04,1,0,"kan",-1
"6","Sun","October 11","W","","4-2",TRUE,"Philadelphia Eagles",24,17,11,316,254,62,1,18,313,129,184,3,1992-10-11,2,1,"kan",7
"7","Sun","October 18","L","","4-3",FALSE,"Dallas Cowboys",10,17,18,230,139,91,1,17,278,183,95,2,1992-10-18,1,0,"kan",-7
"8","Sun","October 25","L","","4-4",TRUE,"Pittsburgh Steelers",3,27,13,179,58,121,3,16,263,109,154,0,1992-10-25,-3,0,"kan",-24
"10","Sun","November 8","W","","5-4",TRUE,"San Diego Chargers",16,14,11,211,104,107,0,17,295,238,57,4,1992-11-08,4,1,"kan",2
"11","Sun","November 15","W","","6-4",TRUE,"Washington Redskins",35,16,20,385,287,98,1,15,285,204,81,1,1992-11-15,0,1,"kan",19
"12","Sun","November 22","W","","7-4",FALSE,"Seattle Seahawks",24,14,11,190,73,117,0,20,310,129,181,6,1992-11-22,6,1,"kan",10
"13","Sun","November 29","W","","8-4",FALSE,"New York Jets",23,7,21,296,203,93,0,15,251,189,62,1,1992-11-29,1,1,"kan",16
"14","Sun","December 6","L","","8-5",FALSE,"Los Angeles Raiders",7,28,12,265,248,17,2,15,230,79,151,2,1992-12-06,0,0,"kan",-21
"15","Sun","December 13","W","","9-5",TRUE,"New England Patriots",27,20,14,270,185,85,4,10,210,101,109,4,1992-12-13,0,1,"kan",7
"16","Sat","December 19","L","","9-6",FALSE,"New York Giants",21,35,14,298,250,48,2,22,348,131,217,0,1992-12-19,-2,0,"kan",-14
"17","Sun","December 27","W","","10-6",TRUE,"Denver Broncos",42,20,13,220,160,60,3,16,290,208,82,3,1992-12-27,0,1,"kan",22
"WildCard","Sat","January 2","L","","10-7",FALSE,"San Diego Chargers",0,17,17,251,190,61,3,18,342,150,192,1,1993-01-02,-2,0,"kan",-17
"1","Sun","September 5","W","","1-0",FALSE,"Tampa Bay Buccaneers",27,3,20,400,278,122,3,15,157,132,25,1,1993-09-05,-2,1,"kan",24
"2","Sun","September 12","L","","1-1",FALSE,"Houston Oilers",0,30,10,206,160,46,5,17,247,190,57,2,1993-09-12,-3,0,"kan",-30
"3","Mon","September 20","W","","2-1",TRUE,"Denver Broncos",15,7,21,414,254,160,1,17,335,300,35,3,1993-09-20,2,1,"kan",8
"5","Sun","October 3","W","","3-1",TRUE,"Los Angeles Raiders",24,9,26,242,127,115,0,15,222,146,76,1,1993-10-03,1,1,"kan",15
"6","Sun","October 10","W","","4-1",TRUE,"Cincinnati Bengals",17,15,14,203,109,94,2,17,277,162,115,1,1993-10-10,-1,1,"kan",2
"7","Sun","October 17","W","","5-1",FALSE,"San Diego Chargers",17,14,20,347,264,83,1,18,269,190,79,1,1993-10-17,0,1,"kan",3
"9","Sun","October 31","L","","5-2",FALSE,"Miami Dolphins",10,30,18,305,206,99,3,26,483,344,139,2,1993-10-31,-1,0,"kan",-20
"10","Mon","November 8","W","","6-2",TRUE,"Green Bay Packers",23,16,15,253,153,100,0,20,287,188,99,6,1993-11-08,6,1,"kan",7
"11","Sun","November 14","W","","7-2",FALSE,"Los Angeles Raiders",31,20,21,338,174,164,1,22,280,178,102,2,1993-11-14,1,1,"kan",11
"12","Sun","November 21","L","","7-3",TRUE,"Chicago Bears",17,19,19,252,119,133,1,18,281,96,185,2,1993-11-21,1,0,"kan",-2
"13","Sun","November 28","W","","8-3",TRUE,"Buffalo Bills",23,7,19,314,208,106,2,17,256,213,43,4,1993-11-28,2,1,"kan",16
"14","Sun","December 5","W","","9-3",FALSE,"Seattle Seahawks",31,16,23,337,231,106,0,16,365,275,90,4,1993-12-05,4,1,"kan",15
"15","Sun","December 12","L","","9-4",FALSE,"Denver Broncos",21,27,17,311,234,77,1,23,340,204,136,2,1993-12-12,1,0,"kan",-6
"16","Sun","December 19","W","","10-4",TRUE,"San Diego Chargers",28,24,20,321,217,104,3,20,268,174,94,3,1993-12-19,0,1,"kan",4
"17","Sun","December 26","L","","10-5",FALSE,"Minnesota Vikings",10,30,12,220,183,37,3,23,424,219,205,1,1993-12-26,-2,0,"kan",-20
"18","Sun","January 2","W","","11-5",TRUE,"Seattle Seahawks",34,24,26,372,263,109,2,16,280,140,140,3,1994-01-02,1,1,"kan",10
"WildCard","Sat","January 8","W","OT","12-5",TRUE,"Pittsburgh Steelers",27,24,28,401,276,125,0,21,369,272,97,0,1994-01-08,0,1,"kan",3
"Division","Sun","January 16","W","","13-5",FALSE,"Houston Oilers",28,20,18,354,283,71,2,19,277,238,39,3,1994-01-16,1,1,"kan",8
"ConfChamp","Sun","January 23","L","","13-6",FALSE,"Buffalo Bills",13,30,22,338,286,52,2,30,389,160,229,1,1994-01-23,-1,0,"kan",-17
"1","Sun","September 4","W","","1-0",FALSE,"New Orleans Saints",30,17,28,460,308,152,0,22,349,312,37,4,1994-09-04,4,1,"kan",13
"2","Sun","September 11","W","","2-0",TRUE,"San Francisco 49ers",24,17,18,292,194,98,0,23,381,271,110,4,1994-09-11,4,1,"kan",7
"3","Sun","September 18","W","","3-0",FALSE,"Atlanta Falcons",30,10,22,427,361,66,4,21,384,284,100,6,1994-09-18,2,1,"kan",20
"4","Sun","September 25","L","","3-1",TRUE,"Los Angeles Rams",0,16,17,242,166,76,3,17,357,202,155,0,1994-09-25,-3,0,"kan",-16
"6","Sun","October 9","L","","3-2",FALSE,"San Diego Chargers",6,20,20,361,297,64,2,18,322,171,151,1,1994-10-09,-1,0,"kan",-14
"7","Mon","October 17","W","","4-2",FALSE,"Denver Broncos",31,28,26,483,393,90,2,21,330,233,97,3,1994-10-17,1,1,"kan",3
"8","Sun","October 23","W","","5-2",TRUE,"Seattle Seahawks",38,23,24,477,305,172,0,16,263,96,167,2,1994-10-23,2,1,"kan",15
"9","Sun","October 30","L","","5-3",FALSE,"Buffalo Bills",10,44,16,266,179,87,5,17,357,180,177,0,1994-10-30,-5,0,"kan",-34
"10","Sun","November 6","W","","6-3",TRUE,"Los Angeles Raiders",13,3,11,252,159,93,0,15,248,148,100,3,1994-11-06,3,1,"kan",10
"11","Sun","November 13","L","","6-4",TRUE,"San Diego Chargers",13,14,15,249,165,84,2,13,235,187,48,4,1994-11-13,2,0,"kan",-1
"12","Sun","November 20","W","","7-4",TRUE,"Cleveland Browns",20,13,23,287,153,134,1,15,239,145,94,4,1994-11-20,3,1,"kan",7
"13","Sun","November 27","L","","7-5",FALSE,"Seattle Seahawks",9,10,18,312,197,115,2,12,266,207,59,0,1994-11-27,-2,0,"kan",-1
"14","Sun","December 4","L","OT","7-6",TRUE,"Denver Broncos",17,20,17,401,323,78,1,26,393,270,123,1,1994-12-04,0,0,"kan",-3
"15","Mon","December 12","L","","7-7",FALSE,"Miami Dolphins",28,45,26,398,314,84,3,23,385,241,144,0,1994-12-12,-3,0,"kan",-17
"16","Sun","December 18","W","","8-7",TRUE,"Houston Oilers",31,9,17,363,228,135,0,16,217,98,119,5,1994-12-18,5,1,"kan",22
"17","Sat","December 24","W","","9-7",FALSE,"Los Angeles Raiders",19,9,24,422,218,204,1,14,274,221,53,1,1994-12-24,0,1,"kan",10
"WildCard","Sat","December 31","L","","9-8",FALSE,"Miami Dolphins",17,27,24,414,314,100,2,22,381,249,132,0,1994-12-31,-2,0,"kan",-10
"1","Sun","September 3","W","","1-0",FALSE,"Seattle Seahawks",34,10,17,419,278,141,0,20,342,264,78,2,1995-09-03,2,1,"kan",24
"2","Sun","September 10","W","OT","2-0",TRUE,"New York Giants",20,17,28,333,178,155,2,12,238,136,102,2,1995-09-10,0,1,"kan",3
"3","Sun","September 17","W","OT","3-0",TRUE,"Oakland Raiders",23,17,14,262,141,121,1,21,344,193,151,3,1995-09-17,2,1,"kan",6
"4","Sun","September 24","L","","3-1",FALSE,"Cleveland Browns",17,35,14,322,263,59,2,23,345,221,124,1,1995-09-24,-1,0,"kan",-18
"5","Sun","October 1","W","","4-1",FALSE,"Arizona Cardinals",24,3,17,293,72,221,2,16,296,240,56,3,1995-10-01,1,1,"kan",21
"6","Mon","October 9","W","OT","5-1",TRUE,"San Diego Chargers",29,23,21,379,317,62,1,25,369,318,51,3,1995-10-09,2,1,"kan",6
"7","Sun","October 15","W","","6-1",TRUE,"New England Patriots",31,26,17,353,203,150,0,23,321,213,108,2,1995-10-15,2,1,"kan",5
"8","Sun","October 22","W","","7-1",FALSE,"Denver Broncos",21,7,21,332,161,171,0,19,285,200,85,3,1995-10-22,3,1,"kan",14
"10","Sun","November 5","W","","8-1",TRUE,"Washington Redskins",24,3,21,368,190,178,3,13,201,122,79,2,1995-11-05,-1,1,"kan",21
"11","Sun","November 12","W","","9-1",FALSE,"San Diego Chargers",22,7,19,286,120,166,1,17,283,213,70,0,1995-11-12,-1,1,"kan",15
"12","Sun","November 19","W","","10-1",TRUE,"Houston Oilers",20,13,11,181,115,66,2,16,294,189,105,4,1995-11-19,2,1,"kan",7
"13","Thu","November 23","L","","10-2",FALSE,"Dallas Cowboys",12,24,19,334,261,73,1,23,293,175,118,0,1995-11-23,-1,0,"kan",-12
"14","Sun","December 3","W","","11-2",FALSE,"Oakland Raiders",29,23,16,308,121,187,1,20,333,325,8,4,1995-12-03,3,1,"kan",6
"15","Mon","December 11","L","","11-3",FALSE,"Miami Dolphins",6,13,17,333,180,153,3,15,248,146,102,2,1995-12-11,-1,0,"kan",-7
"16","Sun","December 17","W","","12-3",TRUE,"Denver Broncos",20,17,22,364,219,145,1,18,268,204,64,2,1995-12-17,1,1,"kan",3
"17","Sun","December 24","W","","13-3",TRUE,"Seattle Seahawks",26,3,21,375,201,174,1,8,89,63,26,0,1995-12-24,-1,1,"kan",23
"Division","Sun","January 7","L","","13-4",TRUE,"Indianapolis Colts",7,10,15,281,152,129,4,16,249,102,147,1,1996-01-07,-3,0,"kan",-3
"1","Sun","September 1","W","","1-0",FALSE,"Houston Oilers",20,19,17,248,169,79,2,16,263,191,72,1,1996-09-01,-1,1,"kan",1
"2","Sun","September 8","W","","2-0",TRUE,"Oakland Raiders",19,3,16,246,121,125,0,22,296,160,136,2,1996-09-08,2,1,"kan",16
"3","Sun","September 15","W","","3-0",FALSE,"Seattle Seahawks",35,17,24,323,166,157,2,17,238,141,97,1,1996-09-15,-1,1,"kan",18
"4","Sun","September 22","W","","4-0",TRUE,"Denver Broncos",17,14,20,306,231,75,1,17,299,138,161,2,1996-09-22,1,1,"kan",3
"5","Sun","September 29","L","","4-1",FALSE,"San Diego Chargers",19,22,19,315,257,58,2,18,313,238,75,2,1996-09-29,0,0,"kan",-3
"6","Mon","October 7","L","","4-2",TRUE,"Pittsburgh Steelers",7,17,17,300,170,130,3,21,436,338,98,3,1996-10-07,0,0,"kan",-10
"8","Thu","October 17","W","","5-2",TRUE,"Seattle Seahawks",34,16,27,340,194,146,1,18,323,213,110,1,1996-10-17,0,1,"kan",18
"9","Sun","October 27","L","","5-3",FALSE,"Denver Broncos",7,34,10,232,208,24,2,26,499,286,213,3,1996-10-27,1,0,"kan",-27
"10","Sun","November 3","W","","6-3",FALSE,"Minnesota Vikings",21,6,23,359,157,202,1,13,258,210,48,2,1996-11-03,1,1,"kan",15
"11","Sun","November 10","W","","7-3",TRUE,"Green Bay Packers",27,20,19,383,201,182,0,24,364,289,75,2,1996-11-10,2,1,"kan",7
"12","Sun","November 17","W","","8-3",TRUE,"Chicago Bears",14,10,20,300,151,149,2,14,256,221,35,2,1996-11-17,0,1,"kan",4
"13","Sun","November 24","L","","8-4",TRUE,"San Diego Chargers",14,28,26,434,332,102,2,20,380,252,128,0,1996-11-24,-2,0,"kan",-14
"14","Thu","November 28","W","","9-4",FALSE,"Detroit Lions",28,24,26,338,95,243,1,21,318,237,81,3,1996-11-28,2,1,"kan",4
"15","Mon","December 9","L","","9-5",FALSE,"Oakland Raiders",7,26,13,169,71,98,1,15,315,145,170,0,1996-12-09,-1,0,"kan",-19
"16","Sun","December 15","L","","9-6",TRUE,"Indianapolis Colts",19,24,20,357,237,120,1,19,311,222,89,0,1996-12-15,-1,0,"kan",-5
"17","Sun","December 22","L","","9-7",FALSE,"Buffalo Bills",9,20,15,249,130,119,3,15,335,257,78,3,1996-12-22,0,0,"kan",-11
"1","Sun","August 31","L","","0-1",FALSE,"Denver Broncos",3,19,12,241,108,133,1,20,378,232,146,0,1997-08-31,-1,0,"kan",-16
"2","Mon","September 8","W","","1-1",FALSE,"Oakland Raiders",28,27,21,428,300,128,3,22,389,281,108,2,1997-09-08,-1,1,"kan",1
"3","Sun","September 14","W","","2-1",TRUE,"Buffalo Bills",22,16,17,267,160,107,0,16,325,275,50,2,1997-09-14,2,1,"kan",6
"4","Sun","September 21","W","","3-1",FALSE,"Carolina Panthers",35,14,18,331,214,117,1,24,364,278,86,5,1997-09-21,4,1,"kan",21
"5","Sun","September 28","W","OT","4-1",TRUE,"Seattle Seahawks",20,17,29,466,263,203,3,16,376,220,156,1,1997-09-28,-2,1,"kan",3
"6","Sun","October 5","L","","4-2",FALSE,"Miami Dolphins",14,17,14,259,163,96,0,19,337,254,83,0,1997-10-05,0,0,"kan",-3
"8","Thu","October 16","W","","5-2",TRUE,"San Diego Chargers",31,3,25,313,224,89,1,12,258,189,69,2,1997-10-16,1,1,"kan",28
"9","Sun","October 26","W","","6-2",FALSE,"St. Louis Rams",28,20,19,255,168,87,0,20,360,261,99,4,1997-10-26,4,1,"kan",8
"10","Mon","November 3","W","","7-2",TRUE,"Pittsburgh Steelers",13,10,24,392,209,183,2,12,235,93,142,1,1997-11-03,-1,1,"kan",3
"11","Sun","November 9","L","","7-3",FALSE,"Jacksonville Jaguars",10,24,22,413,265,148,5,16,332,182,150,2,1997-11-09,-3,0,"kan",-14
"12","Sun","November 16","W","","8-3",TRUE,"Denver Broncos",24,22,15,202,96,106,1,26,329,194,135,1,1997-11-16,0,1,"kan",2
"13","Sun","November 23","W","","9-3",FALSE,"Seattle Seahawks",19,14,22,324,204,120,2,18,291,223,68,3,1997-11-23,1,1,"kan",5
"14","Sun","November 30","W","","10-3",TRUE,"San Francisco 49ers",44,9,22,340,187,153,1,13,279,152,127,3,1997-11-30,2,1,"kan",35
"15","Sun","December 7","W","","11-3",TRUE,"Oakland Raiders",30,0,27,418,204,214,0,5,93,57,36,1,1997-12-07,1,1,"kan",30
"16","Sun","December 14","W","","12-3",FALSE,"San Diego Chargers",29,7,14,239,108,131,0,22,282,219,63,2,1997-12-14,2,1,"kan",22
"17","Sun","December 21","W","","13-3",TRUE,"New Orleans Saints",25,13,14,176,20,156,0,17,252,149,103,5,1997-12-21,5,1,"kan",12
"Division","Sun","January 4","L","","13-4",TRUE,"Denver Broncos",10,14,18,303,226,77,0,16,272,163,109,2,1998-01-04,2,0,"kan",-4
"1","Sun","September 6","W","","1-0",TRUE,"Oakland Raiders",28,8,18,300,157,143,0,18,264,212,52,5,1998-09-06,5,1,"kan",20
"2","Sun","September 13","L","","1-1",FALSE,"Jacksonville Jaguars",16,21,23,364,253,111,2,19,256,111,145,0,1998-09-13,-2,0,"kan",-5
"3","Sun","September 20","W","","2-1",TRUE,"San Diego Chargers",23,7,16,251,129,122,1,6,152,-19,171,6,1998-09-20,5,1,"kan",16
"4","Sun","September 27","W","","3-1",FALSE,"Philadelphia Eagles",24,21,24,393,262,131,0,24,361,250,111,1,1998-09-27,1,1,"kan",3
"5","Sun","October 4","W","","4-1",TRUE,"Seattle Seahawks",17,6,12,251,120,131,5,10,167,94,73,4,1998-10-04,-1,1,"kan",11
"6","Sun","October 11","L","","4-2",FALSE,"New England Patriots",10,40,9,134,120,14,2,31,438,232,206,1,1998-10-11,-1,0,"kan",-30
"8","Mon","October 26","L","","4-3",TRUE,"Pittsburgh Steelers",13,20,16,290,218,72,3,20,272,90,182,1,1998-10-26,-2,0,"kan",-7
"9","Sun","November 1","L","","4-4",TRUE,"New York Jets",17,20,13,204,112,92,3,17,306,253,53,1,1998-11-01,-2,0,"kan",-3
"10","Sun","November 8","L","","4-5",FALSE,"Seattle Seahawks",12,24,24,357,260,97,4,16,202,94,108,2,1998-11-08,-2,0,"kan",-12
"11","Mon","November 16","L","","4-6",TRUE,"Denver Broncos",7,30,15,221,190,31,1,26,379,174,205,0,1998-11-16,-1,0,"kan",-23
"12","Sun","November 22","L","","4-7",FALSE,"San Diego Chargers",37,38,21,366,297,69,2,25,366,271,95,3,1998-11-22,1,0,"kan",-1
"13","Sun","November 29","W","","5-7",TRUE,"Arizona Cardinals",34,24,20,376,248,128,1,22,338,214,124,2,1998-11-29,1,1,"kan",10
"14","Sun","December 6","L","","5-8",FALSE,"Denver Broncos",31,35,20,266,222,44,1,23,476,383,93,3,1998-12-06,2,0,"kan",-4
"15","Sun","December 13","W","","6-8",TRUE,"Dallas Cowboys",20,17,23,383,200,183,0,14,247,196,51,2,1998-12-13,2,1,"kan",3
"16","Sun","December 20","L","","6-9",FALSE,"New York Giants",7,28,15,279,218,61,4,25,309,149,160,0,1998-12-20,-4,0,"kan",-21
"17","Sat","December 26","W","","7-9",FALSE,"Oakland Raiders",31,24,20,373,254,119,3,25,321,281,40,2,1998-12-26,-1,1,"kan",7
"1","Sun","September 12","L","","0-1",FALSE,"Chicago Bears",17,20,17,349,278,71,1,22,388,307,81,2,1999-09-12,1,0,"kan",-3
"2","Sun","September 19","W","","1-1",TRUE,"Denver Broncos",26,10,17,365,177,188,1,20,244,156,88,4,1999-09-19,3,1,"kan",16
"3","Sun","September 26","W","","2-1",TRUE,"Detroit Lions",31,21,21,383,228,155,0,18,311,193,118,2,1999-09-26,2,1,"kan",10
"4","Sun","October 3","L","","2-2",FALSE,"San Diego Chargers",14,21,19,314,193,121,4,8,132,92,40,2,1999-10-03,-2,0,"kan",-7
"5","Sun","October 10","W","","3-2",TRUE,"New England Patriots",16,14,20,329,189,140,2,18,378,316,62,4,1999-10-10,2,1,"kan",2
"7","Thu","October 21","W","","4-2",FALSE,"Baltimore Ravens",35,8,12,218,106,112,0,18,277,172,105,3,1999-10-21,3,1,"kan",27
"8","Sun","October 31","W","","5-2",TRUE,"San Diego Chargers",34,0,11,283,186,97,0,10,213,141,72,4,1999-10-31,4,1,"kan",34
"9","Sun","November 7","L","","5-3",FALSE,"Indianapolis Colts",17,25,19,319,211,108,1,21,375,256,119,2,1999-11-07,1,0,"kan",-8
"10","Sun","November 14","L","","5-4",FALSE,"Tampa Bay Buccaneers",10,17,11,271,184,87,3,14,370,270,100,6,1999-11-14,3,0,"kan",-7
"11","Sun","November 21","L","","5-5",TRUE,"Seattle Seahawks",19,31,22,371,295,76,2,20,368,235,133,2,1999-11-21,0,0,"kan",-12
"12","Sun","November 28","W","","6-5",FALSE,"Oakland Raiders",37,34,16,293,195,98,3,18,315,207,108,3,1999-11-28,0,1,"kan",3
"13","Sun","December 5","W","","7-5",FALSE,"Denver Broncos",16,10,17,352,175,177,1,14,291,208,83,1,1999-12-05,0,1,"kan",6
"14","Sun","December 12","W","","8-5",TRUE,"Minnesota Vikings",31,28,22,380,207,173,2,21,326,151,175,4,1999-12-12,2,1,"kan",3
"15","Sat","December 18","W","","9-5",TRUE,"Pittsburgh Steelers",35,19,16,363,145,218,0,21,376,269,107,4,1999-12-18,4,1,"kan",16
"16","Sun","December 26","L","","9-6",FALSE,"Seattle Seahawks",14,23,17,302,230,72,3,17,267,207,60,0,1999-12-26,-3,0,"kan",-9
"17","Sun","January 2","L","OT","9-7",TRUE,"Oakland Raiders",38,41,25,429,240,189,1,21,408,302,106,2,2000-01-02,1,0,"kan",-3
"1","Sun","September 3","L","","0-1",TRUE,"Indianapolis Colts",14,27,17,280,206,74,1,20,386,267,119,2,2000-09-03,1,0,"kan",-13
"2","Sun","September 10","L","OT","0-2",FALSE,"Tennessee Titans",14,17,14,189,127,62,0,23,353,232,121,3,2000-09-10,3,0,"kan",-3
"3","Sun","September 17","W","","1-2",TRUE,"San Diego Chargers",42,10,25,349,232,117,1,10,187,138,49,2,2000-09-17,1,1,"kan",32
"4","Sun","September 24","W","","2-2",FALSE,"Denver Broncos",23,22,21,294,245,49,3,21,342,197,145,3,2000-09-24,0,1,"kan",1
"5","Mon","October 2","W","","3-2",TRUE,"Seattle Seahawks",24,17,18,378,242,136,0,20,289,103,186,2,2000-10-02,2,1,"kan",7
"7","Sun","October 15","L","","3-3",TRUE,"Oakland Raiders",17,20,20,346,288,58,1,23,391,230,161,1,2000-10-15,0,0,"kan",-3
"8","Sun","October 22","W","","4-3",TRUE,"St. Louis Rams",54,34,21,468,362,106,0,24,428,362,66,4,2000-10-22,4,1,"kan",20
"9","Sun","October 29","W","","5-3",FALSE,"Seattle Seahawks",24,19,17,410,334,76,3,22,351,208,143,4,2000-10-29,1,1,"kan",5
"10","Sun","November 5","L","","5-4",FALSE,"Oakland Raiders",31,49,31,513,474,39,3,31,473,242,231,0,2000-11-05,-3,0,"kan",-18
"11","Sun","November 12","L","","5-5",FALSE,"San Francisco 49ers",7,21,20,294,245,49,1,25,389,240,149,0,2000-11-12,-1,0,"kan",-14
"12","Sun","November 19","L","","5-6",TRUE,"Buffalo Bills",17,21,24,378,275,103,2,21,299,224,75,0,2000-11-19,-2,0,"kan",-4
"13","Sun","November 26","L","","5-7",FALSE,"San Diego Chargers",16,17,10,161,84,77,1,14,201,149,52,5,2000-11-26,4,0,"kan",-1
"14","Mon","December 4","L","","5-8",FALSE,"New England Patriots",24,30,18,418,350,68,3,24,368,263,105,1,2000-12-04,-2,0,"kan",-6
"15","Sun","December 10","W","","6-8",TRUE,"Carolina Panthers",15,14,26,453,315,138,4,21,257,234,23,1,2000-12-10,-3,1,"kan",1
"16","Sun","December 17","W","","7-8",TRUE,"Denver Broncos",20,7,24,424,160,264,2,11,278,225,53,1,2000-12-17,-1,1,"kan",13
"17","Sun","December 24","L","","7-9",FALSE,"Atlanta Falcons",13,29,15,259,210,49,1,20,288,157,131,0,2000-12-24,-1,0,"kan",-16
"1","Sun","September 9","L","","0-1",TRUE,"Oakland Raiders",24,27,16,254,219,35,3,23,427,327,100,3,2001-09-09,0,0,"kan",-3
"2","Sun","September 23","L","","0-2",TRUE,"New York Giants",3,13,11,266,178,88,1,20,299,201,98,3,2001-09-23,2,0,"kan",-10
"3","Sun","September 30","W","","1-2",FALSE,"Washington Redskins",45,13,29,546,346,200,0,11,218,107,111,1,2001-09-30,1,1,"kan",32
"4","Sun","October 7","L","","1-3",FALSE,"Denver Broncos",6,20,16,297,255,42,4,15,300,103,197,1,2001-10-07,-3,0,"kan",-14
"5","Sun","October 14","L","","1-4",TRUE,"Pittsburgh Steelers",17,20,19,271,106,165,1,16,316,113,203,0,2001-10-14,-1,0,"kan",-3
"6","Sun","October 21","L","","1-5",FALSE,"Arizona Cardinals",16,24,20,459,340,119,2,20,363,228,135,2,2001-10-21,0,0,"kan",-8
"7","Thu","October 25","L","","1-6",TRUE,"Indianapolis Colts",28,35,25,415,314,101,3,17,373,179,194,1,2001-10-25,-2,0,"kan",-7
"8","Sun","November 4","W","","2-6",FALSE,"San Diego Chargers",25,20,21,378,170,208,1,22,325,259,66,1,2001-11-04,0,1,"kan",5
"9","Sun","November 11","L","","2-7",FALSE,"New York Jets",7,27,16,224,124,100,4,22,353,179,174,2,2001-11-11,-2,0,"kan",-20
"11","Sun","November 25","W","","3-7",TRUE,"Seattle Seahawks",19,7,23,433,245,188,0,11,204,139,65,0,2001-11-25,0,1,"kan",12
"12","Thu","November 29","L","","3-8",TRUE,"Philadelphia Eagles",10,23,18,291,208,83,3,19,378,251,127,1,2001-11-29,-2,0,"kan",-13
"13","Sun","December 9","L","","3-9",FALSE,"Oakland Raiders",26,28,23,447,243,204,1,16,264,185,79,5,2001-12-09,4,0,"kan",-2
"14","Sun","December 16","W","OT","4-9",TRUE,"Denver Broncos",26,23,22,396,259,137,3,22,335,241,94,1,2001-12-16,-2,1,"kan",3
"15","Sun","December 23","W","","5-9",TRUE,"San Diego Chargers",20,17,24,323,203,120,2,20,329,164,165,0,2001-12-23,-2,1,"kan",3
"16","Sun","December 30","W","","6-9",FALSE,"Jacksonville Jaguars",30,26,23,365,273,92,4,22,431,249,182,3,2001-12-30,-1,1,"kan",4
"17","Sun","January 6","L","","6-10",FALSE,"Seattle Seahawks",18,21,18,308,182,126,1,20,389,239,150,2,2002-01-06,1,0,"kan",-3
"1","Sun","September 8","W","","1-0",FALSE,"Cleveland Browns",40,39,24,470,276,194,1,24,411,352,59,1,2002-09-08,0,1,"kan",1
"2","Sun","September 15","L","","1-1",TRUE,"Jacksonville Jaguars",16,23,18,336,196,140,2,19,450,320,130,1,2002-09-15,-1,0,"kan",-7
"3","Sun","September 22","L","OT","1-2",FALSE,"New England Patriots",38,41,21,349,128,221,3,27,496,399,97,1,2002-09-22,-2,0,"kan",-3
"4","Sun","September 29","W","","2-2",TRUE,"Miami Dolphins",48,30,25,450,328,122,0,28,399,294,105,5,2002-09-29,5,1,"kan",18
"5","Sun","October 6","W","","3-2",FALSE,"New York Jets",29,25,24,504,289,215,1,23,359,212,147,1,2002-10-06,0,1,"kan",4
"6","Sun","October 13","L","","3-3",FALSE,"San Diego Chargers",34,35,17,319,231,88,2,27,465,312,153,5,2002-10-13,3,0,"kan",-1
"7","Sun","October 20","L","OT","3-4",TRUE,"Denver Broncos",34,37,24,305,143,162,0,22,507,366,141,1,2002-10-20,1,0,"kan",-3
"8","Sun","October 27","W","","4-4",TRUE,"Oakland Raiders",20,10,22,323,190,133,2,26,417,334,83,2,2002-10-27,0,1,"kan",10
"10","Sun","November 10","L","","4-5",FALSE,"San Francisco 49ers",13,17,14,256,176,80,0,22,323,168,155,1,2002-11-10,1,0,"kan",-4
"11","Sun","November 17","W","","5-5",TRUE,"Buffalo Bills",17,16,22,320,192,128,0,21,344,211,133,1,2002-11-17,1,1,"kan",1
"12","Sun","November 24","L","","5-6",FALSE,"Seattle Seahawks",32,39,32,552,335,217,1,32,534,354,180,0,2002-11-24,-1,0,"kan",-7
"13","Sun","December 1","W","","6-6",TRUE,"Arizona Cardinals",49,0,27,477,261,216,1,10,122,96,26,4,2002-12-01,3,1,"kan",49
"14","Sun","December 8","W","","7-6",TRUE,"St. Louis Rams",49,10,21,293,113,180,0,16,202,169,33,3,2002-12-08,3,1,"kan",39
"15","Sun","December 15","L","","7-7",FALSE,"Denver Broncos",24,31,22,494,309,185,0,24,482,285,197,3,2002-12-15,3,0,"kan",-7
"16","Sun","December 22","W","","8-7",TRUE,"San Diego Chargers",24,22,19,376,323,53,1,20,383,235,148,1,2002-12-22,0,1,"kan",2
"17","Sat","December 28","L","","8-8",FALSE,"Oakland Raiders",0,24,11,176,132,44,1,26,354,74,280,1,2002-12-28,0,0,"kan",-24
"1","Sun","September 7","W","","1-0",TRUE,"San Diego Chargers",27,14,19,390,259,131,2,13,232,168,64,2,2003-09-07,0,1,"kan",13
"2","Sun","September 14","W","","2-0",TRUE,"Pittsburgh Steelers",41,20,19,282,123,159,2,16,380,320,60,4,2003-09-14,2,1,"kan",21
"3","Sun","September 21","W","","3-0",FALSE,"Houston Texans",42,14,27,426,258,168,2,20,316,209,107,4,2003-09-21,2,1,"kan",28
"4","Sun","September 28","W","","4-0",FALSE,"Baltimore Ravens",17,10,15,265,136,129,0,22,326,124,202,4,2003-09-28,4,1,"kan",7
"5","Sun","October 5","W","","5-0",TRUE,"Denver Broncos",24,23,13,262,129,133,2,22,468,292,176,1,2003-10-05,-1,1,"kan",1
"6","Sun","October 12","W","OT","6-0",FALSE,"Green Bay Packers",40,34,22,482,400,82,0,24,440,257,183,2,2003-10-12,2,1,"kan",6
"7","Mon","October 20","W","","7-0",FALSE,"Oakland Raiders",17,10,16,319,194,125,1,25,357,257,100,3,2003-10-20,2,1,"kan",7
"8","Sun","October 26","W","","8-0",TRUE,"Buffalo Bills",38,5,22,375,275,100,0,15,266,133,133,7,2003-10-26,7,1,"kan",33
"10","Sun","November 9","W","","9-0",TRUE,"Cleveland Browns",41,20,30,443,348,95,2,16,199,119,80,2,2003-11-09,0,1,"kan",21
"11","Sun","November 16","L","","9-1",FALSE,"Cincinnati Bengals",19,24,20,371,304,67,0,21,422,222,200,0,2003-11-16,0,0,"kan",-5
"12","Sun","November 23","W","","10-1",TRUE,"Oakland Raiders",27,24,22,384,242,142,0,20,379,213,166,0,2003-11-23,0,1,"kan",3
"13","Sun","November 30","W","","11-1",FALSE,"San Diego Chargers",28,24,23,335,141,194,2,17,370,211,159,3,2003-11-30,1,1,"kan",4
"14","Sun","December 7","L","","11-2",FALSE,"Denver Broncos",27,45,28,444,381,63,0,26,508,238,270,0,2003-12-07,0,0,"kan",-18
"15","Sun","December 14","W","","12-2",TRUE,"Detroit Lions",45,17,28,521,372,149,0,22,334,197,137,2,2003-12-14,2,1,"kan",28
"16","Sat","December 20","L","","12-3",FALSE,"Minnesota Vikings",20,45,21,329,224,105,4,27,469,246,223,1,2003-12-20,-3,0,"kan",-25
"17","Sun","December 28","W","","13-3",TRUE,"Chicago Bears",31,3,23,282,195,87,1,16,241,157,84,2,2003-12-28,1,1,"kan",28
"Division","Sun","January 11","L","","13-4",TRUE,"Indianapolis Colts",31,38,24,408,212,196,1,27,434,292,142,0,2004-01-11,-1,0,"kan",-7
"1","Sun","September 12","L","","0-1",FALSE,"Denver Broncos",24,34,15,318,151,167,1,24,413,221,192,3,2004-09-12,2,0,"kan",-10
"2","Sun","September 19","L","","0-2",TRUE,"Carolina Panthers",17,28,17,281,172,109,2,23,358,175,183,2,2004-09-19,0,0,"kan",-11
"3","Sun","September 26","L","","0-3",TRUE,"Houston Texans",21,24,25,366,198,168,1,18,296,220,76,1,2004-09-26,0,0,"kan",-3
"4","Mon","October 4","W","","1-3",FALSE,"Baltimore Ravens",27,24,25,398,220,178,0,13,207,127,80,0,2004-10-04,0,1,"kan",3
"6","Sun","October 17","L","","1-4",FALSE,"Jacksonville Jaguars",16,22,19,350,273,77,1,19,378,277,101,0,2004-10-17,-1,0,"kan",-6
"7","Sun","October 24","W","","2-4",TRUE,"Atlanta Falcons",56,10,36,540,269,271,1,9,222,103,119,2,2004-10-24,1,1,"kan",46
"8","Sun","October 31","W","","3-4",TRUE,"Indianapolis Colts",45,35,33,590,387,203,2,23,505,472,33,1,2004-10-31,-1,1,"kan",10
"9","Sun","November 7","L","","3-5",FALSE,"Tampa Bay Buccaneers",31,34,27,459,354,105,3,23,418,288,130,0,2004-11-07,-3,0,"kan",-3
"10","Sun","November 14","L","","3-6",FALSE,"New Orleans Saints",20,27,28,497,297,200,4,20,374,240,134,1,2004-11-14,-3,0,"kan",-7
"11","Mon","November 22","L","","3-7",TRUE,"New England Patriots",19,27,20,417,353,64,1,21,407,309,98,1,2004-11-22,0,0,"kan",-8
"12","Sun","November 28","L","","3-8",TRUE,"San Diego Chargers",31,34,20,310,200,110,2,25,498,371,127,0,2004-11-28,-2,0,"kan",-3
"13","Sun","December 5","W","","4-8",FALSE,"Oakland Raiders",34,27,29,500,340,160,1,16,364,333,31,0,2004-12-05,-1,1,"kan",7
"14","Mon","December 13","W","","5-8",FALSE,"Tennessee Titans",49,38,24,383,237,146,2,30,542,379,163,4,2004-12-13,2,1,"kan",11
"15","Sun","December 19","W","","6-8",TRUE,"Denver Broncos",45,17,22,410,248,162,0,24,402,273,129,3,2004-12-19,3,1,"kan",28
"16","Sat","December 25","W","","7-8",TRUE,"Oakland Raiders",31,30,32,433,334,99,2,18,300,200,100,1,2004-12-25,-1,1,"kan",1
"17","Sun","January 2","L","","7-9",FALSE,"San Diego Chargers",17,24,26,443,373,70,4,21,353,215,138,2,2005-01-02,-2,0,"kan",-7
"1","Sun","September 11","W","","1-0",TRUE,"New York Jets",27,7,23,389,191,198,1,19,390,333,57,3,2005-09-11,2,1,"kan",20
"2","Sun","September 18","W","","2-0",FALSE,"Oakland Raiders",23,17,17,354,229,125,1,16,327,255,72,2,2005-09-18,1,1,"kan",6
"3","Mon","September 26","L","","2-1",FALSE,"Denver Broncos",10,30,18,285,211,74,1,24,358,137,221,0,2005-09-26,-1,0,"kan",-20
"4","Sun","October 2","L","","2-2",TRUE,"Philadelphia Eagles",31,37,19,353,209,144,4,25,396,368,28,2,2005-10-02,-2,0,"kan",-6
"6","Sun","October 16","W","","3-2",TRUE,"Washington Redskins",28,21,18,274,178,96,0,26,398,297,101,3,2005-10-16,3,1,"kan",7
"7","Fri","October 21","W","","4-2",FALSE,"Miami Dolphins",30,20,24,462,277,185,0,9,286,192,94,1,2005-10-21,1,1,"kan",10
"8","Sun","October 30","L","","4-3",FALSE,"San Diego Chargers",20,28,21,418,323,95,1,22,424,341,83,2,2005-10-30,1,0,"kan",-8
"9","Sun","November 6","W","","5-3",TRUE,"Oakland Raiders",27,23,18,321,207,114,1,21,263,162,101,1,2005-11-06,0,1,"kan",4
"10","Sun","November 13","L","","5-4",FALSE,"Buffalo Bills",3,14,22,316,166,150,4,9,209,148,61,2,2005-11-13,-2,0,"kan",-11
"11","Sun","November 20","W","","6-4",FALSE,"Houston Texans",45,17,28,446,220,226,1,14,259,181,78,3,2005-11-20,2,1,"kan",28
"12","Sun","November 27","W","","7-4",TRUE,"New England Patriots",26,16,24,420,308,112,1,20,306,232,74,4,2005-11-27,3,1,"kan",10
"13","Sun","December 4","W","","8-4",TRUE,"Denver Broncos",31,27,24,421,253,168,3,19,388,257,131,2,2005-12-04,-1,1,"kan",4
"14","Sun","December 11","L","","8-5",FALSE,"Dallas Cowboys",28,31,25,493,332,161,1,21,445,316,129,0,2005-12-11,-1,0,"kan",-3
"15","Sat","December 17","L","","8-6",FALSE,"New York Giants",17,27,22,362,174,188,3,22,406,183,223,2,2005-12-17,-1,0,"kan",-10
"16","Sat","December 24","W","","9-6",TRUE,"San Diego Chargers",20,7,20,341,197,144,0,15,233,153,80,2,2005-12-24,2,1,"kan",13
"17","Sun","January 1","W","","10-6",TRUE,"Cincinnati Bengals",37,3,24,537,335,202,1,10,161,124,37,2,2006-01-01,1,1,"kan",34
"1","Sun","September 10","L","","0-1",TRUE,"Cincinnati Bengals",10,23,18,289,176,113,3,12,236,120,116,1,2006-09-10,-2,0,"kan",-13
"2","Sun","September 17","L","OT","0-2",FALSE,"Denver Broncos",6,9,16,276,131,145,2,18,318,173,145,1,2006-09-17,-1,0,"kan",-3
"4","Sun","October 1","W","","1-2",TRUE,"San Francisco 49ers",41,0,23,333,208,125,0,10,165,76,89,4,2006-10-01,4,1,"kan",41
"5","Sun","October 8","W","","2-2",FALSE,"Arizona Cardinals",23,20,18,301,262,39,2,18,298,222,76,1,2006-10-08,-1,1,"kan",3
"6","Sun","October 15","L","","2-3",FALSE,"Pittsburgh Steelers",7,45,14,213,175,38,3,23,457,238,219,1,2006-10-15,-2,0,"kan",-38
"7","Sun","October 22","W","","3-3",TRUE,"San Diego Chargers",30,27,19,355,221,134,1,22,349,252,97,3,2006-10-22,2,1,"kan",3
"8","Sun","October 29","W","","4-3",TRUE,"Seattle Seahawks",35,28,30,499,308,191,3,15,240,190,50,2,2006-10-29,-1,1,"kan",7
"9","Sun","November 5","W","","5-3",FALSE,"St. Louis Rams",31,17,16,317,131,186,0,28,452,337,115,3,2006-11-05,3,1,"kan",14
"10","Sun","November 12","L","","5-4",FALSE,"Miami Dolphins",10,13,14,265,185,80,0,16,306,189,117,1,2006-11-12,1,0,"kan",-3
"11","Sun","November 19","W","","6-4",TRUE,"Oakland Raiders",17,13,21,292,92,200,0,18,326,193,133,1,2006-11-19,1,1,"kan",4
"12","Thu","November 23","W","","7-4",TRUE,"Denver Broncos",19,10,22,382,159,223,1,16,244,206,38,1,2006-11-23,0,1,"kan",9
"13","Sun","December 3","L","OT","7-5",FALSE,"Cleveland Browns",28,31,24,417,293,124,2,26,438,288,150,2,2006-12-03,0,0,"kan",-3
"14","Sun","December 10","L","","7-6",TRUE,"Baltimore Ravens",10,20,17,276,141,135,3,18,376,283,93,1,2006-12-10,-2,0,"kan",-10
"15","Sun","December 17","L","","7-7",FALSE,"San Diego Chargers",9,20,16,241,151,90,2,16,353,88,265,2,2006-12-17,0,0,"kan",-11
"16","Sat","December 23","W","","8-7",FALSE,"Oakland Raiders",20,9,19,292,142,150,1,18,307,195,112,5,2006-12-23,4,1,"kan",11
"17","Sun","December 31","W","","9-7",TRUE,"Jacksonville Jaguars",35,30,23,395,225,170,3,24,397,284,113,1,2006-12-31,-2,1,"kan",5
"WildCard","Sat","January 6","L","","9-8",FALSE,"Indianapolis Colts",8,23,7,126,82,44,3,28,435,247,188,3,2007-01-06,0,0,"kan",-15
"1","Sun","September 9","L","","0-1",FALSE,"Houston Texans",3,20,14,219,147,72,4,13,315,206,109,2,2007-09-09,-2,0,"kan",-17
"2","Sun","September 16","L","","0-2",FALSE,"Chicago Bears",10,20,13,281,211,70,2,18,239,132,107,3,2007-09-16,1,0,"kan",-10
"3","Sun","September 23","W","","1-2",TRUE,"Minnesota Vikings",13,10,14,251,201,50,1,18,256,133,123,1,2007-09-23,0,1,"kan",3
"4","Sun","September 30","W","","2-2",FALSE,"San Diego Chargers",30,16,17,390,264,126,2,19,333,200,133,4,2007-09-30,2,1,"kan",14
"5","Sun","October 7","L","","2-3",TRUE,"Jacksonville Jaguars",7,17,14,271,261,10,1,20,357,201,156,0,2007-10-07,-1,0,"kan",-10
"6","Sun","October 14","W","","3-3",TRUE,"Cincinnati Bengals",27,20,20,354,233,121,2,22,373,295,78,3,2007-10-14,1,1,"kan",7
"7","Sun","October 21","W","","4-3",FALSE,"Oakland Raiders",12,10,14,290,164,126,1,10,268,213,55,2,2007-10-21,1,1,"kan",2
"9","Sun","November 4","L","","4-4",TRUE,"Green Bay Packers",22,33,20,234,173,61,2,19,432,354,78,2,2007-11-04,0,0,"kan",-11
"10","Sun","November 11","L","","4-5",TRUE,"Denver Broncos",11,27,19,284,217,67,4,18,327,186,141,1,2007-11-11,-3,0,"kan",-16
"11","Sun","November 18","L","","4-6",FALSE,"Indianapolis Colts",10,13,11,234,162,72,2,16,216,150,66,1,2007-11-18,-1,0,"kan",-3
"12","Sun","November 25","L","","4-7",TRUE,"Oakland Raiders",17,20,18,292,128,164,1,19,312,159,153,1,2007-11-25,0,0,"kan",-3
"13","Sun","December 2","L","","4-8",TRUE,"San Diego Chargers",10,24,18,268,180,88,4,12,330,139,191,1,2007-12-02,-3,0,"kan",-14
"14","Sun","December 9","L","","4-9",FALSE,"Denver Broncos",7,41,7,129,113,16,3,23,453,238,215,0,2007-12-09,-3,0,"kan",-34
"15","Sun","December 16","L","","4-10",TRUE,"Tennessee Titans",17,26,17,306,217,89,3,19,327,179,148,0,2007-12-16,-3,0,"kan",-9
"16","Sun","December 23","L","","4-11",FALSE,"Detroit Lions",20,25,25,407,344,63,1,12,236,99,137,1,2007-12-23,0,0,"kan",-5
"17","Sun","December 30","L","OT","4-12",FALSE,"New York Jets",10,13,14,219,166,53,0,20,337,138,199,0,2007-12-30,0,0,"kan",-3
"1","Sun","September 7","L","","0-1",FALSE,"New England Patriots",10,17,14,284,182,102,1,18,338,212,126,2,2008-09-07,1,0,"kan",-7
"2","Sun","September 14","L","","0-2",TRUE,"Oakland Raiders",8,23,15,190,135,55,2,18,355,55,300,2,2008-09-14,0,0,"kan",-15
"3","Sun","September 21","L","","0-3",FALSE,"Atlanta Falcons",14,38,17,301,117,184,3,16,378,192,186,1,2008-09-21,-2,0,"kan",-24
"4","Sun","September 28","W","","1-3",TRUE,"Denver Broncos",33,19,17,370,157,213,1,22,446,352,94,4,2008-09-28,3,1,"kan",14
"5","Sun","October 5","L","","1-4",FALSE,"Carolina Panthers",0,34,8,127,92,35,3,20,441,236,205,2,2008-10-05,-1,0,"kan",-34
"7","Sun","October 19","L","","1-5",TRUE,"Tennessee Titans",10,34,13,272,214,58,0,20,455,123,332,0,2008-10-19,0,0,"kan",-24
"8","Sun","October 26","L","","1-6",FALSE,"New York Jets",24,28,17,330,250,80,0,22,420,285,135,3,2008-10-26,3,0,"kan",-4
"9","Sun","November 2","L","OT","1-7",TRUE,"Tampa Bay Buccaneers",27,30,21,384,201,183,1,24,423,342,81,4,2008-11-02,3,0,"kan",-3
"10","Sun","November 9","L","","1-8",FALSE,"San Diego Chargers",19,20,19,339,263,76,0,23,400,308,92,2,2008-11-09,2,0,"kan",-1
"11","Sun","November 16","L","","1-9",TRUE,"New Orleans Saints",20,30,21,330,206,124,1,22,369,266,103,1,2008-11-16,0,0,"kan",-10
"12","Sun","November 23","L","","1-10",TRUE,"Buffalo Bills",31,54,21,462,303,159,5,27,444,273,171,0,2008-11-23,-5,0,"kan",-23
"13","Sun","November 30","W","","2-10",FALSE,"Oakland Raiders",20,13,17,301,156,145,1,14,271,132,139,2,2008-11-30,1,1,"kan",7
"14","Sun","December 7","L","","2-11",FALSE,"Denver Broncos",17,24,14,260,177,83,0,27,425,286,139,1,2008-12-07,1,0,"kan",-7
"15","Sun","December 14","L","","2-12",TRUE,"San Diego Chargers",21,22,22,277,175,102,2,22,394,326,68,3,2008-12-14,1,0,"kan",-1
"16","Sun","December 21","L","","2-13",TRUE,"Miami Dolphins",31,38,23,492,312,180,4,26,403,235,168,2,2008-12-21,-2,0,"kan",-7
"17","Sun","December 28","L","","2-14",FALSE,"Cincinnati Bengals",6,16,14,220,189,31,1,23,329,125,204,0,2008-12-28,-1,0,"kan",-10
"1","Sun","September 13","L","","0-1",FALSE,"Baltimore Ravens",24,38,11,188,159,29,0,32,501,303,198,1,2009-09-13,1,0,"kan",-14
"2","Sun","September 20","L","","0-2",TRUE,"Oakland Raiders",10,13,25,409,236,173,2,11,166,99,67,0,2009-09-20,-2,0,"kan",-3
"3","Sun","September 27","L","","0-3",FALSE,"Philadelphia Eagles",14,34,11,196,97,99,1,21,420,327,93,1,2009-09-27,0,0,"kan",-20
"4","Sun","October 4","L","","0-4",TRUE,"New York Giants",16,27,15,212,88,124,1,21,429,273,156,2,2009-10-04,1,0,"kan",-11
"5","Sun","October 11","L","OT","0-5",TRUE,"Dallas Cowboys",20,26,20,304,232,72,0,20,498,348,150,2,2009-10-11,2,0,"kan",-6
"6","Sun","October 18","W","","1-5",FALSE,"Washington Redskins",14,6,16,268,158,110,0,7,265,147,118,2,2009-10-18,2,1,"kan",8
"7","Sun","October 25","L","","1-6",TRUE,"San Diego Chargers",7,37,10,203,82,121,3,17,403,268,135,0,2009-10-25,-3,0,"kan",-30
"9","Sun","November 8","L","","1-7",FALSE,"Jacksonville Jaguars",21,24,14,301,241,60,0,21,426,253,173,1,2009-11-08,1,0,"kan",-3
"10","Sun","November 15","W","","2-7",FALSE,"Oakland Raiders",16,10,14,318,206,112,3,11,272,90,182,2,2009-11-15,-1,1,"kan",6
"11","Sun","November 22","W","OT","3-7",TRUE,"Pittsburgh Steelers",27,24,13,282,214,68,1,27,516,402,114,3,2009-11-22,2,1,"kan",3
"12","Sun","November 29","L","","3-8",FALSE,"San Diego Chargers",14,43,16,284,170,114,4,26,426,332,94,1,2009-11-29,-3,0,"kan",-29
"13","Sun","December 6","L","","3-9",TRUE,"Denver Broncos",13,44,14,222,128,94,3,24,413,168,245,3,2009-12-06,0,0,"kan",-31
"14","Sun","December 13","L","","3-10",TRUE,"Buffalo Bills",10,16,16,354,202,152,4,13,273,73,200,3,2009-12-13,-1,0,"kan",-6
"15","Sun","December 20","L","","3-11",TRUE,"Cleveland Browns",34,41,22,491,323,168,1,20,417,66,351,3,2009-12-20,2,0,"kan",-7
"16","Sun","December 27","L","","3-12",FALSE,"Cincinnati Bengals",10,17,17,295,172,123,2,17,274,130,144,1,2009-12-27,-1,0,"kan",-7
"17","Sun","January 3","W","","4-12",FALSE,"Denver Broncos",44,24,22,524,207,317,2,30,512,428,84,3,2010-01-03,1,1,"kan",20
"1","Mon","September 13","W","","1-0",TRUE,"San Diego Chargers",21,14,9,197,62,135,0,18,389,280,109,1,2010-09-13,1,1,"kan",7
"2","Sun","September 19","W","","2-0",FALSE,"Cleveland Browns",16,14,16,312,172,140,2,13,299,226,73,2,2010-09-19,0,1,"kan",2
"3","Sun","September 26","W","","3-0",TRUE,"San Francisco 49ers",31,10,21,457,250,207,1,11,251,208,43,1,2010-09-26,0,1,"kan",21
"5","Sun","October 10","L","","3-1",FALSE,"Indianapolis Colts",9,19,16,261,148,113,1,23,341,244,97,1,2010-10-10,0,0,"kan",-10
"6","Sun","October 17","L","","3-2",FALSE,"Houston Texans",31,35,25,417,189,228,0,23,421,289,132,0,2010-10-17,0,0,"kan",-4
"7","Sun","October 24","W","","4-2",TRUE,"Jacksonville Jaguars",42,20,25,426,190,236,0,19,300,216,84,3,2010-10-24,3,1,"kan",22
"8","Sun","October 31","W","OT","5-2",TRUE,"Buffalo Bills",13,10,24,414,140,274,0,23,328,191,137,1,2010-10-31,1,1,"kan",3
"9","Sun","November 7","L","OT","5-3",FALSE,"Oakland Raiders",20,23,21,304,200,104,2,17,321,209,112,3,2010-11-07,1,0,"kan",-3
"10","Sun","November 14","L","","5-4",FALSE,"Denver Broncos",29,49,30,484,433,51,1,25,452,299,153,0,2010-11-14,-1,0,"kan",-20
"11","Sun","November 21","W","","6-4",TRUE,"Arizona Cardinals",31,13,17,352,193,159,0,19,382,281,101,0,2010-11-21,0,1,"kan",18
"12","Sun","November 28","W","","7-4",FALSE,"Seattle Seahawks",42,24,28,503,233,270,1,13,288,268,20,3,2010-11-28,2,1,"kan",18
"13","Sun","December 5","W","","8-4",TRUE,"Denver Broncos",10,6,21,359,174,185,1,13,247,86,161,1,2010-12-05,0,1,"kan",4
"14","Sun","December 12","L","","8-5",FALSE,"San Diego Chargers",0,31,5,67,19,48,0,25,426,219,207,2,2010-12-12,2,0,"kan",-31
"15","Sun","December 19","W","","9-5",FALSE,"St. Louis Rams",27,13,21,383,173,210,1,14,224,155,69,2,2010-12-19,1,1,"kan",14
"16","Sun","December 26","W","","10-5",TRUE,"Tennessee Titans",34,14,23,458,306,152,2,16,270,213,57,2,2010-12-26,0,1,"kan",20
"17","Sun","January 2","L","","10-6",TRUE,"Oakland Raiders",10,31,17,201,86,115,2,21,344,135,209,1,2011-01-02,-1,0,"kan",-21
"WildCard","Sun","January 9","L","","10-7",TRUE,"Baltimore Ravens",7,30,8,161,53,108,5,26,390,248,142,2,2011-01-09,-3,0,"kan",-23
"1","Sun","September 11","L","","0-1",TRUE,"Buffalo Bills",7,41,13,213,105,108,3,23,364,201,163,1,2011-09-11,-2,0,"kan",-34
"2","Sun","September 18","L","","0-2",FALSE,"Detroit Lions",3,48,12,267,116,151,6,23,411,322,89,1,2011-09-18,-5,0,"kan",-45
"3","Sun","September 25","L","","0-3",FALSE,"San Diego Chargers",17,20,13,252,171,81,1,22,375,258,117,2,2011-09-25,1,0,"kan",-3
"4","Sun","October 2","W","","1-3",TRUE,"Minnesota Vikings",22,17,15,350,247,103,0,17,341,190,151,1,2011-10-02,1,1,"kan",5
"5","Sun","October 9","W","","2-3",FALSE,"Indianapolis Colts",28,24,26,436,242,194,0,15,355,277,78,0,2011-10-09,0,1,"kan",4
"7","Sun","October 23","W","","3-3",FALSE,"Oakland Raiders",28,0,22,300,161,139,2,18,322,167,155,6,2011-10-23,4,1,"kan",28
"8","Mon","October 31","W","OT","4-3",TRUE,"San Diego Chargers",23,20,19,341,247,94,4,22,447,345,102,4,2011-10-31,0,1,"kan",3
"9","Sun","November 6","L","","4-4",TRUE,"Miami Dolphins",3,31,20,343,227,116,0,17,351,244,107,0,2011-11-06,0,0,"kan",-28
"10","Sun","November 13","L","","4-5",TRUE,"Denver Broncos",10,17,17,258,124,134,0,16,313,69,244,0,2011-11-13,0,0,"kan",-7
"11","Mon","November 21","L","","4-6",FALSE,"New England Patriots",3,34,16,334,209,125,3,20,380,223,157,1,2011-11-21,-2,0,"kan",-31
"12","Sun","November 27","L","","4-7",TRUE,"Pittsburgh Steelers",9,13,15,252,162,90,4,18,290,182,108,2,2011-11-27,-2,0,"kan",-4
"13","Sun","December 4","W","","5-7",FALSE,"Chicago Bears",10,3,13,252,139,113,1,11,181,88,93,3,2011-12-04,2,1,"kan",7
"14","Sun","December 11","L","","5-8",FALSE,"New York Jets",10,37,13,221,156,65,1,24,314,155,159,1,2011-12-11,0,0,"kan",-27
"15","Sun","December 18","W","","6-8",TRUE,"Green Bay Packers",19,14,23,438,299,139,0,16,315,213,102,0,2011-12-18,0,1,"kan",5
"16","Sat","December 24","L","OT","6-9",TRUE,"Oakland Raiders",13,16,26,435,300,135,2,13,308,237,71,2,2011-12-24,0,0,"kan",-3
"17","Sun","January 1","W","","7-9",FALSE,"Denver Broncos",7,3,14,281,175,106,1,16,266,50,216,2,2012-01-01,1,1,"kan",4
"1","Mon","September 9","W","","1-0",TRUE,"Washington Redskins",44,14,19,319,206,113,1,24,369,249,120,7,1985-09-09,6,1,"dal",30
"2","Sun","September 15","L","","1-1",FALSE,"Detroit Lions",21,26,33,554,452,102,5,13,200,128,72,1,1985-09-15,-4,0,"dal",-5
"3","Sun","September 22","W","","2-1",TRUE,"Cleveland Browns",20,7,20,343,212,131,2,15,297,169,128,3,1985-09-22,1,1,"dal",13
"4","Sun","September 29","W","","3-1",FALSE,"Houston Oilers",17,10,16,339,183,156,0,13,214,133,81,5,1985-09-29,5,1,"dal",7
"5","Sun","October 6","W","","4-1",FALSE,"New York Giants",30,29,27,423,317,106,4,19,473,403,70,5,1985-10-06,1,1,"dal",1
"6","Sun","October 13","W","","5-1",TRUE,"Pittsburgh Steelers",27,13,18,374,241,133,2,14,315,231,84,3,1985-10-13,1,1,"dal",14
"7","Sun","October 20","L","","5-2",FALSE,"Philadelphia Eagles",14,16,22,310,163,147,4,22,402,347,55,1,1985-10-20,-3,0,"dal",-2
"8","Sun","October 27","W","","6-2",TRUE,"Atlanta Falcons",24,10,28,461,352,109,4,18,253,91,162,4,1985-10-27,0,1,"dal",14
"9","Mon","November 4","L","","6-3",FALSE,"St. Louis Cardinals",10,21,18,248,159,89,3,19,286,237,49,0,1985-11-04,-3,0,"dal",-11
"10","Sun","November 10","W","","7-3",FALSE,"Washington Redskins",13,7,14,338,219,119,0,15,267,143,124,3,1985-11-10,3,1,"dal",6
"11","Sun","November 17","L","","7-4",TRUE,"Chicago Bears",0,44,12,171,119,52,5,18,378,162,216,1,1985-11-17,-4,0,"dal",-44
"12","Sun","November 24","W","","8-4",TRUE,"Philadelphia Eagles",34,17,28,377,234,143,1,20,402,277,125,3,1985-11-24,2,1,"dal",17
"13","Thu","November 28","W","","9-4",TRUE,"St. Louis Cardinals",35,17,23,393,277,116,1,24,365,281,84,3,1985-11-28,2,1,"dal",18
"14","Sun","December 8","L","","9-5",FALSE,"Cincinnati Bengals",24,50,20,260,196,64,4,31,570,296,274,2,1985-12-08,-2,0,"dal",-26
"15","Sun","December 15","W","","10-5",TRUE,"New York Giants",28,21,13,273,172,101,1,25,396,296,100,4,1985-12-15,3,1,"dal",7
"16","Sun","December 22","L","","10-6",FALSE,"San Francisco 49ers",16,31,25,419,359,60,4,22,421,312,109,3,1985-12-22,-1,0,"dal",-15
"Division","Sat","January 4","L","","10-7",FALSE,"Los Angeles Rams",0,20,15,243,182,61,6,15,316,47,269,2,1986-01-04,-4,0,"dal",-20
"1","Mon","September 8","W","","1-0",TRUE,"New York Giants",31,28,22,378,265,113,2,24,377,261,116,2,1986-09-08,0,1,"dal",3
"2","Sun","September 14","W","","2-0",FALSE,"Detroit Lions",31,7,24,388,191,197,2,12,184,104,80,3,1986-09-14,1,1,"dal",24
"3","Sun","September 21","L","","2-1",TRUE,"Atlanta Falcons",35,37,22,415,263,152,4,26,420,233,187,1,1986-09-21,-3,0,"dal",-2
"4","Mon","September 29","W","","3-1",FALSE,"St. Louis Cardinals",31,7,18,287,180,107,2,13,225,92,133,4,1986-09-29,2,1,"dal",24
"5","Sun","October 5","L","","3-2",FALSE,"Denver Broncos",14,29,19,266,225,41,3,19,319,198,121,1,1986-10-05,-2,0,"dal",-15
"6","Sun","October 12","W","","4-2",TRUE,"Washington Redskins",30,6,25,424,318,106,2,14,184,113,71,3,1986-10-12,1,1,"dal",24
"7","Sun","October 19","W","","5-2",FALSE,"Philadelphia Eagles",17,14,17,389,253,136,2,19,317,100,217,0,1986-10-19,-2,1,"dal",3
"8","Sun","October 26","W","","6-2",TRUE,"St. Louis Cardinals",37,6,30,445,268,177,1,11,200,152,48,1,1986-10-26,0,1,"dal",31
"9","Sun","November 2","L","","6-3",FALSE,"New York Giants",14,17,25,408,306,102,3,14,245,46,199,3,1986-11-02,0,0,"dal",-3
"10","Sun","November 9","L","","6-4",TRUE,"Los Angeles Raiders",13,17,20,313,147,166,6,15,246,116,130,4,1986-11-09,-2,0,"dal",-4
"11","Sun","November 16","W","","7-4",FALSE,"San Diego Chargers",24,21,20,254,153,101,1,19,307,242,65,2,1986-11-16,1,1,"dal",3
"12","Sun","November 23","L","","7-5",FALSE,"Washington Redskins",14,41,16,251,197,54,3,23,483,316,167,1,1986-11-23,-2,0,"dal",-27
"13","Thu","November 27","L","","7-6",TRUE,"Seattle Seahawks",14,31,22,328,201,127,1,24,415,214,201,1,1986-11-27,0,0,"dal",-17
"14","Sun","December 7","L","","7-7",FALSE,"Los Angeles Rams",10,29,14,224,140,84,2,21,418,212,206,1,1986-12-07,-1,0,"dal",-19
"15","Sun","December 14","L","","7-8",TRUE,"Philadelphia Eagles",21,23,15,444,248,196,2,15,323,225,98,2,1986-12-14,0,0,"dal",-2
"16","Sun","December 21","L","","7-9",TRUE,"Chicago Bears",10,24,16,260,150,110,5,17,322,161,161,6,1986-12-21,1,0,"dal",-14
"1","Sun","September 13","L","","0-1",FALSE,"St. Louis Cardinals",13,24,19,322,197,125,1,20,360,252,108,0,1987-09-13,-1,0,"dal",-11
"2","Sun","September 20","W","","1-1",FALSE,"New York Giants",16,14,21,356,242,114,4,14,265,205,60,5,1987-09-20,1,1,"dal",2
"3","Sun","October 4","W","","2-1",FALSE,"New York Jets",38,24,14,246,132,114,4,22,241,159,82,5,1987-10-04,1,1,"dal",14
"4","Sun","October 11","W","","3-1",TRUE,"Philadelphia Eagles",41,22,19,400,240,160,2,24,434,362,72,3,1987-10-11,1,1,"dal",19
"5","Mon","October 19","L","","3-2",TRUE,"Washington Redskins",7,13,18,316,223,93,3,19,339,153,186,3,1987-10-19,0,0,"dal",-6
"6","Sun","October 25","L","","3-3",FALSE,"Philadelphia Eagles",20,37,18,294,197,97,3,18,237,96,141,1,1987-10-25,-2,0,"dal",-17
"7","Mon","November 2","W","","4-3",TRUE,"New York Giants",33,24,15,240,214,26,2,16,297,242,55,5,1987-11-02,3,1,"dal",9
"8","Sun","November 8","L","","4-4",FALSE,"Detroit Lions",17,27,20,290,167,123,5,20,293,217,76,4,1987-11-08,-1,0,"dal",-10
"9","Sun","November 15","W","OT","5-4",FALSE,"New England Patriots",23,17,24,438,257,181,3,15,265,177,88,2,1987-11-15,-1,1,"dal",6
"10","Sun","November 22","L","","5-5",TRUE,"Miami Dolphins",14,20,16,319,134,185,3,21,440,258,182,1,1987-11-22,-2,0,"dal",-6
"11","Thu","November 26","L","OT","5-6",TRUE,"Minnesota Vikings",38,44,23,403,291,112,5,27,476,288,188,2,1987-11-26,-3,0,"dal",-6
"12","Sun","December 6","L","","5-7",TRUE,"Atlanta Falcons",10,21,24,354,263,91,3,18,364,253,111,4,1987-12-06,1,0,"dal",-11
"13","Sun","December 13","L","","5-8",FALSE,"Washington Redskins",20,24,25,428,341,87,2,15,317,249,68,2,1987-12-13,0,0,"dal",-4
"14","Mon","December 21","W","","6-8",FALSE,"Los Angeles Rams",29,21,20,365,171,194,0,19,311,237,74,4,1987-12-21,4,1,"dal",8
"15","Sun","December 27","W","","7-8",TRUE,"St. Louis Cardinals",21,16,17,285,122,163,0,26,422,296,126,2,1987-12-27,2,1,"dal",5
"1","Sun","September 4","L","","0-1",FALSE,"Pittsburgh Steelers",21,24,25,414,280,134,3,17,356,214,142,0,1988-09-04,-3,0,"dal",-3
"2","Mon","September 12","W","","1-1",FALSE,"Phoenix Cardinals",17,14,18,352,162,190,1,22,367,237,130,1,1988-09-12,0,1,"dal",3
"3","Sun","September 18","L","","1-2",TRUE,"New York Giants",10,12,22,366,275,91,2,21,278,150,128,2,1988-09-18,0,0,"dal",-2
"4","Sun","September 25","W","","2-2",TRUE,"Atlanta Falcons",26,20,17,323,210,113,1,15,314,207,107,2,1988-09-25,1,1,"dal",6
"5","Mon","October 3","L","","2-3",FALSE,"New Orleans Saints",17,20,28,457,271,186,3,17,333,268,65,1,1988-10-03,-2,0,"dal",-3
"6","Sun","October 9","L","","2-4",TRUE,"Washington Redskins",17,35,18,361,301,60,5,19,350,170,180,1,1988-10-09,-4,0,"dal",-18
"7","Sun","October 16","L","","2-5",FALSE,"Chicago Bears",7,17,18,291,195,96,2,24,385,261,124,1,1988-10-16,-1,0,"dal",-10
"8","Sun","October 23","L","","2-6",FALSE,"Philadelphia Eagles",23,24,25,437,332,105,1,23,339,274,65,2,1988-10-23,1,0,"dal",-1
"9","Sun","October 30","L","","2-7",TRUE,"Phoenix Cardinals",10,16,11,228,103,125,2,15,295,135,160,0,1988-10-30,-2,0,"dal",-6
"10","Sun","November 6","L","","2-8",FALSE,"New York Giants",21,29,21,365,262,103,3,15,262,151,111,1,1988-11-06,-2,0,"dal",-8
"11","Sun","November 13","L","","2-9",TRUE,"Minnesota Vikings",3,43,12,159,49,110,7,18,325,222,103,1,1988-11-13,-6,0,"dal",-40
"12","Sun","November 20","L","","2-10",TRUE,"Cincinnati Bengals",24,38,23,355,176,179,2,23,410,196,214,1,1988-11-20,-1,0,"dal",-14
"13","Thu","November 24","L","","2-11",TRUE,"Houston Oilers",17,25,17,282,203,79,2,19,355,210,145,0,1988-11-24,-2,0,"dal",-8
"14","Sun","December 4","L","","2-12",FALSE,"Cleveland Browns",21,24,22,410,247,163,1,16,302,275,27,1,1988-12-04,0,0,"dal",-3
"15","Sun","December 11","W","","3-12",FALSE,"Washington Redskins",24,17,21,444,320,124,2,15,372,348,24,5,1988-12-11,3,1,"dal",7
"16","Sun","December 18","L","","3-13",TRUE,"Philadelphia Eagles",7,23,13,239,102,137,3,18,371,238,133,0,1988-12-18,-3,0,"dal",-16
"1","Sun","September 10","L","","0-1",FALSE,"New Orleans Saints",0,28,10,174,154,20,2,26,344,145,199,1,1989-09-10,-1,0,"dal",-28
"2","Sun","September 17","L","","0-2",FALSE,"Atlanta Falcons",21,27,18,349,241,108,3,23,333,243,90,0,1989-09-17,-3,0,"dal",-6
"3","Sun","September 24","L","","0-3",TRUE,"Washington Redskins",7,30,10,190,156,34,4,20,373,208,165,1,1989-09-24,-3,0,"dal",-23
"4","Sun","October 1","L","","0-4",TRUE,"New York Giants",13,30,12,288,201,87,2,20,342,205,137,5,1989-10-01,3,0,"dal",-17
"5","Sun","October 8","L","","0-5",FALSE,"Green Bay Packers",13,31,12,213,168,45,2,28,502,313,189,1,1989-10-08,-1,0,"dal",-18
"6","Sun","October 15","L","","0-6",TRUE,"San Francisco 49ers",14,31,19,330,270,60,3,17,318,172,146,1,1989-10-15,-2,0,"dal",-17
"7","Sun","October 22","L","","0-7",FALSE,"Kansas City Chiefs",28,36,14,282,166,116,1,26,423,221,202,0,1989-10-22,-1,0,"dal",-8
"8","Sun","October 29","L","","0-8",TRUE,"Phoenix Cardinals",10,19,18,309,264,45,3,17,300,142,158,0,1989-10-29,-3,0,"dal",-9
"9","Sun","November 5","W","","1-8",FALSE,"Washington Redskins",13,3,17,262,114,148,0,20,346,296,50,2,1989-11-05,2,1,"dal",10
"10","Sun","November 12","L","","1-9",FALSE,"Phoenix Cardinals",20,24,21,444,367,77,4,15,385,316,69,0,1989-11-12,-4,0,"dal",-4
"11","Sun","November 19","L","","1-10",TRUE,"Miami Dolphins",14,17,28,428,261,167,2,18,303,238,65,1,1989-11-19,-1,0,"dal",-3
"12","Thu","November 23","L","","1-11",TRUE,"Philadelphia Eagles",0,27,10,191,68,123,5,22,381,243,138,1,1989-11-23,-4,0,"dal",-27
"13","Sun","December 3","L","","1-12",TRUE,"Los Angeles Rams",31,35,20,303,165,138,4,20,403,325,78,3,1989-12-03,-1,0,"dal",-4
"14","Sun","December 10","L","","1-13",FALSE,"Philadelphia Eagles",10,20,14,194,107,87,1,19,280,158,122,0,1989-12-10,-1,0,"dal",-10
"15","Sat","December 16","L","","1-14",FALSE,"New York Giants",0,15,7,108,67,41,1,14,273,133,140,0,1989-12-16,-1,0,"dal",-15
"16","Sun","December 24","L","","1-15",TRUE,"Green Bay Packers",10,20,16,229,116,113,5,16,250,207,43,1,1989-12-24,-4,0,"dal",-10
"1","Sun","September 9","W","","1-0",TRUE,"San Diego Chargers",17,14,14,249,161,88,1,12,212,127,85,2,1990-09-09,1,1,"dal",3
"2","Sun","September 16","L","","1-1",TRUE,"New York Giants",7,28,9,156,136,20,4,23,369,208,161,3,1990-09-16,-1,0,"dal",-21
"3","Sun","September 23","L","","1-2",FALSE,"Washington Redskins",15,19,19,234,143,91,3,11,214,135,79,1,1990-09-23,-2,0,"dal",-4
"4","Sun","September 30","L","","1-3",FALSE,"New York Giants",17,31,20,284,233,51,2,21,334,198,136,0,1990-09-30,-2,0,"dal",-14
"5","Sun","October 7","W","","2-3",TRUE,"Tampa Bay Buccaneers",14,10,19,304,149,155,1,12,271,164,107,1,1990-10-07,0,1,"dal",4
"6","Sun","October 14","L","","2-4",FALSE,"Phoenix Cardinals",3,20,9,100,34,66,3,23,414,191,223,2,1990-10-14,-1,0,"dal",-17
"7","Sun","October 21","W","","3-4",FALSE,"Tampa Bay Buccaneers",17,13,14,223,145,78,1,22,331,241,90,5,1990-10-21,4,1,"dal",4
"8","Sun","October 28","L","","3-5",TRUE,"Philadelphia Eagles",20,21,23,345,215,130,1,23,304,160,144,1,1990-10-28,0,0,"dal",-1
"9","Sun","November 4","L","","3-6",FALSE,"New York Jets",9,24,18,321,226,95,2,15,187,71,116,0,1990-11-04,-2,0,"dal",-15
"10","Sun","November 11","L","","3-7",TRUE,"San Francisco 49ers",6,24,9,158,80,78,2,25,388,281,107,2,1990-11-11,0,0,"dal",-18
"11","Sun","November 18","W","","4-7",FALSE,"Los Angeles Rams",24,21,17,359,295,64,1,18,292,124,168,1,1990-11-18,0,1,"dal",3
"12","Thu","November 22","W","","5-7",TRUE,"Washington Redskins",27,17,18,370,208,162,2,20,297,261,36,1,1990-11-22,-1,1,"dal",10
"13","Sun","December 2","W","","6-7",TRUE,"New Orleans Saints",17,13,17,274,161,113,1,14,283,170,113,1,1990-12-02,0,1,"dal",4
"15","Sun","December 16","W","","7-7",TRUE,"Phoenix Cardinals",41,10,25,354,166,188,3,9,200,151,49,4,1990-12-16,1,1,"dal",31
"16","Sun","December 23","L","","7-8",FALSE,"Philadelphia Eagles",3,17,11,199,125,74,4,17,276,98,178,3,1990-12-23,-1,0,"dal",-14
"17","Sun","December 30","L","","7-9",FALSE,"Atlanta Falcons",7,26,8,151,104,47,2,15,243,59,184,3,1990-12-30,1,0,"dal",-19
"1","Sun","September 1","W","","1-0",FALSE,"Cleveland Browns",26,14,25,395,265,130,0,15,275,243,32,0,1991-09-01,0,1,"dal",12
"2","Mon","September 9","L","","1-1",TRUE,"Washington Redskins",31,33,19,349,224,125,2,20,332,192,140,1,1991-09-09,-1,0,"dal",-2
"3","Sun","September 15","L","","1-2",TRUE,"Philadelphia Eagles",0,24,8,90,45,45,4,16,262,207,55,1,1991-09-15,-3,0,"dal",-24
"4","Sun","September 22","W","","2-2",FALSE,"Phoenix Cardinals",17,9,11,320,139,181,1,20,322,220,102,1,1991-09-22,0,1,"dal",8
"5","Sun","September 29","W","","3-2",TRUE,"New York Giants",21,16,20,327,269,58,1,26,487,368,119,3,1991-09-29,2,1,"dal",5
"6","Sun","October 6","W","","4-2",FALSE,"Green Bay Packers",20,17,25,411,287,124,0,15,259,199,60,3,1991-10-06,3,1,"dal",3
"7","Sun","October 13","W","","5-2",TRUE,"Cincinnati Bengals",35,23,19,376,264,112,2,17,352,178,174,3,1991-10-13,1,1,"dal",12
"9","Sun","October 27","L","","5-3",FALSE,"Detroit Lions",10,34,22,415,341,74,4,13,208,136,72,0,1991-10-27,-4,0,"dal",-24
"10","Sun","November 3","W","","6-3",TRUE,"Phoenix Cardinals",27,7,22,286,165,121,2,16,239,130,109,3,1991-11-03,1,1,"dal",20
"11","Sun","November 10","L","OT","6-4",FALSE,"Houston Oilers",23,26,21,291,241,50,1,33,583,425,158,1,1991-11-10,0,0,"dal",-3
"12","Sun","November 17","L","","6-5",FALSE,"New York Giants",9,22,14,243,142,101,2,21,315,177,138,1,1991-11-17,-1,0,"dal",-13
"13","Sun","November 24","W","","7-5",FALSE,"Washington Redskins",24,21,23,399,277,122,1,15,262,212,50,1,1991-11-24,0,1,"dal",3
"14","Thu","November 28","W","","8-5",TRUE,"Pittsburgh Steelers",20,10,20,297,181,116,0,17,199,134,65,1,1991-11-28,1,1,"dal",10
"15","Sun","December 8","W","","9-5",TRUE,"New Orleans Saints",23,14,20,301,184,117,0,22,328,229,99,1,1991-12-08,1,1,"dal",9
"16","Sun","December 15","W","","10-5",FALSE,"Philadelphia Eagles",25,13,11,210,138,72,0,16,240,129,111,2,1991-12-15,2,1,"dal",12
"17","Sun","December 22","W","","11-5",TRUE,"Atlanta Falcons",31,27,24,391,228,163,4,17,403,316,87,1,1991-12-22,-3,1,"dal",4
"WildCard","Sun","December 29","W","","12-5",FALSE,"Chicago Bears",17,13,15,288,180,108,0,26,372,222,150,3,1991-12-29,3,1,"dal",4
"Division","Sun","January 5","L","","12-6",FALSE,"Detroit Lions",6,38,16,276,179,97,4,23,421,337,84,0,1992-01-05,-4,0,"dal",-32
"1","Mon","September 7","W","","1-0",TRUE,"Washington Redskins",23,10,23,391,216,175,2,17,260,185,75,1,1992-09-07,-1,1,"dal",13
"2","Sun","September 13","W","","2-0",FALSE,"New York Giants",34,28,20,327,229,98,0,22,331,264,67,1,1992-09-13,1,1,"dal",6
"3","Sun","September 20","W","","3-0",TRUE,"Phoenix Cardinals",31,20,21,413,263,150,0,24,438,371,67,2,1992-09-20,2,1,"dal",11
"5","Mon","October 5","L","","3-1",FALSE,"Philadelphia Eagles",7,31,17,311,231,80,4,21,266,106,160,1,1992-10-05,-3,0,"dal",-24
"6","Sun","October 11","W","","4-1",TRUE,"Seattle Seahawks",27,0,16,313,197,116,2,6,62,24,38,3,1992-10-11,1,1,"dal",27
"7","Sun","October 18","W","","5-1",TRUE,"Kansas City Chiefs",17,10,17,278,183,95,2,18,230,139,91,1,1992-10-18,-1,1,"dal",7
"8","Sun","October 25","W","","6-1",FALSE,"Los Angeles Raiders",28,13,23,369,207,162,0,12,165,94,71,1,1992-10-25,1,1,"dal",15
"9","Sun","November 1","W","","7-1",TRUE,"Philadelphia Eagles",20,10,22,389,214,175,2,10,190,117,73,2,1992-11-01,0,1,"dal",10
"10","Sun","November 8","W","","8-1",FALSE,"Detroit Lions",37,3,26,398,240,158,2,10,201,77,124,4,1992-11-08,2,1,"dal",34
"11","Sun","November 15","L","","8-2",TRUE,"Los Angeles Rams",23,27,19,349,269,80,0,24,367,244,123,0,1992-11-15,0,0,"dal",-4
"12","Sun","November 22","W","","9-2",FALSE,"Phoenix Cardinals",16,10,18,334,237,97,1,9,149,103,46,1,1992-11-22,0,1,"dal",6
"13","Thu","November 26","W","","10-2",TRUE,"New York Giants",30,3,17,299,142,157,1,12,207,127,80,1,1992-11-26,0,1,"dal",27
"14","Sun","December 6","W","","11-2",FALSE,"Denver Broncos",31,27,22,304,222,82,0,15,354,261,93,5,1992-12-06,5,1,"dal",4
"15","Sun","December 13","L","","11-3",FALSE,"Washington Redskins",17,20,22,342,221,121,4,14,246,178,68,1,1992-12-13,-3,0,"dal",-3
"16","Mon","December 21","W","","12-3",FALSE,"Atlanta Falcons",41,17,19,435,239,196,0,18,373,333,40,3,1992-12-21,3,1,"dal",24
"17","Sun","December 27","W","","13-3",TRUE,"Chicago Bears",27,14,22,354,175,179,4,9,92,64,28,4,1992-12-27,0,1,"dal",13
"Division","Sun","January 10","W","","14-3",TRUE,"Philadelphia Eagles",34,10,22,346,186,160,1,12,178,115,63,2,1993-01-10,1,1,"dal",24
"ConfChamp","Sun","January 17","W","","15-3",FALSE,"San Francisco 49ers",30,20,24,416,295,121,0,24,415,301,114,4,1993-01-17,4,1,"dal",10
"SuperBowl","Sun","January 31","W","","16-3",TRUE,"Buffalo Bills",52,17,20,408,271,137,1,22,362,254,108,9,1993-01-31,8,1,"dal",35
"1","Mon","September 6","L","","0-1",FALSE,"Washington Redskins",16,35,16,345,254,91,4,23,332,161,171,0,1993-09-06,-4,0,"dal",-19
"2","Sun","September 12","L","","0-2",TRUE,"Buffalo Bills",10,13,23,393,290,103,4,16,229,129,100,2,1993-09-12,-2,0,"dal",-3
"3","Sun","September 19","W","","1-2",FALSE,"Phoenix Cardinals",17,10,23,410,280,130,0,14,273,205,68,1,1993-09-19,1,1,"dal",7
"5","Sun","October 3","W","","2-2",TRUE,"Green Bay Packers",36,14,20,395,297,98,0,18,214,178,36,0,1993-10-03,0,1,"dal",22
"6","Sun","October 10","W","","3-2",FALSE,"Indianapolis Colts",27,3,24,374,231,143,1,19,361,235,126,5,1993-10-10,4,1,"dal",24
"7","Sun","October 17","W","","4-2",TRUE,"San Francisco 49ers",26,17,24,353,230,123,1,25,405,249,156,2,1993-10-17,1,1,"dal",9
"9","Sun","October 31","W","","5-2",FALSE,"Philadelphia Eagles",23,10,19,356,85,271,0,16,228,89,139,1,1993-10-31,1,1,"dal",13
"10","Sun","November 7","W","","6-2",TRUE,"New York Giants",31,9,17,369,230,139,0,18,295,177,118,0,1993-11-07,0,1,"dal",22
"11","Sun","November 14","W","","7-2",TRUE,"Phoenix Cardinals",20,15,15,311,224,87,2,15,265,214,51,3,1993-11-14,1,1,"dal",5
"12","Sun","November 21","L","","7-3",FALSE,"Atlanta Falcons",14,27,13,230,182,48,0,22,400,315,85,1,1993-11-21,1,0,"dal",-13
"13","Thu","November 25","L","","7-4",TRUE,"Miami Dolphins",14,16,19,293,181,112,2,15,382,274,108,4,1993-11-25,2,0,"dal",-2
"14","Mon","December 6","W","","8-4",TRUE,"Philadelphia Eagles",23,17,17,347,165,182,1,21,307,248,59,1,1993-12-06,0,1,"dal",6
"15","Sun","December 12","W","","9-4",FALSE,"Minnesota Vikings",37,20,25,356,208,148,0,20,270,173,97,1,1993-12-12,1,1,"dal",17
"16","Sat","December 18","W","","10-4",FALSE,"New York Jets",28,7,19,364,235,129,5,23,295,214,81,4,1993-12-18,-1,1,"dal",21
"17","Sun","December 26","W","","11-4",TRUE,"Washington Redskins",38,3,27,380,205,175,1,16,198,72,126,2,1993-12-26,1,1,"dal",35
"18","Sun","January 2","W","OT","12-4",FALSE,"New York Giants",16,13,21,339,157,182,1,16,313,183,130,1,1994-01-02,0,1,"dal",3
"Division","Sun","January 16","W","","13-4",TRUE,"Green Bay Packers",27,17,23,381,284,97,3,19,358,327,31,4,1994-01-16,1,1,"dal",10
"ConfChamp","Sun","January 23","W","","14-4",TRUE,"San Francisco 49ers",38,21,24,377,253,124,0,24,359,275,84,1,1994-01-23,1,1,"dal",17
"SuperBowl","Sun","January 30","W","","15-4",TRUE,"Buffalo Bills",30,13,20,341,204,137,1,22,314,227,87,3,1994-01-30,2,1,"dal",17
"1","Sun","September 4","W","","1-0",FALSE,"Pittsburgh Steelers",26,9,26,442,245,197,1,14,126,71,55,0,1994-09-04,-1,1,"dal",17
"2","Sun","September 11","W","","2-0",TRUE,"Houston Oilers",20,17,18,340,225,115,1,20,339,202,137,2,1994-09-11,1,1,"dal",3
"3","Mon","September 19","L","OT","2-1",TRUE,"Detroit Lions",17,20,25,368,206,162,3,22,379,173,206,0,1994-09-19,-3,0,"dal",-3
"5","Sun","October 2","W","","3-1",FALSE,"Washington Redskins",34,7,26,323,181,142,1,12,110,82,28,4,1994-10-02,3,1,"dal",27
"6","Sun","October 9","W","","4-1",TRUE,"Arizona Cardinals",38,3,22,351,273,78,0,10,221,168,53,5,1994-10-09,5,1,"dal",35
"7","Sun","October 16","W","","5-1",TRUE,"Philadelphia Eagles",24,13,19,266,153,113,1,18,294,170,124,5,1994-10-16,4,1,"dal",11
"8","Sun","October 23","W","","6-1",FALSE,"Arizona Cardinals",28,21,14,312,237,75,0,22,315,208,107,0,1994-10-23,0,1,"dal",7
"9","Sun","October 30","W","","7-1",FALSE,"Cincinnati Bengals",23,20,20,368,272,96,2,13,320,243,77,1,1994-10-30,-1,1,"dal",3
"10","Mon","November 7","W","","8-1",TRUE,"New York Giants",38,10,27,450,241,209,2,11,188,133,55,3,1994-11-07,1,1,"dal",28
"11","Sun","November 13","L","","8-2",FALSE,"San Francisco 49ers",14,21,19,408,321,87,3,19,308,161,147,0,1994-11-13,-3,0,"dal",-7
"12","Sun","November 20","W","","9-2",TRUE,"Washington Redskins",31,7,15,241,111,130,1,20,313,229,84,5,1994-11-20,4,1,"dal",24
"13","Thu","November 24","W","","10-2",TRUE,"Green Bay Packers",42,31,23,436,298,138,1,17,277,248,29,0,1994-11-24,-1,1,"dal",11
"14","Sun","December 4","W","","11-2",FALSE,"Philadelphia Eagles",31,19,15,264,160,104,1,25,393,285,108,1,1994-12-04,0,1,"dal",12
"15","Sat","December 10","L","","11-3",TRUE,"Cleveland Browns",14,19,19,289,177,112,4,16,244,110,134,2,1994-12-10,-2,0,"dal",-5
"16","Mon","December 19","W","","12-3",FALSE,"New Orleans Saints",24,16,23,280,175,105,2,19,237,147,90,3,1994-12-19,1,1,"dal",8
"17","Sat","December 24","L","","12-4",FALSE,"New York Giants",10,15,11,183,93,90,1,15,249,122,127,0,1994-12-24,-1,0,"dal",-5
"Division","Sun","January 8","W","","13-4",TRUE,"Green Bay Packers",35,9,27,450,330,120,2,18,327,228,99,1,1995-01-08,-1,1,"dal",26
"ConfChamp","Sun","January 15","L","","13-5",FALSE,"San Francisco 49ers",28,38,29,451,352,99,5,19,294,155,139,1,1995-01-15,-4,0,"dal",-10
"1","Mon","September 4","W","","1-0",FALSE,"New York Giants",35,0,26,461,229,232,1,16,211,146,65,1,1995-09-04,0,1,"dal",35
"2","Sun","September 10","W","","2-0",TRUE,"Denver Broncos",31,21,27,358,196,162,1,17,287,198,89,2,1995-09-10,1,1,"dal",10
"3","Sun","September 17","W","OT","3-0",FALSE,"Minnesota Vikings",23,17,20,387,233,154,2,17,252,160,92,1,1995-09-17,-1,1,"dal",6
"4","Sun","September 24","W","","4-0",TRUE,"Arizona Cardinals",34,20,26,440,251,189,1,22,381,329,52,3,1995-09-24,2,1,"dal",14
"5","Sun","October 1","L","","4-1",FALSE,"Washington Redskins",23,27,19,356,238,118,2,19,319,183,136,1,1995-10-01,-1,0,"dal",-4
"6","Sun","October 8","W","","5-1",TRUE,"Green Bay Packers",34,24,25,448,312,136,0,20,369,295,74,1,1995-10-08,1,1,"dal",10
"7","Sun","October 15","W","","6-1",FALSE,"San Diego Chargers",23,9,22,320,215,105,1,20,333,174,159,4,1995-10-15,3,1,"dal",14
"9","Sun","October 29","W","","7-1",FALSE,"Atlanta Falcons",28,13,23,380,194,186,1,16,258,158,100,0,1995-10-29,-1,1,"dal",15
"10","Mon","November 6","W","","8-1",TRUE,"Philadelphia Eagles",34,12,22,366,202,164,2,14,230,120,110,2,1995-11-06,0,1,"dal",22
"11","Sun","November 12","L","","8-2",TRUE,"San Francisco 49ers",20,38,19,296,188,108,4,21,386,300,86,0,1995-11-12,-4,0,"dal",-18
"12","Sun","November 19","W","","9-2",FALSE,"Oakland Raiders",34,21,25,336,223,113,1,32,449,309,140,3,1995-11-19,2,1,"dal",13
"13","Thu","November 23","W","","10-2",TRUE,"Kansas City Chiefs",24,12,23,293,175,118,0,19,334,261,73,1,1995-11-23,1,1,"dal",12
"14","Sun","December 3","L","","10-3",TRUE,"Washington Redskins",17,24,24,381,285,96,2,18,292,152,140,0,1995-12-03,-2,0,"dal",-7
"15","Sun","December 10","L","","10-4",FALSE,"Philadelphia Eagles",17,20,15,196,87,109,1,19,311,162,149,2,1995-12-10,1,0,"dal",-3
"16","Sun","December 17","W","","11-4",TRUE,"New York Giants",21,20,21,332,222,110,1,21,347,103,244,1,1995-12-17,0,1,"dal",1
"17","Mon","December 25","W","","12-4",FALSE,"Arizona Cardinals",37,13,27,474,373,101,3,12,285,222,63,3,1995-12-25,0,1,"dal",24
"Division","Sun","January 7","W","","13-4",TRUE,"Philadelphia Eagles",30,11,21,397,244,153,1,13,227,153,74,1,1996-01-07,0,1,"dal",19
"ConfChamp","Sun","January 14","W","","14-4",TRUE,"Green Bay Packers",38,27,27,419,250,169,0,17,328,280,48,2,1996-01-14,2,1,"dal",11
"SuperBowl","Sun","January 28","W","","15-4",TRUE,"Pittsburgh Steelers",27,17,15,254,198,56,0,25,310,207,103,3,1996-01-28,3,1,"dal",10
"1","Mon","September 2","L","","0-1",FALSE,"Chicago Bears",6,22,18,256,173,83,4,14,304,213,91,2,1996-09-02,-2,0,"dal",-16
"2","Sun","September 8","W","","1-1",TRUE,"New York Giants",27,0,21,368,228,140,0,7,105,42,63,2,1996-09-08,2,1,"dal",27
"3","Sun","September 15","L","","1-2",TRUE,"Indianapolis Colts",24,25,18,295,184,111,1,18,321,218,103,2,1996-09-15,1,0,"dal",-1
"4","Sun","September 22","L","","1-3",FALSE,"Buffalo Bills",7,10,12,192,160,32,4,14,224,89,135,2,1996-09-22,-2,0,"dal",-3
"5","Mon","September 30","W","","2-3",FALSE,"Philadelphia Eagles",23,19,15,239,131,108,2,14,259,174,85,5,1996-09-30,3,1,"dal",4
"7","Sun","October 13","W","","3-3",TRUE,"Arizona Cardinals",17,3,22,324,199,125,1,13,178,120,58,1,1996-10-13,0,1,"dal",14
"8","Sun","October 20","W","","4-3",TRUE,"Atlanta Falcons",32,28,17,306,250,56,2,22,369,256,113,0,1996-10-20,-2,1,"dal",4
"9","Sun","October 27","W","","5-3",FALSE,"Miami Dolphins",29,10,27,482,359,123,0,10,221,173,48,3,1996-10-27,3,1,"dal",19
"10","Sun","November 3","L","","5-4",TRUE,"Philadelphia Eagles",21,31,22,296,179,117,2,22,347,217,130,0,1996-11-03,-2,0,"dal",-10
"11","Sun","November 10","W","OT","6-4",FALSE,"San Francisco 49ers",20,17,20,316,222,94,1,16,267,156,111,3,1996-11-10,2,1,"dal",3
"12","Mon","November 18","W","","7-4",TRUE,"Green Bay Packers",21,6,15,317,205,112,0,15,254,164,90,0,1996-11-18,0,1,"dal",15
"13","Sun","November 24","L","","7-5",FALSE,"New York Giants",6,20,15,305,272,33,5,14,215,104,111,1,1996-11-24,-4,0,"dal",-14
"14","Thu","November 28","W","","8-5",TRUE,"Washington Redskins",21,10,19,247,46,201,1,13,209,163,46,3,1996-11-28,2,1,"dal",11
"15","Sun","December 8","W","","9-5",FALSE,"Arizona Cardinals",10,6,15,334,254,80,2,20,347,213,134,4,1996-12-08,2,1,"dal",4
"16","Sun","December 15","W","","10-5",TRUE,"New England Patriots",12,6,16,251,144,107,2,16,279,178,101,4,1996-12-15,2,1,"dal",6
"17","Sun","December 22","L","","10-6",FALSE,"Washington Redskins",10,37,14,235,116,119,2,32,483,326,157,1,1996-12-22,-1,0,"dal",-27
"WildCard","Sat","December 28","W","","11-6",TRUE,"Minnesota Vikings",40,15,27,438,183,255,2,12,268,205,63,6,1996-12-28,4,1,"dal",25
"Division","Sun","January 5","L","","11-7",FALSE,"Carolina Panthers",17,26,21,244,148,96,3,18,227,100,127,2,1997-01-05,-1,0,"dal",-9
"1","Sun","August 31","W","","1-0",FALSE,"Pittsburgh Steelers",37,7,21,380,295,85,0,15,174,89,85,2,1997-08-31,2,1,"dal",30
"2","Sun","September 7","L","OT","1-1",FALSE,"Arizona Cardinals",22,25,15,327,147,180,1,21,286,220,66,4,1997-09-07,3,0,"dal",-3
"3","Mon","September 15","W","","2-1",TRUE,"Philadelphia Eagles",21,20,18,279,187,92,2,16,333,176,157,0,1997-09-15,-2,1,"dal",1
"5","Sun","September 28","W","","3-1",TRUE,"Chicago Bears",27,3,13,180,124,56,1,17,243,102,141,2,1997-09-28,1,1,"dal",24
"6","Sun","October 5","L","","3-2",FALSE,"New York Giants",17,20,27,428,310,118,2,13,166,109,57,0,1997-10-05,-2,0,"dal",-3
"7","Mon","October 13","L","","3-3",FALSE,"Washington Redskins",16,21,16,290,175,115,1,16,255,139,116,1,1997-10-13,0,0,"dal",-5
"8","Sun","October 19","W","","4-3",TRUE,"Jacksonville Jaguars",26,22,24,337,238,99,0,15,271,229,42,1,1997-10-19,1,1,"dal",4
"9","Sun","October 26","L","","4-4",FALSE,"Philadelphia Eagles",12,13,14,244,93,151,0,17,274,120,154,0,1997-10-26,0,0,"dal",-1
"10","Sun","November 2","L","","4-5",FALSE,"San Francisco 49ers",10,17,16,271,184,87,2,18,301,173,128,2,1997-11-02,0,0,"dal",-7
"11","Sun","November 9","W","","5-5",TRUE,"Arizona Cardinals",24,6,19,329,204,125,1,18,274,173,101,1,1997-11-09,0,1,"dal",18
"12","Sun","November 16","W","","6-5",TRUE,"Washington Redskins",17,14,20,312,207,105,0,16,259,155,104,0,1997-11-16,0,1,"dal",3
"13","Sun","November 23","L","","6-6",FALSE,"Green Bay Packers",17,45,11,213,120,93,2,29,409,189,220,1,1997-11-23,-1,0,"dal",-28
"14","Thu","November 27","L","","6-7",TRUE,"Tennessee Oilers",14,27,16,386,340,46,5,14,245,81,164,1,1997-11-27,-4,0,"dal",-13
"15","Mon","December 8","L","","6-8",TRUE,"Carolina Panthers",13,23,9,216,138,78,1,22,324,169,155,1,1997-12-08,0,0,"dal",-10
"16","Sun","December 14","L","","6-9",FALSE,"Cincinnati Bengals",24,31,29,402,274,128,2,17,419,262,157,2,1997-12-14,0,0,"dal",-7
"17","Sun","December 21","L","","6-10",TRUE,"New York Giants",7,20,11,184,105,79,3,17,283,136,147,1,1997-12-21,-2,0,"dal",-13
"1","Sun","September 6","W","","1-0",TRUE,"Arizona Cardinals",38,10,30,444,256,188,3,13,205,160,45,2,1998-09-06,-1,1,"dal",28
"2","Sun","September 13","L","","1-1",FALSE,"Denver Broncos",23,42,18,370,201,169,0,21,515,306,209,0,1998-09-13,0,0,"dal",-19
"3","Mon","September 21","W","","2-1",FALSE,"New York Giants",31,7,11,302,224,78,0,16,252,196,56,4,1998-09-21,4,1,"dal",24
"4","Sun","September 27","L","","2-2",TRUE,"Oakland Raiders",12,13,16,275,207,68,3,13,288,159,129,0,1998-09-27,-3,0,"dal",-1
"5","Sun","October 4","W","","3-2",FALSE,"Washington Redskins",31,10,21,387,163,224,1,14,256,164,92,1,1998-10-04,0,1,"dal",21
"6","Sun","October 11","W","","4-2",TRUE,"Carolina Panthers",27,20,22,428,277,151,2,16,304,267,37,3,1998-10-11,1,1,"dal",7
"7","Sun","October 18","L","","4-3",FALSE,"Chicago Bears",12,13,13,236,128,108,1,18,299,220,79,2,1998-10-18,1,0,"dal",-1
"9","Mon","November 2","W","","5-3",FALSE,"Philadelphia Eagles",34,0,20,294,173,121,0,15,200,104,96,3,1998-11-02,3,1,"dal",34
"10","Sun","November 8","W","","6-3",TRUE,"New York Giants",16,6,16,327,165,162,0,15,286,127,159,1,1998-11-08,1,1,"dal",10
"11","Sun","November 15","W","","7-3",FALSE,"Arizona Cardinals",35,28,23,354,208,146,0,28,480,448,32,2,1998-11-15,2,1,"dal",7
"12","Sun","November 22","W","","8-3",TRUE,"Seattle Seahawks",30,22,29,465,292,173,1,17,249,183,66,2,1998-11-22,1,1,"dal",8
"13","Thu","November 26","L","","8-4",TRUE,"Minnesota Vikings",36,46,32,513,455,58,0,21,471,353,118,1,1998-11-26,1,0,"dal",-10
"14","Sun","December 6","L","","8-5",FALSE,"New Orleans Saints",3,22,10,182,174,8,0,17,328,215,113,2,1998-12-06,2,0,"dal",-19
"15","Sun","December 13","L","","8-6",FALSE,"Kansas City Chiefs",17,20,14,247,196,51,2,23,383,200,183,0,1998-12-13,-2,0,"dal",-3
"16","Sun","December 20","W","","9-6",TRUE,"Philadelphia Eagles",13,9,11,248,95,153,2,15,356,231,125,1,1998-12-20,-1,1,"dal",4
"17","Sun","December 27","W","","10-6",TRUE,"Washington Redskins",23,7,22,378,222,156,0,14,292,212,80,2,1998-12-27,2,1,"dal",16
"WildCard","Sat","January 2","L","","10-7",TRUE,"Arizona Cardinals",7,20,20,260,164,96,3,14,346,213,133,2,1999-01-02,-1,0,"dal",-13
"1","Sun","September 12","W","OT","1-0",FALSE,"Washington Redskins",41,35,30,541,355,186,3,25,504,369,135,2,1999-09-12,-1,1,"dal",6
"2","Mon","September 20","W","","2-0",TRUE,"Atlanta Falcons",24,7,17,232,98,134,2,13,324,239,85,4,1999-09-20,2,1,"dal",17
"4","Sun","October 3","W","","3-0",TRUE,"Arizona Cardinals",35,7,17,306,192,114,1,12,208,137,71,5,1999-10-03,4,1,"dal",28
"5","Sun","October 10","L","","3-1",FALSE,"Philadelphia Eagles",10,13,19,300,170,130,3,12,244,139,105,1,1999-10-10,-2,0,"dal",-3
"6","Mon","October 18","L","","3-2",FALSE,"New York Giants",10,13,14,274,250,24,1,13,228,153,75,0,1999-10-18,-1,0,"dal",-3
"7","Sun","October 24","W","","4-2",TRUE,"Washington Redskins",38,20,23,352,244,108,1,14,272,211,61,0,1999-10-24,-1,1,"dal",18
"8","Sun","October 31","L","","4-3",FALSE,"Indianapolis Colts",24,34,18,232,129,103,1,23,419,300,119,0,1999-10-31,-1,0,"dal",-10
"9","Mon","November 8","L","","4-4",FALSE,"Minnesota Vikings",17,27,14,328,123,205,2,17,308,190,118,2,1999-11-08,0,0,"dal",-10
"10","Sun","November 14","W","","5-4",TRUE,"Green Bay Packers",27,13,19,339,190,149,2,20,284,244,40,2,1999-11-14,0,1,"dal",14
"11","Sun","November 21","L","","5-5",FALSE,"Arizona Cardinals",9,13,15,258,102,156,0,13,207,105,102,2,1999-11-21,2,0,"dal",-4
"12","Thu","November 25","W","","6-5",TRUE,"Miami Dolphins",20,0,15,324,223,101,1,16,275,206,69,5,1999-11-25,4,1,"dal",20
"13","Sun","December 5","L","","6-6",FALSE,"New England Patriots",6,13,12,203,140,63,0,18,284,176,108,2,1999-12-05,2,0,"dal",-7
"14","Sun","December 12","W","","7-6",TRUE,"Philadelphia Eagles",20,10,22,337,225,112,1,14,238,143,95,3,1999-12-12,2,1,"dal",10
"15","Sun","December 19","L","","7-7",TRUE,"New York Jets",21,22,16,347,152,195,2,19,355,229,126,2,1999-12-19,0,0,"dal",-1
"16","Fri","December 24","L","","7-8",FALSE,"New Orleans Saints",24,31,24,368,246,122,3,18,310,249,61,2,1999-12-24,-1,0,"dal",-7
"17","Sun","January 2","W","","8-8",TRUE,"New York Giants",26,18,20,437,288,149,0,19,380,308,72,1,2000-01-02,1,1,"dal",8
"WildCard","Sun","January 9","L","","8-9",FALSE,"Minnesota Vikings",10,27,18,389,278,111,3,20,374,199,175,0,2000-01-09,-3,0,"dal",-17
"1","Sun","September 3","L","","0-1",TRUE,"Philadelphia Eagles",14,41,10,167,100,67,2,27,425,119,306,3,2000-09-03,1,0,"dal",-27
"2","Sun","September 10","L","","0-2",FALSE,"Arizona Cardinals",31,32,17,330,240,90,2,21,322,224,98,1,2000-09-10,-1,0,"dal",-1
"3","Mon","September 18","W","","1-2",FALSE,"Washington Redskins",27,21,15,332,179,153,2,24,331,224,107,2,2000-09-18,0,1,"dal",6
"4","Sun","September 24","L","","1-3",TRUE,"San Francisco 49ers",24,41,18,298,222,76,3,27,439,178,261,0,2000-09-24,-3,0,"dal",-17
"5","Sun","October 1","W","OT","2-3",FALSE,"Carolina Panthers",16,13,20,291,118,173,2,13,272,153,119,2,2000-10-01,0,1,"dal",3
"7","Sun","October 15","L","","2-4",FALSE,"New York Giants",14,19,23,269,193,76,5,17,311,108,203,0,2000-10-15,-5,0,"dal",-5
"8","Sun","October 22","W","","3-4",TRUE,"Arizona Cardinals",48,7,23,347,147,200,0,15,276,167,109,3,2000-10-22,3,1,"dal",41
"9","Sun","October 29","L","OT","3-5",TRUE,"Jacksonville Jaguars",17,23,22,325,207,118,3,18,392,231,161,0,2000-10-29,-3,0,"dal",-6
"10","Sun","November 5","L","OT","3-6",FALSE,"Philadelphia Eagles",13,16,16,295,91,204,2,23,357,228,129,2,2000-11-05,0,0,"dal",-3
"11","Sun","November 12","W","","4-6",TRUE,"Cincinnati Bengals",23,6,22,405,308,97,1,15,195,56,139,2,2000-11-12,1,1,"dal",17
"12","Sun","November 19","L","","4-7",FALSE,"Baltimore Ravens",0,27,9,192,137,55,3,22,479,229,250,2,2000-11-19,-1,0,"dal",-27
"13","Thu","November 23","L","","4-8",TRUE,"Minnesota Vikings",15,27,22,404,276,128,2,18,360,192,168,0,2000-11-23,-2,0,"dal",-12
"14","Sun","December 3","L","","4-9",FALSE,"Tampa Bay Buccaneers",7,27,19,266,153,113,4,17,301,51,250,1,2000-12-03,-3,0,"dal",-20
"15","Sun","December 10","W","","5-9",TRUE,"Washington Redskins",32,13,19,314,72,242,0,17,270,191,79,2,2000-12-10,2,1,"dal",19
"16","Sun","December 17","L","","5-10",TRUE,"New York Giants",13,17,15,145,70,75,3,12,225,126,99,1,2000-12-17,-2,0,"dal",-4
"17","Mon","December 25","L","","5-11",FALSE,"Tennessee Titans",0,31,6,95,9,86,5,23,374,216,158,4,2000-12-25,-1,0,"dal",-31
"1","Sun","September 9","L","","0-1",TRUE,"Tampa Bay Buccaneers",6,10,8,127,28,99,3,19,263,192,71,2,2001-09-09,-1,0,"dal",-4
"2","Sun","September 23","L","","0-2",TRUE,"San Diego Chargers",21,32,14,289,188,101,5,26,475,345,130,1,2001-09-23,-4,0,"dal",-11
"3","Sun","September 30","L","","0-3",FALSE,"Philadelphia Eagles",18,40,11,242,61,181,5,14,276,145,131,3,2001-09-30,-2,0,"dal",-22
"4","Sun","October 7","L","","0-4",FALSE,"Oakland Raiders",21,28,17,231,123,108,0,23,308,207,101,2,2001-10-07,2,0,"dal",-7
"5","Mon","October 15","W","","1-4",TRUE,"Washington Redskins",9,7,23,386,175,211,1,10,226,123,103,1,2001-10-15,0,1,"dal",2
"7","Sun","October 28","W","","2-4",TRUE,"Arizona Cardinals",17,3,15,225,80,145,2,17,292,217,75,4,2001-10-28,2,1,"dal",14
"8","Sun","November 4","L","OT","2-5",FALSE,"New York Giants",24,27,17,324,238,86,4,19,358,265,93,5,2001-11-04,1,0,"dal",-3
"9","Sun","November 11","L","","2-6",FALSE,"Atlanta Falcons",13,20,15,303,96,207,2,12,201,46,155,1,2001-11-11,-1,0,"dal",-7
"10","Sun","November 18","L","","2-7",TRUE,"Philadelphia Eagles",3,36,11,213,81,132,4,17,227,129,98,1,2001-11-18,-3,0,"dal",-33
"11","Thu","November 22","L","","2-8",TRUE,"Denver Broncos",24,26,16,191,164,27,2,19,279,160,119,1,2001-11-22,-1,0,"dal",-2
"12","Sun","December 2","W","","3-8",FALSE,"Washington Redskins",20,14,19,337,122,215,1,15,277,196,81,1,2001-12-02,0,1,"dal",6
"13","Sun","December 9","W","","4-8",TRUE,"New York Giants",20,13,14,289,185,104,0,12,245,120,125,2,2001-12-09,2,1,"dal",7
"14","Sun","December 16","L","","4-9",FALSE,"Seattle Seahawks",3,29,10,218,116,102,1,22,312,139,173,0,2001-12-16,-1,0,"dal",-26
"15","Sun","December 23","L","","4-10",FALSE,"Arizona Cardinals",10,17,21,343,169,174,3,11,209,134,75,0,2001-12-23,-3,0,"dal",-7
"16","Sun","December 30","W","","5-10",TRUE,"San Francisco 49ers",27,21,24,420,234,186,0,16,285,229,56,1,2001-12-30,1,1,"dal",6
"17","Sun","January 6","L","","5-11",FALSE,"Detroit Lions",10,15,12,264,158,106,1,20,366,242,124,0,2002-01-06,-1,0,"dal",-5
"1","Sun","September 8","L","","0-1",FALSE,"Houston Texans",10,19,11,267,112,155,2,13,210,123,87,1,2002-09-08,-1,0,"dal",-9
"2","Sun","September 15","W","","1-1",TRUE,"Tennessee Titans",21,13,14,297,230,67,0,19,333,235,98,1,2002-09-15,1,1,"dal",8
"3","Sun","September 22","L","","1-2",FALSE,"Philadelphia Eagles",13,44,18,304,183,121,4,26,447,294,153,2,2002-09-22,-2,0,"dal",-31
"4","Sun","September 29","W","","2-2",FALSE,"St. Louis Rams",13,10,17,315,193,122,2,19,366,273,93,3,2002-09-29,1,1,"dal",3
"5","Sun","October 6","L","","2-3",TRUE,"New York Giants",17,21,20,340,245,95,0,16,316,212,104,2,2002-10-06,2,0,"dal",-4
"6","Sun","October 13","W","","3-3",TRUE,"Carolina Panthers",14,13,17,311,174,137,2,14,308,198,110,0,2002-10-13,-2,1,"dal",1
"7","Sun","October 20","L","OT","3-4",FALSE,"Arizona Cardinals",6,9,14,342,194,148,4,22,380,228,152,1,2002-10-20,-3,0,"dal",-3
"8","Sun","October 27","L","","3-5",TRUE,"Seattle Seahawks",14,17,17,237,132,105,1,18,267,170,97,2,2002-10-27,1,0,"dal",-3
"9","Sun","November 3","L","","3-6",FALSE,"Detroit Lions",7,9,17,221,150,71,2,8,148,96,52,2,2002-11-03,0,0,"dal",-2
"11","Sun","November 17","L","","3-7",FALSE,"Indianapolis Colts",3,20,11,178,94,84,2,20,362,252,110,1,2002-11-17,-1,0,"dal",-17
"12","Sun","November 24","W","","4-7",TRUE,"Jacksonville Jaguars",21,19,21,405,287,118,3,19,326,194,132,3,2002-11-24,0,1,"dal",2
"13","Thu","November 28","W","","5-7",TRUE,"Washington Redskins",27,20,19,328,117,211,0,16,315,232,83,4,2002-11-28,4,1,"dal",7
"14","Sun","December 8","L","","5-8",TRUE,"San Francisco 49ers",27,31,10,257,147,110,2,26,401,276,125,1,2002-12-08,-1,0,"dal",-4
"15","Sun","December 15","L","","5-9",FALSE,"New York Giants",7,37,14,241,137,104,3,20,377,220,157,0,2002-12-15,-3,0,"dal",-30
"16","Sat","December 21","L","","5-10",TRUE,"Philadelphia Eagles",3,27,9,146,78,68,3,17,359,245,114,2,2002-12-21,-1,0,"dal",-24
"17","Sun","December 29","L","","5-11",FALSE,"Washington Redskins",14,20,8,186,148,38,4,18,352,201,151,5,2002-12-29,1,0,"dal",-6
"1","Sun","September 7","L","","0-1",TRUE,"Atlanta Falcons",13,27,16,403,254,149,2,17,318,220,98,1,2003-09-07,-1,0,"dal",-14
"2","Mon","September 15","W","OT","1-1",FALSE,"New York Giants",35,32,24,403,296,107,1,20,309,256,53,3,2003-09-15,2,1,"dal",3
"4","Sun","September 28","W","","2-1",FALSE,"New York Jets",17,6,18,360,158,202,1,15,285,219,66,2,2003-09-28,1,1,"dal",11
"5","Sun","October 5","W","","3-1",TRUE,"Arizona Cardinals",24,7,18,365,268,97,1,9,151,119,32,2,2003-10-05,1,1,"dal",17
"6","Sun","October 12","W","","4-1",TRUE,"Philadelphia Eagles",23,21,15,292,173,119,1,14,232,115,117,1,2003-10-12,0,1,"dal",2
"7","Sun","October 19","W","","5-1",FALSE,"Detroit Lions",38,7,25,331,197,134,1,9,157,74,83,4,2003-10-19,3,1,"dal",31
"8","Sun","October 26","L","","5-2",FALSE,"Tampa Bay Buccaneers",0,16,9,178,118,60,3,14,261,133,128,0,2003-10-26,-3,0,"dal",-16
"9","Sun","November 2","W","","6-2",TRUE,"Washington Redskins",21,14,24,400,192,208,4,13,213,124,89,0,2003-11-02,-4,1,"dal",7
"10","Sun","November 9","W","","7-2",TRUE,"Buffalo Bills",10,6,14,236,114,122,0,15,185,85,100,2,2003-11-09,2,1,"dal",4
"11","Sun","November 16","L","","7-3",FALSE,"New England Patriots",0,12,17,291,207,84,3,14,268,203,65,1,2003-11-16,-2,0,"dal",-12
"12","Sun","November 23","W","","8-3",TRUE,"Carolina Panthers",24,20,19,319,254,65,1,15,244,169,75,2,2003-11-23,1,1,"dal",4
"13","Thu","November 27","L","","8-4",TRUE,"Miami Dolphins",21,40,21,354,263,91,5,22,365,239,126,1,2003-11-27,-4,0,"dal",-19
"14","Sun","December 7","L","","8-5",FALSE,"Philadelphia Eagles",10,36,13,225,75,150,2,20,403,228,175,0,2003-12-07,-2,0,"dal",-26
"15","Sun","December 14","W","","9-5",FALSE,"Washington Redskins",27,0,16,326,104,222,1,8,161,55,106,6,2003-12-14,5,1,"dal",27
"16","Sun","December 21","W","","10-5",TRUE,"New York Giants",19,3,16,326,222,104,0,10,213,159,54,0,2003-12-21,0,1,"dal",16
"17","Sun","December 28","L","","10-6",FALSE,"New Orleans Saints",7,13,21,352,267,85,3,13,291,233,58,0,2003-12-28,-3,0,"dal",-6
"WildCard","Sat","January 3","L","","10-7",FALSE,"Carolina Panthers",10,29,10,204,132,72,2,16,380,273,107,0,2004-01-03,-2,0,"dal",-19
"1","Sun","September 12","L","","0-1",FALSE,"Minnesota Vikings",17,35,27,423,352,71,2,23,415,279,136,0,2004-09-12,-2,0,"dal",-18
"2","Sun","September 19","W","","1-1",TRUE,"Cleveland Browns",19,12,20,441,315,126,4,12,202,66,136,3,2004-09-19,-1,1,"dal",7
"3","Mon","September 27","W","","2-1",FALSE,"Washington Redskins",21,18,14,287,237,50,0,21,384,290,94,0,2004-09-27,0,1,"dal",3
"5","Sun","October 10","L","","2-2",TRUE,"New York Giants",10,26,16,278,112,166,2,19,336,211,125,1,2004-10-10,-1,0,"dal",-16
"6","Sun","October 17","L","","2-3",TRUE,"Pittsburgh Steelers",20,24,20,348,248,100,1,21,297,172,125,0,2004-10-17,-1,0,"dal",-4
"7","Sun","October 24","L","","2-4",FALSE,"Green Bay Packers",20,41,18,362,296,66,0,23,480,260,220,0,2004-10-24,0,0,"dal",-21
"8","Sun","October 31","W","","3-4",TRUE,"Detroit Lions",31,21,22,357,230,127,3,15,284,245,39,1,2004-10-31,-2,1,"dal",10
"9","Sun","November 7","L","","3-5",FALSE,"Cincinnati Bengals",3,26,13,311,202,109,5,15,328,212,116,0,2004-11-07,-5,0,"dal",-23
"10","Mon","November 15","L","","3-6",TRUE,"Philadelphia Eagles",21,49,14,317,246,71,3,20,485,336,149,0,2004-11-15,-3,0,"dal",-28
"11","Sun","November 21","L","","3-7",FALSE,"Baltimore Ravens",10,30,16,222,128,94,3,15,287,228,59,2,2004-11-21,-1,0,"dal",-20
"12","Thu","November 25","W","","4-7",TRUE,"Chicago Bears",21,7,18,267,113,154,2,10,140,91,49,4,2004-11-25,2,1,"dal",14
"13","Mon","December 6","W","","5-7",FALSE,"Seattle Seahawks",43,39,24,405,207,198,2,25,507,398,109,2,2004-12-06,0,1,"dal",4
"14","Sun","December 12","L","","5-8",TRUE,"New Orleans Saints",13,27,18,269,148,121,4,21,344,239,105,2,2004-12-12,-2,0,"dal",-14
"15","Sun","December 19","L","","5-9",FALSE,"Philadelphia Eagles",7,12,14,237,157,80,2,24,328,208,120,3,2004-12-19,1,0,"dal",-5
"16","Sun","December 26","W","","6-9",TRUE,"Washington Redskins",13,10,21,306,217,89,2,15,233,149,84,3,2004-12-26,1,1,"dal",3
"17","Sun","January 2","L","","6-10",FALSE,"New York Giants",24,28,21,367,220,147,2,18,235,137,98,1,2005-01-02,-1,0,"dal",-4
"1","Sun","September 11","W","","1-0",FALSE,"San Diego Chargers",28,24,23,301,192,109,1,19,291,188,103,2,2005-09-11,1,1,"dal",4
"2","Mon","September 19","L","","1-1",TRUE,"Washington Redskins",13,14,14,351,261,90,0,14,346,242,104,2,2005-09-19,2,0,"dal",-1
"3","Sun","September 25","W","","2-1",FALSE,"San Francisco 49ers",34,31,26,443,348,95,3,19,390,266,124,3,2005-09-25,0,1,"dal",3
"4","Sun","October 2","L","","2-2",FALSE,"Oakland Raiders",13,19,16,303,187,116,1,16,333,204,129,0,2005-10-02,-1,0,"dal",-6
"5","Sun","October 9","W","","3-2",TRUE,"Philadelphia Eagles",33,10,28,456,289,167,1,6,129,110,19,0,2005-10-09,-1,1,"dal",23
"6","Sun","October 16","W","OT","4-2",TRUE,"New York Giants",16,13,25,385,293,92,4,11,270,179,91,4,2005-10-16,0,1,"dal",3
"7","Sun","October 23","L","","4-3",FALSE,"Seattle Seahawks",10,13,16,275,111,164,2,20,289,217,72,3,2005-10-23,1,0,"dal",-3
"8","Sun","October 30","W","","5-3",TRUE,"Arizona Cardinals",34,13,21,348,202,146,1,12,213,142,71,2,2005-10-30,1,1,"dal",21
"10","Mon","November 14","W","","6-3",FALSE,"Philadelphia Eagles",21,20,13,241,183,58,1,21,359,178,181,1,2005-11-14,0,1,"dal",1
"11","Sun","November 20","W","","7-3",TRUE,"Detroit Lions",20,7,26,253,104,149,1,11,226,169,57,1,2005-11-20,0,1,"dal",13
"12","Thu","November 24","L","OT","7-4",TRUE,"Denver Broncos",21,24,23,314,229,85,2,13,293,149,144,2,2005-11-24,0,0,"dal",-3
"13","Sun","December 4","L","","7-5",FALSE,"New York Giants",10,17,16,206,125,81,4,17,277,150,127,2,2005-12-04,-2,0,"dal",-7
"14","Sun","December 11","W","","8-5",TRUE,"Kansas City Chiefs",31,28,21,445,316,129,0,25,493,332,161,1,2005-12-11,1,1,"dal",3
"15","Sun","December 18","L","","8-6",FALSE,"Washington Redskins",7,35,13,216,107,109,4,19,334,163,171,1,2005-12-18,-3,0,"dal",-28
"16","Sat","December 24","W","","9-6",FALSE,"Carolina Panthers",24,20,22,394,180,214,2,13,318,247,71,2,2005-12-24,0,1,"dal",4
"17","Sun","January 1","L","","9-7",TRUE,"St. Louis Rams",10,20,15,271,214,57,4,20,253,147,106,0,2006-01-01,-4,0,"dal",-10
"1","Sun","September 10","L","","0-1",FALSE,"Jacksonville Jaguars",17,24,14,323,235,88,3,22,307,229,78,1,2006-09-10,-2,0,"dal",-7
"2","Sun","September 17","W","","1-1",TRUE,"Washington Redskins",27,10,22,367,229,138,1,16,245,152,93,1,2006-09-17,0,1,"dal",17
"4","Sun","October 1","W","","2-1",FALSE,"Tennessee Titans",45,14,23,396,179,217,1,16,229,151,78,3,2006-10-01,2,1,"dal",31
"5","Sun","October 8","L","","2-2",FALSE,"Philadelphia Eagles",24,38,23,320,174,146,5,16,383,331,52,2,2006-10-08,-3,0,"dal",-14
"6","Sun","October 15","W","","3-2",TRUE,"Houston Texans",34,6,21,354,184,170,0,12,232,198,34,3,2006-10-15,3,1,"dal",28
"7","Mon","October 23","L","","3-3",TRUE,"New York Giants",22,36,21,379,310,69,4,18,328,173,155,2,2006-10-23,-2,0,"dal",-14
"8","Sun","October 29","W","","4-3",FALSE,"Carolina Panthers",35,14,27,414,258,156,1,16,204,128,76,3,2006-10-29,2,1,"dal",21
"9","Sun","November 5","L","","4-4",FALSE,"Washington Redskins",19,22,21,378,267,111,0,18,300,183,117,1,2006-11-05,1,0,"dal",-3
"10","Sun","November 12","W","","5-4",FALSE,"Arizona Cardinals",27,10,20,434,308,126,0,17,295,209,86,3,2006-11-12,3,1,"dal",17
"11","Sun","November 19","W","","6-4",TRUE,"Indianapolis Colts",21,14,24,342,225,117,2,22,335,247,88,4,2006-11-19,2,1,"dal",7
"12","Thu","November 23","W","","7-4",TRUE,"Tampa Bay Buccaneers",38,10,27,435,298,137,0,10,211,110,101,2,2006-11-23,2,1,"dal",28
"13","Sun","December 3","W","","8-4",FALSE,"New York Giants",23,20,21,365,255,110,2,22,396,270,126,1,2006-12-03,-1,1,"dal",3
"14","Sun","December 10","L","","8-5",TRUE,"New Orleans Saints",17,42,16,347,231,116,2,28,536,377,159,0,2006-12-10,-2,0,"dal",-25
"15","Sat","December 16","W","","9-5",FALSE,"Atlanta Falcons",38,28,21,352,258,94,2,19,376,249,127,3,2006-12-16,1,1,"dal",10
"16","Mon","December 25","L","","9-6",TRUE,"Philadelphia Eagles",7,23,16,201,118,83,3,20,426,222,204,1,2006-12-25,-2,0,"dal",-16
"17","Sun","December 31","L","","9-7",TRUE,"Detroit Lions",31,39,19,365,307,58,4,22,362,277,85,1,2006-12-31,-3,0,"dal",-8
"WildCard","Sat","January 6","L","","9-8",FALSE,"Seattle Seahawks",20,21,14,284,168,116,1,19,332,240,92,2,2007-01-06,1,0,"dal",-1
"1","Sun","September 9","W","","1-0",TRUE,"New York Giants",45,35,21,478,336,142,2,22,438,314,124,1,2007-09-09,-1,1,"dal",10
"2","Sun","September 16","W","","2-0",FALSE,"Miami Dolphins",37,20,19,352,186,166,0,21,334,273,61,5,2007-09-16,5,1,"dal",17
"3","Sun","September 23","W","","3-0",FALSE,"Chicago Bears",34,10,21,431,300,131,1,16,239,164,75,4,2007-09-23,3,1,"dal",24
"4","Sun","September 30","W","","4-0",TRUE,"St. Louis Rams",35,7,28,502,331,171,1,12,187,125,62,1,2007-09-30,0,1,"dal",28
"5","Mon","October 8","W","","5-0",FALSE,"Buffalo Bills",25,24,24,385,309,76,6,14,229,148,81,1,2007-10-08,-5,1,"dal",1
"6","Sun","October 14","L","","5-1",TRUE,"New England Patriots",27,48,13,285,186,99,1,28,448,373,75,1,2007-10-14,0,0,"dal",-21
"7","Sun","October 21","W","","6-1",TRUE,"Minnesota Vikings",24,14,22,381,253,128,2,11,196,65,131,1,2007-10-21,-1,1,"dal",10
"9","Sun","November 4","W","","7-1",FALSE,"Philadelphia Eagles",38,17,24,434,324,110,1,21,316,250,66,3,2007-11-04,2,1,"dal",21
"10","Sun","November 11","W","","8-1",FALSE,"New York Giants",31,20,19,323,243,80,1,23,300,194,106,2,2007-11-11,1,1,"dal",11
"11","Sun","November 18","W","","9-1",TRUE,"Washington Redskins",28,23,19,362,287,75,1,28,423,361,62,2,2007-11-18,1,1,"dal",5
"12","Thu","November 22","W","","10-1",TRUE,"New York Jets",34,3,21,344,170,174,1,9,180,120,60,2,2007-11-22,1,1,"dal",31
"13","Thu","November 29","W","","11-1",TRUE,"Green Bay Packers",37,27,23,414,309,105,1,20,357,233,124,2,2007-11-29,1,1,"dal",10
"14","Sun","December 9","W","","12-1",FALSE,"Detroit Lions",28,27,25,368,281,87,1,25,390,238,152,0,2007-12-09,-1,1,"dal",1
"15","Sun","December 16","L","","12-2",TRUE,"Philadelphia Eagles",6,10,11,240,187,53,3,20,315,181,134,1,2007-12-16,-2,0,"dal",-4
"16","Sat","December 22","W","","13-2",FALSE,"Carolina Panthers",20,13,25,405,257,148,1,12,216,147,69,1,2007-12-22,0,1,"dal",7
"17","Sun","December 30","L","","13-3",FALSE,"Washington Redskins",6,27,7,147,146,1,1,22,354,223,131,2,2007-12-30,1,0,"dal",-21
"Division","Sun","January 13","L","","13-4",TRUE,"New York Giants",17,21,23,336,182,154,1,16,230,140,90,0,2008-01-13,-1,0,"dal",-4
"1","Sun","September 7","W","","1-0",FALSE,"Cleveland Browns",28,10,30,487,320,167,1,11,205,114,91,0,2008-09-07,-1,1,"dal",18
"2","Mon","September 15","W","","2-0",TRUE,"Philadelphia Eagles",41,37,20,380,312,68,2,23,337,259,78,1,2008-09-15,-1,1,"dal",4
"3","Sun","September 21","W","","3-0",FALSE,"Green Bay Packers",27,16,22,453,236,217,2,17,334,250,84,1,2008-09-21,-1,1,"dal",11
"4","Sun","September 28","L","","3-1",TRUE,"Washington Redskins",24,26,21,344,300,44,1,22,381,220,161,0,2008-09-28,-1,0,"dal",-2
"5","Sun","October 5","W","","4-1",TRUE,"Cincinnati Bengals",31,22,18,373,175,198,2,18,269,208,61,2,2008-10-05,0,1,"dal",9
"6","Sun","October 12","L","OT","4-2",FALSE,"Arizona Cardinals",24,30,15,374,301,73,1,14,276,226,50,3,2008-10-12,2,0,"dal",-6
"7","Sun","October 19","L","","4-3",FALSE,"St. Louis Rams",14,34,17,341,217,124,4,18,325,135,190,0,2008-10-19,-4,0,"dal",-20
"8","Sun","October 26","W","","5-3",TRUE,"Tampa Bay Buccaneers",13,9,17,172,102,70,0,15,262,213,49,1,2008-10-26,1,1,"dal",4
"9","Sun","November 2","L","","5-4",FALSE,"New York Giants",14,35,11,183,102,81,4,23,319,119,200,3,2008-11-02,-1,0,"dal",-21
"11","Sun","November 16","W","","6-4",FALSE,"Washington Redskins",14,10,17,315,198,117,2,14,228,136,92,1,2008-11-16,-1,1,"dal",4
"12","Sun","November 23","W","","7-4",TRUE,"San Francisco 49ers",35,22,16,408,334,74,1,16,304,278,26,2,2008-11-23,1,1,"dal",13
"13","Thu","November 27","W","","8-4",TRUE,"Seattle Seahawks",34,9,24,447,331,116,1,19,322,242,80,2,2008-11-27,1,1,"dal",25
"14","Sun","December 7","L","","8-5",FALSE,"Pittsburgh Steelers",13,20,15,289,194,95,5,13,238,168,70,2,2008-12-07,-3,0,"dal",-7
"15","Sun","December 14","W","","9-5",TRUE,"New York Giants",20,8,17,321,221,100,0,17,218,146,72,2,2008-12-14,2,1,"dal",12
"16","Sat","December 20","L","","9-6",TRUE,"Baltimore Ravens",24,33,16,327,235,92,2,20,388,123,265,1,2008-12-20,-1,0,"dal",-9
"17","Sun","December 28","L","","9-7",FALSE,"Philadelphia Eagles",6,44,15,298,211,87,5,16,303,166,137,1,2008-12-28,-4,0,"dal",-38
"1","Sun","September 13","W","","1-0",FALSE,"Tampa Bay Buccaneers",34,21,18,462,344,118,0,26,450,276,174,0,2009-09-13,0,1,"dal",13
"2","Sun","September 20","L","","1-1",TRUE,"New York Giants",31,33,23,378,127,251,4,19,427,330,97,0,2009-09-20,-4,0,"dal",-2
"3","Mon","September 28","W","","2-1",TRUE,"Carolina Panthers",21,7,24,449,237,212,0,15,271,198,73,3,2009-09-28,3,1,"dal",14
"4","Sun","October 4","L","","2-2",FALSE,"Denver Broncos",10,17,20,315,241,74,2,18,337,221,116,1,2009-10-04,-1,0,"dal",-7
"5","Sun","October 11","W","OT","3-2",FALSE,"Kansas City Chiefs",26,20,20,498,348,150,2,20,304,232,72,0,2009-10-11,-2,1,"dal",6
"7","Sun","October 25","W","","4-2",TRUE,"Atlanta Falcons",37,21,18,414,299,115,1,21,298,174,124,3,2009-10-25,2,1,"dal",16
"8","Sun","November 1","W","","5-2",TRUE,"Seattle Seahawks",38,17,26,362,249,113,1,18,308,229,79,2,2009-11-01,1,1,"dal",21
"9","Sun","November 8","W","","6-2",FALSE,"Philadelphia Eagles",20,16,18,358,282,76,1,17,297,208,89,2,2009-11-08,1,1,"dal",4
"10","Sun","November 15","L","","6-3",FALSE,"Green Bay Packers",7,17,17,278,217,61,3,20,283,178,105,0,2009-11-15,-3,0,"dal",-10
"11","Sun","November 22","W","","7-3",TRUE,"Washington Redskins",7,6,17,305,152,153,2,14,324,246,78,1,2009-11-22,-1,1,"dal",1
"12","Thu","November 26","W","","8-3",TRUE,"Oakland Raiders",24,7,18,494,299,195,0,14,305,181,124,1,2009-11-26,1,1,"dal",17
"13","Sun","December 6","L","","8-4",FALSE,"New York Giants",24,31,27,424,379,45,1,15,337,237,100,2,2009-12-06,1,0,"dal",-7
"14","Sun","December 13","L","","8-5",TRUE,"San Diego Chargers",17,20,22,347,239,108,0,21,341,268,73,1,2009-12-13,1,0,"dal",-3
"15","Sat","December 19","W","","9-5",FALSE,"New Orleans Saints",24,17,24,439,294,145,0,23,336,271,65,3,2009-12-19,3,1,"dal",7
"16","Sun","December 27","W","","10-5",FALSE,"Washington Redskins",17,0,22,393,285,108,1,15,208,165,43,1,2009-12-27,0,1,"dal",17
"17","Sun","January 3","W","","11-5",TRUE,"Philadelphia Eagles",24,0,21,474,295,179,1,10,228,191,37,1,2010-01-03,0,1,"dal",24
"WildCard","Sat","January 9","W","","12-5",TRUE,"Philadelphia Eagles",34,14,27,426,228,198,1,17,340,284,56,4,2010-01-09,3,1,"dal",20
"Division","Sun","January 17","L","","12-6",FALSE,"Minnesota Vikings",3,34,16,248,156,92,3,16,323,214,109,0,2010-01-17,-3,0,"dal",-31
"1","Sun","September 12","L","","0-1",FALSE,"Washington Redskins",7,13,24,380,277,103,1,17,250,161,89,0,2010-09-12,-1,0,"dal",-6
"2","Sun","September 19","L","","0-2",TRUE,"Chicago Bears",20,27,23,410,374,36,3,14,308,270,38,0,2010-09-19,-3,0,"dal",-7
"3","Sun","September 26","W","","1-2",FALSE,"Houston Texans",27,13,21,385,284,101,0,24,340,216,124,3,2010-09-26,3,1,"dal",14
"5","Sun","October 10","L","","1-3",TRUE,"Tennessee Titans",27,34,25,511,370,141,3,17,321,163,158,0,2010-10-10,-3,0,"dal",-7
"6","Sun","October 17","L","","1-4",FALSE,"Minnesota Vikings",21,24,16,314,220,94,2,14,188,93,95,1,2010-10-17,-1,0,"dal",-3
"7","Mon","October 25","L","","1-5",TRUE,"New York Giants",35,41,14,254,213,41,2,25,497,297,200,5,2010-10-25,3,0,"dal",-6
"8","Sun","October 31","L","","1-6",TRUE,"Jacksonville Jaguars",17,35,25,415,365,50,4,20,387,238,149,1,2010-10-31,-3,0,"dal",-18
"9","Sun","November 7","L","","1-7",FALSE,"Green Bay Packers",7,45,12,205,166,39,4,26,415,277,138,0,2010-11-07,-4,0,"dal",-38
"10","Sun","November 14","W","","2-7",FALSE,"New York Giants",33,20,15,427,327,100,1,25,480,373,107,3,2010-11-14,2,1,"dal",13
"11","Sun","November 21","W","","3-7",TRUE,"Detroit Lions",35,19,19,265,131,134,1,17,338,263,75,2,2010-11-21,1,1,"dal",16
"12","Thu","November 25","L","","3-8",TRUE,"New Orleans Saints",27,30,24,457,313,144,3,21,414,333,81,2,2010-11-25,-1,0,"dal",-3
"13","Sun","December 5","W","OT","4-8",FALSE,"Indianapolis Colts",38,35,24,368,151,217,0,24,405,365,40,4,2010-12-05,4,1,"dal",3
"14","Sun","December 12","L","","4-9",TRUE,"Philadelphia Eagles",27,30,22,349,239,110,2,18,429,258,171,2,2010-12-12,0,0,"dal",-3
"15","Sun","December 19","W","","5-9",TRUE,"Washington Redskins",33,30,25,434,300,134,0,23,341,286,55,3,2010-12-19,3,1,"dal",3
"16","Sat","December 25","L","","5-10",FALSE,"Arizona Cardinals",26,27,24,382,199,183,3,10,271,178,93,0,2010-12-25,-3,0,"dal",-1
"17","Sun","January 2","W","","6-10",FALSE,"Philadelphia Eagles",14,13,14,272,113,159,1,14,244,123,121,4,2011-01-02,3,1,"dal",1
"1","Sun","September 11","L","","0-1",FALSE,"New York Jets",24,27,21,390,326,64,3,19,360,315,45,2,2011-09-11,-1,0,"dal",-3
"2","Sun","September 18","W","OT","1-1",FALSE,"San Francisco 49ers",27,24,20,472,427,45,2,14,206,132,74,1,2011-09-18,-1,1,"dal",3
"3","Mon","September 26","W","","2-1",TRUE,"Washington Redskins",18,16,17,375,250,125,2,20,298,233,65,2,2011-09-26,0,1,"dal",2
"4","Sun","October 2","L","","2-2",TRUE,"Detroit Lions",30,34,25,434,321,113,3,18,303,240,63,1,2011-10-02,-2,0,"dal",-4
"6","Sun","October 16","L","","2-3",FALSE,"New England Patriots",16,20,21,377,300,77,2,25,371,270,101,4,2011-10-16,2,0,"dal",-4
"7","Sun","October 23","W","","3-3",TRUE,"St. Louis Rams",34,7,24,445,151,294,1,13,265,195,70,2,2011-10-23,1,1,"dal",27
"8","Sun","October 30","L","","3-4",FALSE,"Philadelphia Eagles",7,34,12,267,182,85,1,31,495,256,239,0,2011-10-30,-1,0,"dal",-27
"9","Sun","November 6","W","","4-4",TRUE,"Seattle Seahawks",23,13,18,442,279,163,1,18,381,219,162,3,2011-11-06,2,1,"dal",10
"10","Sun","November 13","W","","5-4",TRUE,"Buffalo Bills",44,7,24,433,270,163,0,20,271,136,135,4,2011-11-13,4,1,"dal",37
"11","Sun","November 20","W","OT","6-4",FALSE,"Washington Redskins",27,24,20,353,264,89,0,18,339,279,60,2,2011-11-20,2,1,"dal",3
"12","Thu","November 24","W","","7-4",TRUE,"Miami Dolphins",20,19,19,303,218,85,2,18,352,263,89,1,2011-11-24,-1,1,"dal",1
"13","Sun","December 4","L","OT","7-5",FALSE,"Arizona Cardinals",13,19,20,336,261,75,0,16,327,224,103,0,2011-12-04,0,0,"dal",-6
"14","Sun","December 11","L","","7-6",TRUE,"New York Giants",34,37,23,444,305,139,1,28,510,400,110,1,2011-12-11,0,0,"dal",-3
"15","Sat","December 17","W","","8-6",FALSE,"Tampa Bay Buccaneers",31,15,28,399,239,160,1,7,190,132,58,1,2011-12-17,0,1,"dal",16
"16","Sat","December 24","L","","8-7",TRUE,"Philadelphia Eagles",7,20,16,238,157,81,0,20,386,281,105,1,2011-12-24,1,0,"dal",-13
"17","Sun","January 1","L","","8-8",FALSE,"New York Giants",14,31,19,300,251,49,2,20,437,331,106,0,2012-01-01,-2,0,"dal",-17
"1","Sun","September 8","W","","1-0",TRUE,"Philadelphia Eagles",21,0,21,317,125,192,2,11,168,88,80,1,1985-09-08,-1,1,"nyg",21
"2","Sun","September 15","L","","1-1",FALSE,"Green Bay Packers",20,23,17,315,239,76,1,20,290,164,126,2,1985-09-15,1,0,"nyg",-3
"3","Sun","September 22","W","","2-1",TRUE,"St. Louis Cardinals",27,17,19,318,163,155,1,18,289,206,83,3,1985-09-22,2,1,"nyg",10
"4","Sun","September 29","W","OT","3-1",FALSE,"Philadelphia Eagles",16,10,21,338,198,140,3,11,168,54,114,1,1985-09-29,-2,1,"nyg",6
"5","Sun","October 6","L","","3-2",TRUE,"Dallas Cowboys",29,30,19,473,403,70,5,27,423,317,106,4,1985-10-06,-1,0,"nyg",-1
"6","Sun","October 13","L","","3-3",FALSE,"Cincinnati Bengals",30,35,34,470,443,27,4,16,199,157,42,0,1985-10-13,-4,0,"nyg",-5
"7","Sun","October 20","W","","4-3",TRUE,"Washington Redskins",17,3,21,329,185,144,3,16,276,207,69,3,1985-10-20,0,1,"nyg",14
"8","Sun","October 27","W","","5-3",FALSE,"New Orleans Saints",21,13,27,388,154,234,2,12,232,101,131,4,1985-10-27,2,1,"nyg",8
"9","Sun","November 3","W","","6-3",TRUE,"Tampa Bay Buccaneers",22,20,23,342,167,175,0,20,316,228,88,1,1985-11-03,1,1,"nyg",2
"10","Sun","November 10","W","","7-3",TRUE,"Los Angeles Rams",24,19,21,333,224,109,3,14,261,103,158,1,1985-11-10,-2,1,"nyg",5
"11","Mon","November 18","L","","7-4",FALSE,"Washington Redskins",21,23,12,253,101,152,1,22,356,258,98,3,1985-11-18,2,0,"nyg",-2
"12","Sun","November 24","W","","8-4",FALSE,"St. Louis Cardinals",34,3,20,313,152,161,2,13,221,181,40,5,1985-11-24,3,1,"nyg",31
"13","Sun","December 1","L","","8-5",TRUE,"Cleveland Browns",33,35,28,496,267,229,3,17,314,205,109,3,1985-12-01,0,0,"nyg",-2
"14","Sun","December 8","W","","9-5",FALSE,"Houston Oilers",35,14,25,432,234,198,2,18,320,298,22,3,1985-12-08,1,1,"nyg",21
"15","Sun","December 15","L","","9-6",FALSE,"Dallas Cowboys",21,28,25,396,296,100,4,13,273,172,101,1,1985-12-15,-3,0,"nyg",-7
"16","Sat","December 21","W","","10-6",TRUE,"Pittsburgh Steelers",28,10,23,371,82,289,2,10,214,99,115,2,1985-12-21,0,1,"nyg",18
"WildCard","Sun","December 29","W","","11-6",TRUE,"San Francisco 49ers",17,3,21,355,181,174,1,19,362,268,94,2,1985-12-29,1,1,"nyg",14
"Division","Sun","January 5","L","","11-7",FALSE,"Chicago Bears",0,21,10,181,149,32,1,17,363,216,147,0,1986-01-05,-1,0,"nyg",-21
"1","Mon","September 8","L","","0-1",FALSE,"Dallas Cowboys",28,31,24,377,261,116,2,22,378,265,113,2,1986-09-08,0,0,"nyg",-3
"2","Sun","September 14","W","","1-1",TRUE,"San Diego Chargers",20,7,25,391,257,134,1,18,262,221,41,7,1986-09-14,6,1,"nyg",13
"3","Sun","September 21","W","","2-1",FALSE,"Los Angeles Raiders",14,9,18,334,205,129,2,14,318,260,58,2,1986-09-21,0,1,"nyg",5
"4","Sun","September 28","W","","3-1",TRUE,"New Orleans Saints",20,17,26,388,274,114,3,10,196,131,65,1,1986-09-28,-2,1,"nyg",3
"5","Sun","October 5","W","","4-1",FALSE,"St. Louis Cardinals",13,6,8,144,83,61,1,12,241,158,83,2,1986-10-05,1,1,"nyg",7
"6","Sun","October 12","W","","5-1",TRUE,"Philadelphia Eagles",35,3,24,394,216,178,1,9,117,58,59,2,1986-10-12,1,1,"nyg",32
"7","Sun","October 19","L","","5-2",FALSE,"Seattle Seahawks",12,17,22,307,145,162,4,13,218,146,72,2,1986-10-19,-2,0,"nyg",-5
"8","Mon","October 27","W","","6-2",TRUE,"Washington Redskins",27,20,24,397,195,202,0,17,410,378,32,2,1986-10-27,2,1,"nyg",7
"9","Sun","November 2","W","","7-2",TRUE,"Dallas Cowboys",17,14,14,245,46,199,3,25,408,306,102,3,1986-11-02,0,1,"nyg",3
"10","Sun","November 9","W","","8-2",FALSE,"Philadelphia Eagles",17,14,15,265,112,153,2,17,237,159,78,2,1986-11-09,0,1,"nyg",3
"11","Sun","November 16","W","","9-2",FALSE,"Minnesota Vikings",22,20,23,383,293,90,2,21,353,244,109,1,1986-11-16,-1,1,"nyg",2
"12","Sun","November 23","W","","10-2",TRUE,"Denver Broncos",19,16,14,262,119,143,2,26,405,325,80,4,1986-11-23,2,1,"nyg",3
"13","Mon","December 1","W","","11-2",FALSE,"San Francisco 49ers",21,17,20,397,384,13,3,26,367,251,116,1,1986-12-01,-2,1,"nyg",4
"14","Sun","December 7","W","","12-2",FALSE,"Washington Redskins",24,14,17,333,259,74,2,22,349,276,73,7,1986-12-07,5,1,"nyg",10
"15","Sun","December 14","W","","13-2",TRUE,"St. Louis Cardinals",27,7,20,313,62,251,2,15,184,100,84,2,1986-12-14,0,1,"nyg",20
"16","Sat","December 20","W","","14-2",TRUE,"Green Bay Packers",55,24,30,448,222,226,2,17,314,195,119,3,1986-12-20,1,1,"nyg",31
"Division","Sun","January 4","W","","15-2",TRUE,"San Francisco 49ers",49,3,21,366,150,216,0,9,184,155,29,4,1987-01-04,4,1,"nyg",46
"ConfChamp","Sun","January 11","W","","16-2",TRUE,"Washington Redskins",17,0,12,199,82,117,3,12,190,150,40,2,1987-01-11,-1,1,"nyg",17
"SuperBowl","Sun","January 25","W","","17-2",TRUE,"Denver Broncos",39,20,24,399,263,136,0,24,372,320,52,1,1987-01-25,1,1,"nyg",19
"1","Mon","September 14","L","","0-1",FALSE,"Chicago Bears",19,34,14,203,122,81,1,17,416,292,124,2,1987-09-14,1,0,"nyg",-15
"2","Sun","September 20","L","","0-2",TRUE,"Dallas Cowboys",14,16,14,265,205,60,5,21,356,242,114,4,1987-09-20,-1,0,"nyg",-2
"3","Mon","October 5","L","","0-3",TRUE,"San Francisco 49ers",21,41,14,231,154,77,4,28,433,191,242,1,1987-10-05,-3,0,"nyg",-20
"4","Sun","October 11","L","","0-4",TRUE,"Washington Redskins",12,38,13,171,124,47,3,24,376,176,200,2,1987-10-11,-1,0,"nyg",-26
"5","Sun","October 18","L","OT","0-5",FALSE,"Buffalo Bills",3,6,19,308,180,128,2,22,331,164,167,7,1987-10-18,5,0,"nyg",-3
"6","Sun","October 25","W","","1-5",TRUE,"St. Louis Cardinals",30,7,21,394,232,162,1,19,308,257,51,4,1987-10-25,3,1,"nyg",23
"7","Mon","November 2","L","","1-6",FALSE,"Dallas Cowboys",24,33,16,297,242,55,5,15,240,214,26,2,1987-11-02,-3,0,"nyg",-9
"8","Sun","November 8","W","","2-6",TRUE,"New England Patriots",17,10,24,347,217,130,3,11,232,159,73,3,1987-11-08,0,1,"nyg",7
"9","Sun","November 15","W","","3-6",FALSE,"Philadelphia Eagles",20,17,17,384,268,116,3,22,337,146,191,1,1987-11-15,-2,1,"nyg",3
"10","Sun","November 22","L","","3-7",FALSE,"New Orleans Saints",14,23,16,298,223,75,7,16,278,175,103,2,1987-11-22,-5,0,"nyg",-9
"11","Sun","November 29","L","","3-8",FALSE,"Washington Redskins",19,23,16,319,200,119,1,20,357,275,82,4,1987-11-29,3,0,"nyg",-4
"12","Sun","December 6","W","OT","4-8",TRUE,"Philadelphia Eagles",23,20,15,299,221,78,2,15,259,164,95,1,1987-12-06,-1,1,"nyg",3
"13","Sun","December 13","L","","4-9",FALSE,"St. Louis Cardinals",24,27,23,397,335,62,2,23,322,164,158,0,1987-12-13,-2,0,"nyg",-3
"14","Sat","December 19","W","","5-9",TRUE,"Green Bay Packers",20,10,21,326,215,111,3,10,179,105,74,1,1987-12-19,-2,1,"nyg",10
"15","Sun","December 27","W","","6-9",TRUE,"New York Jets",20,7,23,420,264,156,0,13,234,166,68,0,1987-12-27,0,1,"nyg",13
"1","Mon","September 5","W","","1-0",TRUE,"Washington Redskins",27,20,16,218,162,56,1,20,386,269,117,2,1988-09-05,1,1,"nyg",7
"2","Sun","September 11","L","","1-1",TRUE,"San Francisco 49ers",17,20,17,309,197,112,0,25,430,249,181,2,1988-09-11,2,0,"nyg",-3
"3","Sun","September 18","W","","2-1",FALSE,"Dallas Cowboys",12,10,21,278,150,128,2,22,366,275,91,2,1988-09-18,0,1,"nyg",2
"4","Sun","September 25","L","","2-2",TRUE,"Los Angeles Rams",31,45,24,363,284,79,3,21,369,232,137,1,1988-09-25,-2,0,"nyg",-14
"5","Sun","October 2","W","","3-2",FALSE,"Washington Redskins",24,23,20,264,190,74,1,19,344,251,93,3,1988-10-02,2,1,"nyg",1
"6","Mon","October 10","L","","3-3",FALSE,"Philadelphia Eagles",13,24,23,436,336,100,1,23,452,343,109,0,1988-10-10,-1,0,"nyg",-11
"7","Sun","October 16","W","","4-3",TRUE,"Detroit Lions",30,10,23,402,280,122,2,10,113,65,48,2,1988-10-16,0,1,"nyg",20
"8","Sun","October 23","W","","5-3",FALSE,"Atlanta Falcons",23,16,22,346,225,121,3,23,368,216,152,2,1988-10-23,-1,1,"nyg",7
"9","Sun","October 30","W","OT","6-3",FALSE,"Detroit Lions",13,10,20,272,196,76,2,11,146,98,48,2,1988-10-30,0,1,"nyg",3
"10","Sun","November 6","W","","7-3",TRUE,"Dallas Cowboys",29,21,15,262,151,111,1,21,365,262,103,3,1988-11-06,2,1,"nyg",8
"11","Sun","November 13","L","","7-4",FALSE,"Phoenix Cardinals",17,24,21,280,188,92,0,24,495,351,144,2,1988-11-13,2,0,"nyg",-7
"12","Sun","November 20","L","OT","7-5",TRUE,"Philadelphia Eagles",17,23,21,394,316,78,3,18,283,176,107,1,1988-11-20,-2,0,"nyg",-6
"13","Sun","November 27","W","","8-5",FALSE,"New Orleans Saints",13,12,8,219,205,14,5,16,255,100,155,5,1988-11-27,0,1,"nyg",1
"14","Sun","December 4","W","","9-5",TRUE,"Phoenix Cardinals",44,7,25,301,131,170,1,7,158,91,67,5,1988-12-04,4,1,"nyg",37
"15","Sun","December 11","W","","10-5",TRUE,"Kansas City Chiefs",28,12,17,244,85,159,1,16,258,151,107,1,1988-12-11,0,1,"nyg",16
"16","Sun","December 18","L","","10-6",FALSE,"New York Jets",21,27,24,367,170,197,1,15,298,198,100,0,1988-12-18,-1,0,"nyg",-6
"1","Mon","September 11","W","","1-0",FALSE,"Washington Redskins",27,24,19,390,231,159,3,19,457,345,112,3,1989-09-11,0,1,"nyg",3
"2","Sun","September 17","W","","2-0",TRUE,"Detroit Lions",24,14,21,345,216,129,1,19,410,315,95,5,1989-09-17,4,1,"nyg",10
"3","Sun","September 24","W","","3-0",TRUE,"Phoenix Cardinals",35,7,16,366,204,162,1,16,248,183,65,6,1989-09-24,5,1,"nyg",28
"4","Sun","October 1","W","","4-0",FALSE,"Dallas Cowboys",30,13,20,342,205,137,5,12,288,201,87,2,1989-10-01,-3,1,"nyg",17
"5","Sun","October 8","L","","4-1",FALSE,"Philadelphia Eagles",19,21,20,323,239,84,1,18,243,85,158,0,1989-10-08,-1,0,"nyg",-2
"6","Sun","October 15","W","","5-1",TRUE,"Washington Redskins",20,17,19,306,173,133,1,18,316,194,122,2,1989-10-15,1,1,"nyg",3
"7","Sun","October 22","W","","6-1",FALSE,"San Diego Chargers",20,13,24,327,218,109,2,9,179,128,51,1,1989-10-22,-1,1,"nyg",7
"8","Mon","October 30","W","","7-1",TRUE,"Minnesota Vikings",24,14,13,174,55,119,0,20,250,140,110,4,1989-10-30,4,1,"nyg",10
"9","Sun","November 5","W","","8-1",FALSE,"Phoenix Cardinals",20,13,22,384,174,210,2,14,186,111,75,1,1989-11-05,-1,1,"nyg",7
"10","Sun","November 12","L","","8-2",FALSE,"Los Angeles Rams",10,31,13,207,201,6,2,28,445,295,150,2,1989-11-12,0,0,"nyg",-21
"11","Sun","November 19","W","","9-2",TRUE,"Seattle Seahawks",15,3,21,349,187,162,1,12,195,132,63,2,1989-11-19,1,1,"nyg",12
"12","Mon","November 27","L","","9-3",FALSE,"San Francisco 49ers",24,34,23,342,290,52,5,24,381,285,96,3,1989-11-27,-2,0,"nyg",-10
"13","Sun","December 3","L","","9-4",TRUE,"Philadelphia Eagles",17,24,17,294,236,58,5,13,279,130,149,2,1989-12-03,-3,0,"nyg",-7
"14","Sun","December 10","W","","10-4",FALSE,"Denver Broncos",14,7,16,261,148,113,0,18,367,284,83,0,1989-12-10,0,1,"nyg",7
"15","Sat","December 16","W","","11-4",TRUE,"Dallas Cowboys",15,0,14,273,133,140,0,7,108,67,41,1,1989-12-16,1,1,"nyg",15
"16","Sun","December 24","W","","12-4",TRUE,"Los Angeles Raiders",34,17,20,280,164,116,1,19,312,230,82,3,1989-12-24,2,1,"nyg",17
"Division","Sun","January 7","L","OT","12-5",TRUE,"Los Angeles Rams",13,19,20,344,173,171,1,26,448,302,146,2,1990-01-07,1,0,"nyg",-6
"1","Sun","September 9","W","","1-0",TRUE,"Philadelphia Eagles",27,20,11,227,148,79,1,21,295,214,81,3,1990-09-09,2,1,"nyg",7
"2","Sun","September 16","W","","2-0",FALSE,"Dallas Cowboys",28,7,23,369,208,161,3,9,156,136,20,4,1990-09-16,1,1,"nyg",21
"3","Sun","September 23","W","","3-0",TRUE,"Miami Dolphins",20,3,17,310,179,131,0,7,158,119,39,3,1990-09-23,3,1,"nyg",17
"4","Sun","September 30","W","","4-0",TRUE,"Dallas Cowboys",31,17,21,334,198,136,0,20,284,233,51,2,1990-09-30,2,1,"nyg",14
"6","Sun","October 14","W","","5-0",FALSE,"Washington Redskins",24,20,13,332,275,57,1,22,328,166,162,4,1990-10-14,3,1,"nyg",4
"7","Sun","October 21","W","","6-0",TRUE,"Phoenix Cardinals",20,19,18,321,164,157,2,14,221,96,125,0,1990-10-21,-2,1,"nyg",1
"8","Sun","October 28","W","","7-0",TRUE,"Washington Redskins",21,10,16,263,141,122,0,16,213,149,64,3,1990-10-28,3,1,"nyg",11
"9","Mon","November 5","W","","8-0",FALSE,"Indianapolis Colts",24,7,17,274,158,116,2,11,181,126,55,1,1990-11-05,-1,1,"nyg",17
"10","Sun","November 11","W","","9-0",FALSE,"Los Angeles Rams",31,7,20,300,185,115,1,14,274,174,100,3,1990-11-11,2,1,"nyg",24
"11","Sun","November 18","W","","10-0",TRUE,"Detroit Lions",20,0,15,314,170,144,0,15,208,133,75,2,1990-11-18,2,1,"nyg",20
"12","Sun","November 25","L","","10-1",FALSE,"Philadelphia Eagles",13,31,16,327,219,108,2,22,405,229,176,2,1990-11-25,0,0,"nyg",-18
"13","Mon","December 3","L","","10-2",FALSE,"San Francisco 49ers",3,7,15,221,146,75,1,11,240,152,88,0,1990-12-03,-1,0,"nyg",-4
"14","Sun","December 9","W","","11-2",TRUE,"Minnesota Vikings",23,15,14,228,113,115,0,18,269,135,134,3,1990-12-09,3,1,"nyg",8
"15","Sat","December 15","L","","11-3",TRUE,"Buffalo Bills",13,17,20,313,156,157,0,13,264,199,65,0,1990-12-15,0,0,"nyg",-4
"16","Sun","December 23","W","","12-3",FALSE,"Phoenix Cardinals",24,21,20,348,185,163,0,20,452,368,84,2,1990-12-23,2,1,"nyg",3
"17","Sun","December 30","W","","13-3",FALSE,"New England Patriots",13,10,17,324,111,213,1,12,258,118,140,2,1990-12-30,1,1,"nyg",3
"Division","Sun","January 13","W","","14-3",TRUE,"Chicago Bears",31,3,23,288,94,194,1,11,232,205,27,2,1991-01-13,1,1,"nyg",28
"ConfChamp","Sun","January 20","W","","15-3",FALSE,"San Francisco 49ers",15,13,20,311,159,152,0,13,240,201,39,1,1991-01-20,1,1,"nyg",2
"SuperBowl","Sun","January 27","W","","16-3",TRUE,"Buffalo Bills",20,19,24,386,214,172,0,18,371,205,166,0,1991-01-27,0,1,"nyg",1
"1","Mon","September 2","W","","1-0",TRUE,"San Francisco 49ers",16,14,17,331,201,130,0,14,258,152,106,2,1991-09-02,2,1,"nyg",2
"2","Sun","September 8","L","","1-1",TRUE,"Los Angeles Rams",13,19,18,293,177,116,3,10,217,74,143,1,1991-09-08,-2,0,"nyg",-6
"3","Sun","September 15","L","","1-2",FALSE,"Chicago Bears",17,20,21,337,205,132,2,10,307,206,101,3,1991-09-15,1,0,"nyg",-3
"4","Sun","September 22","W","","2-2",TRUE,"Cleveland Browns",13,10,12,264,52,212,2,10,145,67,78,0,1991-09-22,-2,1,"nyg",3
"5","Sun","September 29","L","","2-3",FALSE,"Dallas Cowboys",16,21,26,487,368,119,3,20,327,269,58,1,1991-09-29,-2,0,"nyg",-5
"6","Sun","October 6","W","","3-3",TRUE,"Phoenix Cardinals",20,9,19,368,200,168,1,21,307,214,93,2,1991-10-06,1,1,"nyg",11
"7","Mon","October 14","W","","4-3",FALSE,"Pittsburgh Steelers",23,20,17,311,114,197,0,20,377,229,148,1,1991-10-14,1,1,"nyg",3
"9","Sun","October 27","L","","4-4",TRUE,"Washington Redskins",13,17,15,271,137,134,1,16,254,159,95,1,1991-10-27,0,0,"nyg",-4
"10","Mon","November 4","L","","4-5",FALSE,"Philadelphia Eagles",7,30,9,187,134,53,1,19,359,222,137,0,1991-11-04,-1,0,"nyg",-23
"11","Sun","November 10","W","","5-5",FALSE,"Phoenix Cardinals",21,14,17,290,110,180,1,14,244,189,55,2,1991-11-10,1,1,"nyg",7
"12","Sun","November 17","W","","6-5",TRUE,"Dallas Cowboys",22,9,21,315,177,138,1,14,243,142,101,2,1991-11-17,1,1,"nyg",13
"13","Sun","November 24","W","","7-5",FALSE,"Tampa Bay Buccaneers",21,14,15,236,158,78,0,13,227,88,139,2,1991-11-24,2,1,"nyg",7
"14","Sun","December 1","L","","7-6",FALSE,"Cincinnati Bengals",24,27,22,347,278,69,1,15,251,204,47,0,1991-12-01,-1,0,"nyg",-3
"15","Sun","December 8","L","","7-7",TRUE,"Philadelphia Eagles",14,19,10,151,84,67,3,20,324,173,151,2,1991-12-08,-1,0,"nyg",-5
"16","Sun","December 15","L","","7-8",FALSE,"Washington Redskins",17,34,20,337,259,78,3,18,415,264,151,2,1991-12-15,-1,0,"nyg",-17
"17","Sat","December 21","W","","8-8",TRUE,"Houston Oilers",24,20,21,383,190,193,1,23,345,222,123,0,1991-12-21,-1,1,"nyg",4
"1","Sun","September 6","L","","0-1",TRUE,"San Francisco 49ers",14,31,21,315,196,119,2,27,384,212,172,1,1992-09-06,-1,0,"nyg",-17
"2","Sun","September 13","L","","0-2",TRUE,"Dallas Cowboys",28,34,22,331,264,67,1,20,327,229,98,0,1992-09-13,-1,0,"nyg",-6
"3","Mon","September 21","W","","1-2",FALSE,"Chicago Bears",27,14,26,386,212,174,1,16,274,175,99,2,1992-09-21,1,1,"nyg",13
"5","Sun","October 4","L","","1-3",FALSE,"Los Angeles Raiders",10,13,20,278,173,105,1,14,300,219,81,1,1992-10-04,0,0,"nyg",-3
"6","Sun","October 11","W","","2-3",TRUE,"Phoenix Cardinals",31,21,20,399,139,260,0,22,306,193,113,1,1992-10-11,1,1,"nyg",10
"7","Sun","October 18","L","","2-4",FALSE,"Los Angeles Rams",17,38,18,296,172,124,2,22,356,226,130,1,1992-10-18,-1,0,"nyg",-21
"8","Sun","October 25","W","","3-4",TRUE,"Seattle Seahawks",23,10,13,261,85,176,2,12,186,108,78,2,1992-10-25,0,1,"nyg",13
"9","Sun","November 1","W","","4-4",FALSE,"Washington Redskins",24,7,24,389,148,241,0,12,239,178,61,2,1992-11-01,2,1,"nyg",17
"10","Sun","November 8","W","","5-4",TRUE,"Green Bay Packers",27,7,9,177,119,58,2,20,361,273,88,5,1992-11-08,3,1,"nyg",20
"11","Sun","November 15","L","","5-5",FALSE,"Denver Broncos",13,27,10,159,39,120,1,18,379,230,149,2,1992-11-15,1,0,"nyg",-14
"12","Sun","November 22","L","","5-6",TRUE,"Philadelphia Eagles",34,47,23,345,251,94,4,17,365,181,184,4,1992-11-22,0,0,"nyg",-13
"13","Thu","November 26","L","","5-7",FALSE,"Dallas Cowboys",3,30,12,207,127,80,1,17,299,142,157,1,1992-11-26,0,0,"nyg",-27
"14","Sun","December 6","L","","5-8",TRUE,"Washington Redskins",10,28,10,165,60,105,0,22,393,216,177,0,1992-12-06,0,0,"nyg",-18
"15","Sat","December 12","L","","5-9",FALSE,"Phoenix Cardinals",0,19,8,131,61,70,3,18,280,101,179,1,1992-12-12,-2,0,"nyg",-19
"16","Sat","December 19","W","","6-9",TRUE,"Kansas City Chiefs",35,21,22,348,131,217,0,14,298,250,48,2,1992-12-19,2,1,"nyg",14
"17","Sun","December 27","L","","6-10",FALSE,"Philadelphia Eagles",10,20,13,235,168,67,3,16,296,98,198,1,1992-12-27,-2,0,"nyg",-10
"1","Sun","September 5","W","","1-0",FALSE,"Chicago Bears",26,20,21,361,256,105,0,17,269,166,103,2,1993-09-05,2,1,"nyg",6
"2","Sun","September 12","W","","2-0",TRUE,"Tampa Bay Buccaneers",23,7,21,381,200,181,1,12,199,154,45,1,1993-09-12,0,1,"nyg",16
"3","Sun","September 19","W","","3-0",TRUE,"Los Angeles Rams",20,10,23,330,184,146,2,8,171,126,45,2,1993-09-19,0,1,"nyg",10
"5","Sun","October 3","L","","3-1",FALSE,"Buffalo Bills",14,17,19,299,153,146,4,17,251,112,139,2,1993-10-03,-2,0,"nyg",-3
"6","Sun","October 10","W","","4-1",FALSE,"Washington Redskins",41,7,26,415,216,199,0,16,304,239,65,4,1993-10-10,4,1,"nyg",34
"7","Sun","October 17","W","","5-1",TRUE,"Philadelphia Eagles",21,10,18,347,137,210,2,19,299,209,90,3,1993-10-17,1,1,"nyg",11
"9","Sun","October 31","L","","5-2",TRUE,"New York Jets",6,10,17,265,141,124,2,17,256,129,127,1,1993-10-31,-1,0,"nyg",-4
"10","Sun","November 7","L","","5-3",FALSE,"Dallas Cowboys",9,31,18,295,177,118,0,17,369,230,139,0,1993-11-07,0,0,"nyg",-22
"11","Sun","November 14","W","","6-3",TRUE,"Washington Redskins",20,6,16,262,110,152,1,20,325,230,95,3,1993-11-14,2,1,"nyg",14
"12","Sun","November 21","W","","7-3",FALSE,"Philadelphia Eagles",7,3,14,292,165,127,2,13,228,99,129,1,1993-11-21,-1,1,"nyg",4
"13","Sun","November 28","W","","8-3",TRUE,"Phoenix Cardinals",19,17,17,374,328,46,0,19,303,176,127,1,1993-11-28,1,1,"nyg",2
"14","Sun","December 5","W","","9-3",FALSE,"Miami Dolphins",19,14,19,351,241,110,0,23,408,357,51,3,1993-12-05,3,1,"nyg",5
"15","Sun","December 12","W","","10-3",TRUE,"Indianapolis Colts",20,6,19,290,85,205,0,14,305,250,55,0,1993-12-12,0,1,"nyg",14
"16","Mon","December 20","W","","11-3",FALSE,"New Orleans Saints",24,14,20,277,144,133,1,15,304,293,11,2,1993-12-20,1,1,"nyg",10
"17","Sun","December 26","L","","11-4",FALSE,"Phoenix Cardinals",6,17,16,293,215,78,1,20,333,189,144,2,1993-12-26,1,0,"nyg",-11
"18","Sun","January 2","L","OT","11-5",TRUE,"Dallas Cowboys",13,16,16,313,183,130,1,21,339,157,182,1,1994-01-02,0,0,"nyg",-3
"WildCard","Sun","January 9","W","","12-5",TRUE,"Minnesota Vikings",17,10,17,270,94,176,0,11,260,181,79,1,1994-01-09,1,1,"nyg",7
"Division","Sat","January 15","L","","12-6",FALSE,"San Francisco 49ers",3,44,12,194,153,41,3,25,413,235,178,1,1994-01-15,-2,0,"nyg",-41
"1","Sun","September 4","W","","1-0",TRUE,"Philadelphia Eagles",28,23,15,290,149,141,2,20,395,317,78,1,1994-09-04,-1,1,"nyg",5
"2","Sun","September 11","W","","2-0",FALSE,"Arizona Cardinals",20,17,19,206,88,118,2,11,174,135,39,3,1994-09-11,1,1,"nyg",3
"3","Sun","September 18","W","","3-0",TRUE,"Washington Redskins",31,23,20,337,231,106,0,24,456,376,80,2,1994-09-18,2,1,"nyg",8
"5","Sun","October 2","L","","3-1",FALSE,"New Orleans Saints",22,27,11,202,152,50,2,15,314,247,67,3,1994-10-02,1,0,"nyg",-5
"6","Mon","October 10","L","","3-2",TRUE,"Minnesota Vikings",10,27,16,240,203,37,3,25,395,292,103,2,1994-10-10,-1,0,"nyg",-17
"7","Sun","October 16","L","","3-3",FALSE,"Los Angeles Rams",10,17,14,282,161,121,2,17,274,169,105,1,1994-10-16,-1,0,"nyg",-7
"8","Sun","October 23","L","","3-4",TRUE,"Pittsburgh Steelers",6,10,8,215,162,53,3,16,296,121,175,4,1994-10-23,1,0,"nyg",-4
"9","Sun","October 30","L","OT","3-5",TRUE,"Detroit Lions",25,28,23,344,149,195,1,24,329,180,149,3,1994-10-30,2,0,"nyg",-3
"10","Mon","November 7","L","","3-6",FALSE,"Dallas Cowboys",10,38,11,188,133,55,3,27,450,241,209,2,1994-11-07,-1,0,"nyg",-28
"11","Sun","November 13","L","","3-7",TRUE,"Arizona Cardinals",9,10,17,231,81,150,1,18,239,173,66,1,1994-11-13,0,0,"nyg",-1
"12","Mon","November 21","W","","4-7",FALSE,"Houston Oilers",13,10,18,287,124,163,0,13,278,112,166,0,1994-11-21,0,1,"nyg",3
"13","Sun","November 27","W","","5-7",FALSE,"Washington Redskins",21,19,20,291,160,131,1,14,313,161,152,1,1994-11-27,0,1,"nyg",2
"14","Sun","December 4","W","","6-7",FALSE,"Cleveland Browns",16,13,18,298,202,96,1,13,306,229,77,5,1994-12-04,4,1,"nyg",3
"15","Sun","December 11","W","","7-7",TRUE,"Cincinnati Bengals",27,20,18,304,215,89,2,20,326,205,121,1,1994-12-11,-1,1,"nyg",7
"16","Sun","December 18","W","","8-7",FALSE,"Philadelphia Eagles",16,13,20,352,230,122,2,12,222,171,51,2,1994-12-18,0,1,"nyg",3
"17","Sat","December 24","W","","9-7",TRUE,"Dallas Cowboys",15,10,15,249,122,127,0,11,183,93,90,1,1994-12-24,1,1,"nyg",5
"1","Mon","September 4","L","","0-1",TRUE,"Dallas Cowboys",0,35,16,211,146,65,1,26,461,229,232,1,1995-09-04,0,0,"nyg",-35
"2","Sun","September 10","L","OT","0-2",FALSE,"Kansas City Chiefs",17,20,12,238,136,102,2,28,333,178,155,2,1995-09-10,0,0,"nyg",-3
"3","Sun","September 17","L","","0-3",FALSE,"Green Bay Packers",6,14,17,303,187,116,1,16,198,113,85,0,1995-09-17,-1,0,"nyg",-8
"4","Sun","September 24","W","","1-3",TRUE,"New Orleans Saints",45,29,31,474,256,218,1,18,322,235,87,2,1995-09-24,1,1,"nyg",16
"5","Sun","October 1","L","","1-4",FALSE,"San Francisco 49ers",6,20,17,237,204,33,1,22,311,202,109,1,1995-10-01,0,0,"nyg",-14
"6","Sun","October 8","W","OT","2-4",TRUE,"Arizona Cardinals",27,21,23,344,158,186,4,29,431,291,140,3,1995-10-08,-1,1,"nyg",6
"7","Sun","October 15","L","","2-5",TRUE,"Philadelphia Eagles",14,17,15,196,112,84,4,14,219,66,153,4,1995-10-15,0,0,"nyg",-3
"9","Sun","October 29","W","","3-5",FALSE,"Washington Redskins",24,15,13,243,129,114,2,20,409,306,103,5,1995-10-29,3,1,"nyg",9
"10","Sun","November 5","L","","3-6",FALSE,"Seattle Seahawks",28,30,26,403,286,117,0,24,386,248,138,2,1995-11-05,2,0,"nyg",-2
"11","Sun","November 12","L","","3-7",TRUE,"Oakland Raiders",13,17,15,267,191,76,1,20,299,146,153,1,1995-11-12,0,0,"nyg",-4
"12","Sun","November 19","L","","3-8",FALSE,"Philadelphia Eagles",19,28,15,223,118,105,4,20,330,179,151,3,1995-11-19,-1,0,"nyg",-9
"13","Sun","November 26","L","","3-9",TRUE,"Chicago Bears",24,27,23,338,217,121,0,26,409,266,143,1,1995-11-26,1,0,"nyg",-3
"14","Thu","November 30","W","","4-9",FALSE,"Arizona Cardinals",10,6,14,199,133,66,1,17,342,250,92,3,1995-11-30,2,1,"nyg",4
"15","Sun","December 10","W","","5-9",TRUE,"Washington Redskins",20,13,9,160,72,88,1,21,306,145,161,1,1995-12-10,0,1,"nyg",7
"16","Sun","December 17","L","","5-10",FALSE,"Dallas Cowboys",20,21,21,347,103,244,1,21,332,222,110,1,1995-12-17,0,0,"nyg",-1
"17","Sat","December 23","L","","5-11",TRUE,"San Diego Chargers",17,27,21,300,202,98,4,13,205,108,97,1,1995-12-23,-3,0,"nyg",-10
"1","Sun","September 1","L","OT","0-1",TRUE,"Buffalo Bills",20,23,12,231,138,93,1,25,410,257,153,2,1996-09-01,1,0,"nyg",-3
"2","Sun","September 8","L","","0-2",FALSE,"Dallas Cowboys",0,27,7,105,42,63,2,21,368,228,140,0,1996-09-08,-2,0,"nyg",-27
"3","Sun","September 15","L","","0-3",TRUE,"Washington Redskins",10,31,19,286,182,104,4,26,427,192,235,1,1996-09-15,-3,0,"nyg",-21
"4","Sun","September 22","W","","1-3",FALSE,"New York Jets",13,6,12,201,110,91,2,13,208,130,78,2,1996-09-22,0,1,"nyg",7
"5","Sun","September 29","W","","2-3",TRUE,"Minnesota Vikings",15,10,21,291,146,145,0,10,228,140,88,2,1996-09-29,2,1,"nyg",5
"7","Sun","October 13","L","","2-4",TRUE,"Philadelphia Eagles",10,19,9,150,63,87,2,17,304,164,140,0,1996-10-13,-2,0,"nyg",-9
"8","Sun","October 20","L","","2-5",FALSE,"Washington Redskins",21,31,24,394,287,107,2,20,330,207,123,1,1996-10-20,-1,0,"nyg",-10
"9","Sun","October 27","W","","3-5",FALSE,"Detroit Lions",35,7,18,335,235,100,2,14,252,185,67,6,1996-10-27,4,1,"nyg",28
"10","Sun","November 3","W","","4-5",TRUE,"Arizona Cardinals",16,8,17,279,144,135,0,14,245,216,29,2,1996-11-03,2,1,"nyg",8
"11","Sun","November 10","L","","4-6",FALSE,"Carolina Panthers",17,27,14,289,215,74,4,23,350,208,142,1,1996-11-10,-3,0,"nyg",-10
"12","Sun","November 17","L","","4-7",FALSE,"Arizona Cardinals",23,31,24,331,240,91,4,20,347,250,97,3,1996-11-17,-1,0,"nyg",-8
"13","Sun","November 24","W","","5-7",TRUE,"Dallas Cowboys",20,6,14,215,104,111,1,15,305,272,33,5,1996-11-24,4,1,"nyg",14
"14","Sun","December 1","L","","5-8",FALSE,"Philadelphia Eagles",0,24,9,121,37,84,4,24,410,271,139,3,1996-12-01,-1,0,"nyg",-24
"15","Sun","December 8","W","","6-8",FALSE,"Miami Dolphins",17,7,21,280,149,131,1,15,294,191,103,2,1996-12-08,1,1,"nyg",10
"16","Sun","December 15","L","","6-9",TRUE,"New Orleans Saints",3,17,10,138,48,90,4,11,261,106,155,3,1996-12-15,-1,0,"nyg",-14
"17","Sat","December 21","L","","6-10",TRUE,"New England Patriots",22,23,17,296,199,97,1,17,308,282,26,2,1996-12-21,1,0,"nyg",-1
"1","Sun","August 31","W","","1-0",TRUE,"Philadelphia Eagles",31,17,12,290,189,101,0,24,447,327,120,2,1997-08-31,2,1,"nyg",14
"2","Sun","September 7","L","","1-1",FALSE,"Jacksonville Jaguars",13,40,13,206,167,39,3,22,375,252,123,1,1997-09-07,-2,0,"nyg",-27
"3","Sun","September 14","L","","1-2",TRUE,"Baltimore Ravens",23,24,29,390,269,121,0,19,273,210,63,1,1997-09-14,1,0,"nyg",-1
"4","Sun","September 21","L","","1-3",FALSE,"St. Louis Rams",3,13,11,194,147,47,2,15,225,133,92,1,1997-09-21,-1,0,"nyg",-10
"5","Sun","September 28","W","","2-3",TRUE,"New Orleans Saints",14,9,18,264,159,105,2,14,266,193,73,2,1997-09-28,0,1,"nyg",5
"6","Sun","October 5","W","","3-3",TRUE,"Dallas Cowboys",20,17,13,166,109,57,0,27,428,310,118,2,1997-10-05,2,1,"nyg",3
"7","Sun","October 12","W","","4-3",FALSE,"Arizona Cardinals",27,13,23,426,187,239,1,19,235,208,27,5,1997-10-12,4,1,"nyg",14
"8","Sun","October 19","W","OT","5-3",FALSE,"Detroit Lions",26,20,15,331,210,121,1,20,337,226,111,2,1997-10-19,1,1,"nyg",6
"9","Sun","October 26","W","","6-3",TRUE,"Cincinnati Bengals",29,27,28,323,214,109,0,22,323,225,98,2,1997-10-26,2,1,"nyg",2
"11","Sun","November 9","L","","6-4",FALSE,"Tennessee Oilers",6,10,10,218,111,107,1,19,326,173,153,2,1997-11-09,1,0,"nyg",-4
"12","Sun","November 16","W","","7-4",TRUE,"Arizona Cardinals",19,10,21,373,172,201,0,21,399,350,49,3,1997-11-16,3,1,"nyg",9
"13","Sun","November 23","T","OT","7-4-1",FALSE,"Washington Redskins",7,7,18,262,105,157,2,23,374,291,83,4,1997-11-23,2,0,"nyg",0
"14","Sun","November 30","L","","7-5-1",TRUE,"Tampa Bay Buccaneers",8,20,13,202,103,99,2,21,299,152,147,3,1997-11-30,1,0,"nyg",-12
"15","Sun","December 7","W","","8-5-1",FALSE,"Philadelphia Eagles",31,21,18,345,137,208,2,15,256,186,70,5,1997-12-07,3,1,"nyg",10
"16","Sat","December 13","W","","9-5-1",TRUE,"Washington Redskins",30,10,14,240,110,130,2,18,320,275,45,6,1997-12-13,4,1,"nyg",20
"17","Sun","December 21","W","","10-5-1",FALSE,"Dallas Cowboys",20,7,17,283,136,147,1,11,184,105,79,3,1997-12-21,2,1,"nyg",13
"WildCard","Sat","December 27","L","","10-6-1",TRUE,"Minnesota Vikings",22,23,13,266,190,76,2,16,293,187,106,3,1997-12-27,1,0,"nyg",-1
"1","Sun","September 6","W","","1-0",TRUE,"Washington Redskins",31,24,15,235,153,82,1,21,331,258,73,3,1998-09-06,2,1,"nyg",7
"2","Sun","September 13","L","","1-1",FALSE,"Oakland Raiders",17,20,15,233,162,71,1,21,414,252,162,1,1998-09-13,0,0,"nyg",-3
"3","Mon","September 21","L","","1-2",TRUE,"Dallas Cowboys",7,31,16,252,196,56,4,11,302,224,78,0,1998-09-21,-4,0,"nyg",-24
"4","Sun","September 27","W","","2-2",FALSE,"San Diego Chargers",34,16,19,313,208,105,1,17,355,266,89,4,1998-09-27,3,1,"nyg",18
"5","Sun","October 4","L","","2-3",FALSE,"Tampa Bay Buccaneers",3,20,8,135,71,64,3,16,234,60,174,2,1998-10-04,-1,0,"nyg",-17
"6","Sun","October 11","L","","2-4",TRUE,"Atlanta Falcons",20,34,17,266,156,110,3,20,381,253,128,2,1998-10-11,-1,0,"nyg",-14
"7","Sun","October 18","W","","3-4",TRUE,"Arizona Cardinals",34,7,26,390,249,141,0,15,194,132,62,3,1998-10-18,3,1,"nyg",27
"9","Sun","November 1","L","","3-5",FALSE,"Washington Redskins",14,21,10,229,143,86,0,21,320,196,124,0,1998-11-01,0,0,"nyg",-7
"10","Sun","November 8","L","","3-6",FALSE,"Dallas Cowboys",6,16,15,286,127,159,1,16,327,165,162,0,1998-11-08,-1,0,"nyg",-10
"11","Sun","November 15","L","","3-7",TRUE,"Green Bay Packers",3,37,9,127,62,65,3,24,433,264,169,0,1998-11-15,-3,0,"nyg",-34
"12","Sun","November 22","W","","4-7",TRUE,"Philadelphia Eagles",20,0,15,261,138,123,1,16,214,97,117,2,1998-11-22,1,1,"nyg",20
"13","Mon","November 30","L","","4-8",FALSE,"San Francisco 49ers",7,31,18,344,224,120,2,23,466,229,237,0,1998-11-30,-2,0,"nyg",-24
"14","Sun","December 6","W","","5-8",FALSE,"Arizona Cardinals",23,19,15,344,144,200,2,17,328,253,75,3,1998-12-06,1,1,"nyg",4
"15","Sun","December 13","W","","6-8",TRUE,"Denver Broncos",20,16,18,392,254,138,2,21,329,159,170,1,1998-12-13,-1,1,"nyg",4
"16","Sun","December 20","W","","7-8",TRUE,"Kansas City Chiefs",28,7,25,309,149,160,0,15,279,218,61,4,1998-12-20,4,1,"nyg",21
"17","Sun","December 27","W","","8-8",FALSE,"Philadelphia Eagles",20,10,22,339,130,209,0,12,264,141,123,1,1998-12-27,1,1,"nyg",10
"1","Sun","September 12","W","","1-0",FALSE,"Tampa Bay Buccaneers",17,13,4,107,79,28,0,15,254,177,77,5,1999-09-12,5,1,"nyg",4
"2","Sun","September 19","L","","1-1",TRUE,"Washington Redskins",21,50,18,373,290,83,3,28,395,231,164,0,1999-09-19,-3,0,"nyg",-29
"3","Sun","September 26","L","","1-2",FALSE,"New England Patriots",14,16,19,258,201,57,0,17,290,223,67,0,1999-09-26,0,0,"nyg",-2
"4","Sun","October 3","W","","2-2",TRUE,"Philadelphia Eagles",16,15,24,361,233,128,5,10,174,90,84,3,1999-10-03,-2,1,"nyg",1
"5","Sun","October 10","L","","2-3",FALSE,"Arizona Cardinals",3,14,15,285,178,107,2,13,206,175,31,0,1999-10-10,-2,0,"nyg",-11
"6","Mon","October 18","W","","3-3",TRUE,"Dallas Cowboys",13,10,13,228,153,75,0,14,274,250,24,1,1999-10-18,1,1,"nyg",3
"7","Sun","October 24","W","","4-3",TRUE,"New Orleans Saints",31,3,19,321,215,106,2,12,270,163,107,3,1999-10-24,1,1,"nyg",28
"8","Sun","October 31","W","OT","5-3",FALSE,"Philadelphia Eagles",23,17,20,299,207,92,0,15,360,248,112,3,1999-10-31,3,1,"nyg",6
"10","Sun","November 14","L","","5-4",TRUE,"Indianapolis Colts",19,27,26,384,237,147,4,13,342,237,105,1,1999-11-14,-3,0,"nyg",-8
"11","Sun","November 21","L","","5-5",FALSE,"Washington Redskins",13,23,21,301,229,72,5,22,363,157,206,2,1999-11-21,-3,0,"nyg",-10
"12","Sun","November 28","L","","5-6",TRUE,"Arizona Cardinals",24,34,20,334,282,52,4,23,291,222,69,1,1999-11-28,-3,0,"nyg",-10
"13","Sun","December 5","W","","6-6",TRUE,"New York Jets",41,28,25,490,338,152,1,18,291,276,15,0,1999-12-05,-1,1,"nyg",13
"14","Sun","December 12","W","","7-6",FALSE,"Buffalo Bills",19,17,20,334,240,94,2,13,237,161,76,2,1999-12-12,0,1,"nyg",2
"15","Sun","December 19","L","","7-7",FALSE,"St. Louis Rams",10,31,20,328,261,67,2,19,419,319,100,1,1999-12-19,-1,0,"nyg",-21
"16","Sun","December 26","L","","7-8",TRUE,"Minnesota Vikings",17,34,25,344,268,76,1,18,378,204,174,2,1999-12-26,1,0,"nyg",-17
"17","Sun","January 2","L","","7-9",FALSE,"Dallas Cowboys",18,26,19,380,308,72,1,20,437,288,149,0,2000-01-02,-1,0,"nyg",-8
"1","Sun","September 3","W","","1-0",TRUE,"Arizona Cardinals",21,16,20,395,172,223,2,19,355,312,43,4,2000-09-03,2,1,"nyg",5
"2","Sun","September 10","W","","2-0",FALSE,"Philadelphia Eagles",33,18,24,387,220,167,0,13,237,181,56,0,2000-09-10,0,1,"nyg",15
"3","Sun","September 17","W","","3-0",FALSE,"Chicago Bears",14,7,23,409,237,172,1,13,228,180,48,1,2000-09-17,0,1,"nyg",7
"4","Sun","September 24","L","","3-1",TRUE,"Washington Redskins",6,16,21,261,168,93,1,17,394,284,110,0,2000-09-24,-1,0,"nyg",-10
"5","Sun","October 1","L","","3-2",FALSE,"Tennessee Titans",14,28,14,215,191,24,4,28,436,284,152,1,2000-10-01,-3,0,"nyg",-14
"6","Sun","October 8","W","","4-2",FALSE,"Atlanta Falcons",13,6,14,255,151,104,2,17,238,225,13,3,2000-10-08,1,1,"nyg",7
"7","Sun","October 15","W","","5-2",TRUE,"Dallas Cowboys",19,14,17,311,108,203,0,23,269,193,76,5,2000-10-15,5,1,"nyg",5
"9","Sun","October 29","W","","6-2",TRUE,"Philadelphia Eagles",24,7,25,384,232,152,0,8,192,120,72,1,2000-10-29,1,1,"nyg",17
"10","Sun","November 5","W","","7-2",FALSE,"Cleveland Browns",24,3,24,370,221,149,1,11,193,152,41,1,2000-11-05,0,1,"nyg",21
"11","Sun","November 12","L","","7-3",TRUE,"St. Louis Rams",24,38,14,348,213,135,3,28,397,256,141,1,2000-11-12,-2,0,"nyg",-14
"12","Sun","November 19","L","","7-4",TRUE,"Detroit Lions",21,31,25,373,320,53,4,22,314,219,95,2,2000-11-19,-2,0,"nyg",-10
"13","Sun","November 26","W","","8-4",FALSE,"Arizona Cardinals",31,7,25,371,225,146,1,14,267,179,88,4,2000-11-26,3,1,"nyg",24
"14","Sun","December 3","W","","9-4",FALSE,"Washington Redskins",9,7,13,305,164,141,3,15,290,261,29,2,2000-12-03,-1,1,"nyg",2
"15","Sun","December 10","W","","10-4",TRUE,"Pittsburgh Steelers",30,10,20,394,326,68,0,17,264,217,47,1,2000-12-10,1,1,"nyg",20
"16","Sun","December 17","W","","11-4",FALSE,"Dallas Cowboys",17,13,12,225,126,99,1,15,145,70,75,3,2000-12-17,2,1,"nyg",4
"17","Sat","December 23","W","","12-4",TRUE,"Jacksonville Jaguars",28,25,19,373,293,80,1,14,327,257,70,2,2000-12-23,1,1,"nyg",3
"Division","Sun","January 7","W","","13-4",TRUE,"Philadelphia Eagles",20,10,15,237,125,112,3,11,186,140,46,3,2001-01-07,0,1,"nyg",10
"ConfChamp","Sun","January 14","W","","14-4",TRUE,"Minnesota Vikings",41,0,31,518,380,138,2,9,114,60,54,5,2001-01-14,3,1,"nyg",41
"SuperBowl","Sun","January 28","L","","14-5",TRUE,"Baltimore Ravens",7,34,11,152,86,66,5,13,244,133,111,0,2001-01-28,-5,0,"nyg",-27
"1","Mon","September 10","L","","0-1",FALSE,"Denver Broncos",20,31,17,308,245,63,0,25,473,330,143,0,2001-09-10,0,0,"nyg",-11
"2","Sun","September 23","W","","1-1",FALSE,"Kansas City Chiefs",13,3,20,299,201,98,3,11,266,178,88,1,2001-09-23,-2,1,"nyg",10
"3","Sun","September 30","W","","2-1",TRUE,"New Orleans Saints",21,13,13,253,100,153,1,20,330,256,74,1,2001-09-30,0,1,"nyg",8
"4","Sun","October 7","W","","3-1",TRUE,"Washington Redskins",23,9,21,309,167,142,4,9,181,124,57,5,2001-10-07,1,1,"nyg",14
"5","Sun","October 14","L","","3-2",FALSE,"St. Louis Rams",14,15,16,324,227,97,2,19,315,274,41,4,2001-10-14,2,0,"nyg",-1
"6","Mon","October 22","L","","3-3",TRUE,"Philadelphia Eagles",9,10,16,238,142,96,1,13,215,124,91,1,2001-10-22,0,0,"nyg",-1
"7","Sun","October 28","L","","3-4",FALSE,"Washington Redskins",21,35,25,388,346,42,2,17,353,196,157,0,2001-10-28,-2,0,"nyg",-14
"8","Sun","November 4","W","OT","4-4",TRUE,"Dallas Cowboys",27,24,19,358,265,93,5,17,324,238,86,4,2001-11-04,-1,1,"nyg",3
"9","Sun","November 11","W","","5-4",FALSE,"Arizona Cardinals",17,10,20,334,148,186,1,12,213,135,78,3,2001-11-11,2,1,"nyg",7
"10","Mon","November 19","L","","5-5",FALSE,"Minnesota Vikings",16,28,18,358,297,61,2,24,359,263,96,3,2001-11-19,1,0,"nyg",-12
"11","Sun","November 25","L","","5-6",TRUE,"Oakland Raiders",10,28,18,313,160,153,0,15,339,220,119,0,2001-11-25,0,0,"nyg",-18
"13","Sun","December 9","L","","5-7",FALSE,"Dallas Cowboys",13,20,12,245,120,125,2,14,289,185,104,0,2001-12-09,-2,0,"nyg",-7
"14","Sat","December 15","W","","6-7",TRUE,"Arizona Cardinals",17,13,15,244,139,105,0,19,285,197,88,1,2001-12-15,1,1,"nyg",4
"15","Sun","December 23","W","","7-7",TRUE,"Seattle Seahawks",27,24,22,420,332,88,2,14,259,161,98,2,2001-12-23,0,1,"nyg",3
"16","Sun","December 30","L","","7-8",FALSE,"Philadelphia Eagles",21,24,18,420,291,129,1,21,361,241,120,2,2001-12-30,1,0,"nyg",-3
"17","Sun","January 6","L","","7-9",TRUE,"Green Bay Packers",25,34,25,524,378,146,3,18,413,308,105,1,2002-01-06,-2,0,"nyg",-9
"1","Thu","September 5","L","","0-1",TRUE,"San Francisco 49ers",13,16,21,361,318,43,3,13,279,166,113,1,2002-09-05,-2,0,"nyg",-3
"2","Sun","September 15","W","","1-1",FALSE,"St. Louis Rams",26,21,16,394,291,103,1,18,352,260,92,4,2002-09-15,3,1,"nyg",5
"3","Sun","September 22","W","","2-1",TRUE,"Seattle Seahawks",9,6,21,351,257,94,0,7,145,105,40,1,2002-09-22,1,1,"nyg",3
"4","Sun","September 29","L","","2-2",FALSE,"Arizona Cardinals",7,21,14,263,196,67,3,18,263,161,102,1,2002-09-29,-2,0,"nyg",-14
"5","Sun","October 6","W","","3-2",FALSE,"Dallas Cowboys",21,17,16,316,212,104,2,20,340,245,95,0,2002-10-06,-2,1,"nyg",4
"6","Sun","October 13","L","","3-3",TRUE,"Atlanta Falcons",10,17,18,303,190,113,2,15,313,246,67,0,2002-10-13,-2,0,"nyg",-7
"8","Mon","October 28","L","","3-4",FALSE,"Philadelphia Eagles",3,17,18,348,245,103,1,21,422,127,295,0,2002-10-28,-1,0,"nyg",-14
"9","Sun","November 3","W","","4-4",TRUE,"Jacksonville Jaguars",24,17,26,394,217,177,1,16,329,203,126,1,2002-11-03,0,1,"nyg",7
"10","Sun","November 10","W","","5-4",FALSE,"Minnesota Vikings",27,20,26,460,291,169,1,17,356,132,224,2,2002-11-10,1,1,"nyg",7
"11","Sun","November 17","W","","6-4",TRUE,"Washington Redskins",19,17,21,299,211,88,3,12,166,106,60,2,2002-11-17,-1,1,"nyg",2
"12","Sun","November 24","L","","6-5",FALSE,"Houston Texans",14,16,19,369,201,168,3,12,212,89,123,1,2002-11-24,-2,0,"nyg",-2
"13","Sun","December 1","L","OT","6-6",TRUE,"Tennessee Titans",29,32,24,345,283,62,0,31,476,334,142,1,2002-12-01,1,0,"nyg",-3
"14","Sun","December 8","W","","7-6",FALSE,"Washington Redskins",27,21,16,316,205,111,0,23,447,315,132,5,2002-12-08,5,1,"nyg",6
"15","Sun","December 15","W","","8-6",TRUE,"Dallas Cowboys",37,7,20,377,220,157,0,14,241,137,104,3,2002-12-15,3,1,"nyg",30
"16","Sun","December 22","W","","9-6",FALSE,"Indianapolis Colts",44,27,24,469,366,103,3,20,399,349,50,2,2002-12-22,-1,1,"nyg",17
"17","Sat","December 28","W","OT","10-6",TRUE,"Philadelphia Eagles",10,7,23,461,248,213,4,9,209,144,65,1,2002-12-28,-3,1,"nyg",3
"WildCard","Sun","January 5","L","","10-7",FALSE,"San Francisco 49ers",38,39,26,446,327,119,1,23,446,356,90,2,2003-01-05,1,0,"nyg",-1
"1","Sun","September 7","W","","1-0",TRUE,"St. Louis Rams",23,13,15,336,187,149,3,18,355,315,40,4,2003-09-07,1,1,"nyg",10
"2","Mon","September 15","L","OT","1-1",TRUE,"Dallas Cowboys",32,35,20,309,256,53,3,24,403,296,107,1,2003-09-15,-2,0,"nyg",-3
"3","Sun","September 21","W","OT","2-1",FALSE,"Washington Redskins",24,21,25,399,270,129,0,25,456,332,124,1,2003-09-21,1,1,"nyg",3
"5","Sun","October 5","L","","2-2",TRUE,"Miami Dolphins",10,23,25,350,273,77,4,15,285,151,134,1,2003-10-05,-3,0,"nyg",-13
"6","Sun","October 12","L","","2-3",FALSE,"New England Patriots",6,17,26,382,306,76,5,12,220,91,129,0,2003-10-12,-5,0,"nyg",-11
"7","Sun","October 19","L","","2-4",TRUE,"Philadelphia Eagles",10,14,25,339,159,180,2,9,134,47,87,2,2003-10-19,0,0,"nyg",-4
"8","Sun","October 26","W","","3-4",FALSE,"Minnesota Vikings",29,17,26,450,367,83,1,22,359,222,137,2,2003-10-26,1,1,"nyg",12
"9","Sun","November 2","W","OT","4-4",FALSE,"New York Jets",31,28,23,413,298,115,0,28,392,260,132,4,2003-11-02,4,1,"nyg",3
"10","Sun","November 9","L","","4-5",TRUE,"Atlanta Falcons",7,27,18,320,196,124,4,20,274,58,216,0,2003-11-09,-4,0,"nyg",-20
"11","Sun","November 16","L","","4-6",FALSE,"Philadelphia Eagles",10,28,20,361,252,109,1,20,376,314,62,1,2003-11-16,0,0,"nyg",-18
"12","Mon","November 24","L","","4-7",FALSE,"Tampa Bay Buccaneers",13,19,12,212,133,79,4,21,358,265,93,3,2003-11-24,-1,0,"nyg",-6
"13","Sun","November 30","L","","4-8",TRUE,"Buffalo Bills",7,24,10,222,198,24,1,23,403,252,151,0,2003-11-30,-1,0,"nyg",-17
"14","Sun","December 7","L","","4-9",TRUE,"Washington Redskins",7,20,15,220,100,120,3,20,288,138,150,0,2003-12-07,-3,0,"nyg",-13
"15","Sun","December 14","L","","4-10",FALSE,"New Orleans Saints",7,45,16,241,130,111,2,26,440,308,132,1,2003-12-14,-1,0,"nyg",-38
"16","Sun","December 21","L","","4-11",FALSE,"Dallas Cowboys",3,19,10,213,159,54,0,16,326,222,104,0,2003-12-21,0,0,"nyg",-16
"17","Sun","December 28","L","","4-12",TRUE,"Carolina Panthers",24,37,14,175,99,76,5,15,251,141,110,2,2003-12-28,-3,0,"nyg",-13
"1","Sun","September 12","L","","0-1",FALSE,"Philadelphia Eagles",17,31,19,413,243,170,1,21,454,313,141,0,2004-09-12,-1,0,"nyg",-14
"2","Sun","September 19","W","","1-1",TRUE,"Washington Redskins",20,14,15,277,215,62,1,20,322,214,108,7,2004-09-19,6,1,"nyg",6
"3","Sun","September 26","W","","2-1",TRUE,"Cleveland Browns",27,10,25,390,274,116,0,18,285,161,124,3,2004-09-26,3,1,"nyg",17
"4","Sun","October 3","W","","3-1",FALSE,"Green Bay Packers",14,7,21,403,158,245,1,15,301,220,81,3,2004-10-03,2,1,"nyg",7
"5","Sun","October 10","W","","4-1",FALSE,"Dallas Cowboys",26,10,19,336,211,125,1,16,278,112,166,2,2004-10-10,1,1,"nyg",16
"7","Sun","October 24","L","","4-2",TRUE,"Detroit Lions",13,28,22,325,250,75,2,22,325,210,115,0,2004-10-24,-2,0,"nyg",-15
"8","Sun","October 31","W","","5-2",FALSE,"Minnesota Vikings",34,13,22,283,115,168,0,15,324,231,93,3,2004-10-31,3,1,"nyg",21
"9","Sun","November 7","L","","5-3",TRUE,"Chicago Bears",21,28,15,258,167,91,5,13,231,109,122,2,2004-11-07,-3,0,"nyg",-7
"10","Sun","November 14","L","","5-4",FALSE,"Arizona Cardinals",14,17,19,308,161,147,0,18,178,74,104,0,2004-11-14,0,0,"nyg",-3
"11","Sun","November 21","L","","5-5",TRUE,"Atlanta Falcons",10,14,20,277,158,119,2,16,298,97,201,0,2004-11-21,-2,0,"nyg",-4
"12","Sun","November 28","L","","5-6",TRUE,"Philadelphia Eagles",6,27,12,272,111,161,2,22,390,238,152,1,2004-11-28,-1,0,"nyg",-21
"13","Sun","December 5","L","","5-7",FALSE,"Washington Redskins",7,31,7,145,107,38,0,27,379,168,211,0,2004-12-05,0,0,"nyg",-24
"14","Sun","December 12","L","","5-8",FALSE,"Baltimore Ravens",14,37,11,196,145,51,6,23,353,184,169,1,2004-12-12,-5,0,"nyg",-23
"15","Sat","December 18","L","","5-9",TRUE,"Pittsburgh Steelers",30,33,18,278,182,96,1,27,469,309,160,2,2004-12-18,1,0,"nyg",-3
"16","Sun","December 26","L","","5-10",FALSE,"Cincinnati Bengals",22,23,18,326,184,142,1,16,233,170,63,2,2004-12-26,1,0,"nyg",-1
"17","Sun","January 2","W","","6-10",TRUE,"Dallas Cowboys",28,24,18,235,137,98,1,21,367,220,147,2,2005-01-02,1,1,"nyg",4
"1","Sun","September 11","W","","1-0",TRUE,"Arizona Cardinals",42,19,14,275,154,121,2,20,318,287,31,2,2005-09-11,0,1,"nyg",23
"2","Mon","September 19","W","","2-0",FALSE,"New Orleans Saints",27,10,15,257,165,92,1,23,422,350,72,6,2005-09-19,5,1,"nyg",17
"3","Sun","September 25","L","","2-1",FALSE,"San Diego Chargers",23,45,23,424,338,86,1,25,485,217,268,1,2005-09-25,0,0,"nyg",-22
"4","Sun","October 2","W","","3-1",TRUE,"St. Louis Rams",44,24,24,456,292,164,0,27,476,434,42,5,2005-10-02,5,1,"nyg",20
"6","Sun","October 16","L","OT","3-2",FALSE,"Dallas Cowboys",13,16,11,270,179,91,4,25,385,293,92,4,2005-10-16,0,0,"nyg",-3
"7","Sun","October 23","W","","4-2",TRUE,"Denver Broncos",24,23,22,311,214,97,2,20,385,194,191,1,2005-10-23,-1,1,"nyg",1
"8","Sun","October 30","W","","5-2",TRUE,"Washington Redskins",36,0,19,386,124,262,1,7,125,87,38,4,2005-10-30,3,1,"nyg",36
"9","Sun","November 6","W","","6-2",FALSE,"San Francisco 49ers",24,6,19,344,251,93,0,9,138,86,52,1,2005-11-06,1,1,"nyg",18
"10","Sun","November 13","L","","6-3",TRUE,"Minnesota Vikings",21,24,25,405,281,124,5,11,137,125,12,1,2005-11-13,-4,0,"nyg",-3
"11","Sun","November 20","W","","7-3",TRUE,"Philadelphia Eagles",27,17,17,315,200,115,0,20,404,298,106,1,2005-11-20,1,1,"nyg",10
"12","Sun","November 27","L","OT","7-4",FALSE,"Seattle Seahawks",21,24,25,490,324,166,1,17,355,228,127,2,2005-11-27,1,0,"nyg",-3
"13","Sun","December 4","W","","8-4",TRUE,"Dallas Cowboys",17,10,17,277,150,127,2,16,206,125,81,4,2005-12-04,2,1,"nyg",7
"14","Sun","December 11","W","OT","9-4",FALSE,"Philadelphia Eagles",26,23,28,437,299,138,3,17,337,162,175,1,2005-12-11,-2,1,"nyg",3
"15","Sat","December 17","W","","10-4",TRUE,"Kansas City Chiefs",27,17,22,406,183,223,2,22,362,174,188,3,2005-12-17,1,1,"nyg",10
"16","Sat","December 24","L","","10-5",FALSE,"Washington Redskins",20,35,18,332,233,99,1,22,380,224,156,1,2005-12-24,0,0,"nyg",-15
"17","Sat","December 31","W","","11-5",FALSE,"Oakland Raiders",30,21,13,402,191,211,0,21,325,300,25,0,2005-12-31,0,1,"nyg",9
"WildCard","Sun","January 8","L","","11-6",TRUE,"Carolina Panthers",0,23,9,132,91,41,5,23,335,112,223,0,2006-01-08,-5,0,"nyg",-23
"1","Sun","September 10","L","","0-1",TRUE,"Indianapolis Colts",21,26,23,433,247,186,2,22,327,272,55,1,2006-09-10,-1,0,"nyg",-5
"2","Sun","September 17","W","OT","1-1",FALSE,"Philadelphia Eagles",30,24,24,404,318,86,1,23,451,344,107,1,2006-09-17,0,1,"nyg",6
"3","Sun","September 24","L","","1-2",FALSE,"Seattle Seahawks",30,42,18,337,264,73,4,26,333,227,106,3,2006-09-24,-1,0,"nyg",-12
"5","Sun","October 8","W","","2-2",TRUE,"Washington Redskins",19,3,20,411,256,155,0,10,164,86,78,0,2006-10-08,0,1,"nyg",16
"6","Sun","October 15","W","","3-2",FALSE,"Atlanta Falcons",27,14,28,424,165,259,2,16,329,106,223,2,2006-10-15,0,1,"nyg",13
"7","Mon","October 23","W","","4-2",FALSE,"Dallas Cowboys",36,22,18,328,173,155,2,21,379,310,69,4,2006-10-23,2,1,"nyg",14
"8","Sun","October 29","W","","5-2",TRUE,"Tampa Bay Buccaneers",17,3,16,251,143,108,0,10,174,134,40,1,2006-10-29,1,1,"nyg",14
"9","Sun","November 5","W","","6-2",TRUE,"Houston Texans",14,10,23,285,163,122,1,17,251,170,81,1,2006-11-05,0,1,"nyg",4
"10","Sun","November 12","L","","6-3",TRUE,"Chicago Bears",20,38,15,249,99,150,3,21,352,234,118,3,2006-11-12,0,0,"nyg",-18
"11","Mon","November 20","L","","6-4",FALSE,"Jacksonville Jaguars",10,26,13,247,222,25,3,21,414,249,165,1,2006-11-20,-2,0,"nyg",-16
"12","Sun","November 26","L","","6-5",FALSE,"Tennessee Titans",21,24,18,287,143,144,2,20,343,235,108,2,2006-11-26,0,0,"nyg",-3
"13","Sun","December 3","L","","6-6",TRUE,"Dallas Cowboys",20,23,22,396,270,126,1,21,365,255,110,2,2006-12-03,1,0,"nyg",-3
"14","Sun","December 10","W","","7-6",FALSE,"Carolina Panthers",27,13,15,307,172,135,0,22,463,418,45,3,2006-12-10,3,1,"nyg",14
"15","Sun","December 17","L","","7-7",TRUE,"Philadelphia Eagles",22,36,22,358,270,88,4,21,382,221,161,2,2006-12-17,-2,0,"nyg",-14
"16","Sun","December 24","L","","7-8",TRUE,"New Orleans Saints",7,30,6,142,59,83,3,22,359,123,236,0,2006-12-24,-3,0,"nyg",-23
"17","Sat","December 30","W","","8-8",FALSE,"Washington Redskins",34,28,23,355,94,261,0,21,393,265,128,2,2006-12-30,2,1,"nyg",6
"WildCard","Sun","January 7","L","","8-9",FALSE,"Philadelphia Eagles",20,23,17,305,154,151,1,19,323,138,185,0,2007-01-07,-1,0,"nyg",-3
"1","Sun","September 9","L","","0-1",FALSE,"Dallas Cowboys",35,45,22,438,314,124,1,21,478,336,142,2,2007-09-09,1,0,"nyg",-10
"2","Sun","September 16","L","","0-2",TRUE,"Green Bay Packers",13,35,20,325,231,94,2,25,368,285,83,1,2007-09-16,-1,0,"nyg",-22
"3","Sun","September 23","W","","1-2",FALSE,"Washington Redskins",24,17,19,315,219,96,3,14,260,178,82,1,2007-09-23,-2,1,"nyg",7
"4","Sun","September 30","W","","2-2",TRUE,"Philadelphia Eagles",16,3,16,212,129,83,1,16,190,76,114,1,2007-09-30,0,1,"nyg",13
"5","Sun","October 7","W","","3-2",TRUE,"New York Jets",35,24,21,374,186,188,2,16,277,222,55,3,2007-10-07,1,1,"nyg",11
"6","Mon","October 15","W","","4-2",FALSE,"Atlanta Falcons",31,10,28,491,303,188,3,14,284,181,103,1,2007-10-15,-2,1,"nyg",21
"7","Sun","October 21","W","","5-2",TRUE,"San Francisco 49ers",33,15,21,279,139,140,1,20,267,164,103,4,2007-10-21,3,1,"nyg",18
"8","Sun","October 28","W","","6-2",FALSE,"Miami Dolphins",13,10,19,238,49,189,1,18,245,119,126,2,2007-10-28,1,1,"nyg",3
"10","Sun","November 11","L","","6-3",TRUE,"Dallas Cowboys",20,31,23,300,194,106,2,19,323,243,80,1,2007-11-11,-1,0,"nyg",-11
"11","Sun","November 18","W","","7-3",FALSE,"Detroit Lions",16,10,19,341,269,72,2,17,376,351,25,4,2007-11-18,2,1,"nyg",6
"12","Sun","November 25","L","","7-4",TRUE,"Minnesota Vikings",17,41,18,309,234,75,4,15,251,124,127,0,2007-11-25,-4,0,"nyg",-24
"13","Sun","December 2","W","","8-4",FALSE,"Chicago Bears",21,16,24,356,181,175,4,18,312,244,68,0,2007-12-02,-4,1,"nyg",5
"14","Sun","December 9","W","","9-4",FALSE,"Philadelphia Eagles",16,13,15,318,207,111,2,18,306,165,141,1,2007-12-09,-1,1,"nyg",3
"15","Sun","December 16","L","","9-5",TRUE,"Washington Redskins",10,22,20,307,168,139,1,14,309,156,153,0,2007-12-16,-1,0,"nyg",-12
"16","Sun","December 23","W","","10-5",FALSE,"Buffalo Bills",38,21,17,383,94,289,4,16,244,127,117,4,2007-12-23,0,1,"nyg",17
"17","Sat","December 29","L","","10-6",TRUE,"New England Patriots",35,38,19,316,237,79,1,27,390,346,44,0,2007-12-29,-1,0,"nyg",-3
"WildCard","Sun","January 6","W","","11-6",FALSE,"Tampa Bay Buccaneers",24,14,16,277,177,100,0,20,271,202,69,3,2008-01-06,3,1,"nyg",10
"Division","Sun","January 13","W","","12-6",FALSE,"Dallas Cowboys",21,17,16,230,140,90,0,23,336,182,154,1,2008-01-13,1,1,"nyg",4
"ConfChamp","Sun","January 20","W","OT","13-6",FALSE,"Green Bay Packers",23,20,24,377,243,134,1,13,264,236,28,2,2008-01-20,1,1,"nyg",3
"SuperBowl","Sun","February 3","W","","14-6",TRUE,"New England Patriots",17,14,17,338,247,91,1,22,274,229,45,1,2008-02-03,0,1,"nyg",3
"1","Thu","September 4","W","","1-0",TRUE,"Washington Redskins",16,7,21,354,200,154,1,11,209,125,84,0,2008-09-04,-1,1,"nyg",9
"2","Sun","September 14","W","","2-0",FALSE,"St. Louis Rams",41,13,25,441,241,200,0,13,201,133,68,1,2008-09-14,1,1,"nyg",28
"3","Sun","September 21","W","OT","3-0",TRUE,"Cincinnati Bengals",26,23,24,406,289,117,0,24,347,245,102,0,2008-09-21,0,1,"nyg",3
"5","Sun","October 5","W","","4-0",TRUE,"Seattle Seahawks",44,6,27,523,269,254,0,13,187,113,74,1,2008-10-05,1,1,"nyg",38
"6","Mon","October 13","L","","4-1",FALSE,"Cleveland Browns",14,35,23,373,192,181,3,20,454,310,144,0,2008-10-13,-3,0,"nyg",-21
"7","Sun","October 19","W","","5-1",TRUE,"San Francisco 49ers",29,17,17,273,161,112,0,13,253,218,35,3,2008-10-19,3,1,"nyg",12
"8","Sun","October 26","W","","6-1",FALSE,"Pittsburgh Steelers",21,14,14,282,199,83,0,12,249,154,95,4,2008-10-26,4,1,"nyg",7
"9","Sun","November 2","W","","7-1",TRUE,"Dallas Cowboys",35,14,23,319,119,200,3,11,183,102,81,4,2008-11-02,1,1,"nyg",21
"10","Sun","November 9","W","","8-1",FALSE,"Philadelphia Eagles",36,31,26,401,182,219,2,17,300,194,106,2,2008-11-09,0,1,"nyg",5
"11","Sun","November 16","W","","9-1",TRUE,"Baltimore Ravens",30,10,22,353,146,207,1,18,275,154,121,2,2008-11-16,1,1,"nyg",20
"12","Sun","November 23","W","","10-1",FALSE,"Arizona Cardinals",37,29,18,321,234,87,0,27,371,348,23,2,2008-11-23,2,1,"nyg",8
"13","Sun","November 30","W","","11-1",FALSE,"Washington Redskins",23,7,23,404,296,108,1,17,320,228,92,2,2008-11-30,1,1,"nyg",16
"14","Sun","December 7","L","","11-2",TRUE,"Philadelphia Eagles",14,20,14,211,123,88,0,24,331,191,140,0,2008-12-07,0,0,"nyg",-6
"15","Sun","December 14","L","","11-3",FALSE,"Dallas Cowboys",8,20,17,218,146,72,2,17,321,221,100,0,2008-12-14,-2,0,"nyg",-12
"16","Sun","December 21","W","OT","12-3",TRUE,"Carolina Panthers",34,28,25,459,158,301,0,16,343,185,158,0,2008-12-21,0,1,"nyg",6
"17","Sun","December 28","L","","12-4",FALSE,"Minnesota Vikings",19,20,19,357,222,135,0,15,328,218,110,1,2008-12-28,1,0,"nyg",-1
"Division","Sun","January 11","L","","12-5",TRUE,"Philadelphia Eagles",11,23,16,307,169,138,3,20,276,217,59,2,2009-01-11,-1,0,"nyg",-12
"1","Sun","September 13","W","","1-0",TRUE,"Washington Redskins",23,17,18,351,248,103,2,15,272,187,85,2,2009-09-13,0,1,"nyg",6
"2","Sun","September 20","W","","2-0",FALSE,"Dallas Cowboys",33,31,19,427,330,97,0,23,378,127,251,4,2009-09-20,4,1,"nyg",2
"3","Sun","September 27","W","","3-0",FALSE,"Tampa Bay Buccaneers",24,0,27,397,171,226,0,5,86,58,28,1,2009-09-27,1,1,"nyg",24
"4","Sun","October 4","W","","4-0",FALSE,"Kansas City Chiefs",27,16,21,429,273,156,2,15,212,88,124,1,2009-10-04,-1,1,"nyg",11
"5","Sun","October 11","W","","5-0",TRUE,"Oakland Raiders",44,7,27,483,263,220,1,7,124,64,60,3,2009-10-11,2,1,"nyg",37
"6","Sun","October 18","L","","5-1",FALSE,"New Orleans Saints",27,48,17,325,241,84,2,28,493,369,124,0,2009-10-18,-2,0,"nyg",-21
"7","Sun","October 25","L","","5-2",TRUE,"Arizona Cardinals",17,24,15,327,220,107,4,15,288,216,72,2,2009-10-25,-2,0,"nyg",-7
"8","Sun","November 1","L","","5-3",FALSE,"Philadelphia Eagles",17,40,21,356,215,141,3,17,391,211,180,2,2009-11-01,-1,0,"nyg",-23
"9","Sun","November 8","L","","5-4",TRUE,"San Diego Chargers",20,21,19,304,188,116,1,18,226,192,34,2,2009-11-08,1,0,"nyg",-1
"11","Sun","November 22","W","OT","6-4",TRUE,"Atlanta Falcons",34,31,26,456,368,88,1,27,352,262,90,1,2009-11-22,0,1,"nyg",3
"12","Thu","November 26","L","","6-5",FALSE,"Denver Broncos",6,26,15,267,210,57,3,23,373,235,138,1,2009-11-26,-2,0,"nyg",-20
"13","Sun","December 6","W","","7-5",TRUE,"Dallas Cowboys",31,24,15,337,237,100,2,27,424,379,45,1,2009-12-06,-1,1,"nyg",7
"14","Sun","December 13","L","","7-6",TRUE,"Philadelphia Eagles",38,45,27,512,379,133,4,20,374,297,77,1,2009-12-13,-3,0,"nyg",-7
"15","Mon","December 21","W","","8-6",FALSE,"Washington Redskins",45,12,23,387,273,114,0,15,302,213,89,3,2009-12-21,3,1,"nyg",33
"16","Sun","December 27","L","","8-7",TRUE,"Carolina Panthers",9,41,22,317,257,60,4,25,416,169,247,0,2009-12-27,-4,0,"nyg",-32
"17","Sun","January 3","L","","8-8",FALSE,"Minnesota Vikings",7,44,11,181,146,35,2,28,487,358,129,0,2010-01-03,-2,0,"nyg",-37
"1","Sun","September 12","W","","1-0",TRUE,"Carolina Panthers",31,18,21,376,258,118,4,14,237,148,89,5,2010-09-12,1,1,"nyg",13
"2","Sun","September 19","L","","1-1",FALSE,"Indianapolis Colts",14,38,13,257,137,120,3,24,410,250,160,1,2010-09-19,-2,0,"nyg",-24
"3","Sun","September 26","L","","1-2",TRUE,"Tennessee Titans",10,29,26,471,364,107,3,17,271,110,161,0,2010-09-26,-3,0,"nyg",-19
"4","Sun","October 3","W","","2-2",TRUE,"Chicago Bears",17,3,18,372,183,189,3,6,110,51,59,3,2010-10-03,0,1,"nyg",14
"5","Sun","October 10","W","","3-2",FALSE,"Houston Texans",34,10,26,414,297,117,2,11,195,171,24,2,2010-10-10,0,1,"nyg",24
"6","Sun","October 17","W","","4-2",TRUE,"Detroit Lions",28,20,24,334,167,167,1,16,366,302,64,3,2010-10-17,2,1,"nyg",8
"7","Mon","October 25","W","","5-2",FALSE,"Dallas Cowboys",41,35,25,497,297,200,5,14,254,213,41,2,2010-10-25,-3,1,"nyg",6
"9","Sun","November 7","W","","6-2",FALSE,"Seattle Seahawks",41,7,30,487,290,197,1,8,162,113,49,3,2010-11-07,2,1,"nyg",34
"10","Sun","November 14","L","","6-3",TRUE,"Dallas Cowboys",20,33,25,480,373,107,3,15,427,327,100,1,2010-11-14,-2,0,"nyg",-13
"11","Sun","November 21","L","","6-4",FALSE,"Philadelphia Eagles",17,27,13,208,147,61,5,17,392,244,148,2,2010-11-21,-3,0,"nyg",-10
"12","Sun","November 28","W","","7-4",TRUE,"Jacksonville Jaguars",24,20,17,361,226,135,0,26,328,121,207,2,2010-11-28,2,1,"nyg",4
"13","Sun","December 5","W","","8-4",TRUE,"Washington Redskins",31,7,22,358,161,197,1,19,338,264,74,6,2010-12-05,5,1,"nyg",24
"14","Mon","December 13","W","","9-4",FALSE,"Minnesota Vikings",21,3,21,395,182,213,2,10,164,103,61,1,2010-12-13,-1,1,"nyg",18
"15","Sun","December 19","L","","9-5",TRUE,"Philadelphia Eagles",31,38,20,364,264,100,2,19,418,221,197,3,2010-12-19,1,0,"nyg",-7
"16","Sun","December 26","L","","9-6",FALSE,"Green Bay Packers",17,45,16,386,296,90,6,27,515,396,119,1,2010-12-26,-5,0,"nyg",-28
"17","Sun","January 2","W","","10-6",FALSE,"Washington Redskins",17,14,14,325,243,82,1,20,403,336,67,4,2011-01-02,3,1,"nyg",3
"1","Sun","September 11","L","","0-1",FALSE,"Washington Redskins",14,28,15,315,240,75,1,21,332,258,74,1,2011-09-11,0,0,"nyg",-14
"2","Mon","September 19","W","","1-1",TRUE,"St. Louis Rams",28,16,22,323,204,119,1,14,367,308,59,2,2011-09-19,1,1,"nyg",12
"3","Sun","September 25","W","","2-1",FALSE,"Philadelphia Eagles",29,16,14,334,232,102,0,25,376,199,177,3,2011-09-25,3,1,"nyg",13
"4","Sun","October 2","W","","3-1",FALSE,"Arizona Cardinals",31,27,24,360,306,54,2,22,368,212,156,2,2011-10-02,0,1,"nyg",4
"5","Sun","October 9","L","","3-2",TRUE,"Seattle Seahawks",25,36,21,464,395,69,5,26,424,279,145,3,2011-10-09,-2,0,"nyg",-11
"6","Sun","October 16","W","","4-2",TRUE,"Buffalo Bills",27,24,24,414,292,122,0,17,374,219,155,2,2011-10-16,2,1,"nyg",3
"8","Sun","October 30","W","","5-2",TRUE,"Miami Dolphins",20,17,21,402,344,58,0,18,246,101,145,1,2011-10-30,1,1,"nyg",3
"9","Sun","November 6","W","","6-2",FALSE,"New England Patriots",24,20,23,361,250,111,2,23,438,332,106,4,2011-11-06,2,1,"nyg",4
"10","Sun","November 13","L","","6-3",FALSE,"San Francisco 49ers",20,27,21,395,302,93,2,16,305,228,77,1,2011-11-13,-1,0,"nyg",-7
"11","Sun","November 20","L","","6-4",TRUE,"Philadelphia Eagles",10,17,12,278,249,29,2,17,391,255,136,3,2011-11-20,1,0,"nyg",-7
"12","Mon","November 28","L","","6-5",FALSE,"New Orleans Saints",24,49,29,465,392,73,2,31,577,372,205,0,2011-11-28,-2,0,"nyg",-25
"13","Sun","December 4","L","","6-6",TRUE,"Green Bay Packers",35,38,24,447,347,100,2,29,449,360,89,1,2011-12-04,-1,0,"nyg",-3
"14","Sun","December 11","W","","7-6",FALSE,"Dallas Cowboys",37,34,28,510,400,110,1,23,444,305,139,1,2011-12-11,0,1,"nyg",3
"15","Sun","December 18","L","","7-7",TRUE,"Washington Redskins",10,23,22,324,233,91,3,19,300,177,123,2,2011-12-18,-1,0,"nyg",-13
"16","Sat","December 24","W","","8-7",FALSE,"New York Jets",29,14,11,332,217,115,1,22,331,226,105,3,2011-12-24,2,1,"nyg",15
"17","Sun","January 1","W","","9-7",TRUE,"Dallas Cowboys",31,14,20,437,331,106,0,19,300,251,49,2,2012-01-01,2,1,"nyg",17
"WildCard","Sun","January 8","W","","10-7",TRUE,"Atlanta Falcons",24,2,19,442,270,172,0,14,247,183,64,0,2012-01-08,0,1,"nyg",22
"Division","Sun","January 15","W","","11-7",FALSE,"Green Bay Packers",37,20,19,420,325,95,1,25,388,241,147,4,2012-01-15,3,1,"nyg",17
"ConfChamp","Sun","January 22","W","OT","12-7",FALSE,"San Francisco 49ers",20,17,20,352,267,85,0,15,328,178,150,2,2012-01-22,2,1,"nyg",3
"SuperBowl","Sun","February 5","W","","13-7",TRUE,"New England Patriots",21,17,26,396,282,114,0,21,349,266,83,1,2012-02-05,1,1,"nyg",4
"1","Mon","September 9","L","","0-1",FALSE,"Dallas Cowboys",14,44,24,369,249,120,7,19,319,206,113,1,1985-09-09,-6,0,"was",-30
"2","Sun","September 15","W","","1-1",TRUE,"Houston Oilers",16,13,20,333,93,240,3,11,188,107,81,0,1985-09-15,-3,1,"was",3
"3","Sun","September 22","L","","1-2",TRUE,"Philadelphia Eagles",6,19,15,257,117,140,2,15,327,152,175,1,1985-09-22,-1,0,"was",-13
"4","Sun","September 29","L","","1-3",FALSE,"Chicago Bears",10,45,19,376,184,192,3,16,250,159,91,1,1985-09-29,-2,0,"was",-35
"5","Mon","October 7","W","","2-3",TRUE,"St. Louis Cardinals",27,10,17,305,67,238,2,17,310,215,95,6,1985-10-07,4,1,"was",17
"6","Sun","October 13","W","","3-3",TRUE,"Detroit Lions",24,3,23,291,123,168,0,8,226,198,28,4,1985-10-13,4,1,"was",21
"7","Sun","October 20","L","","3-4",FALSE,"New York Giants",3,17,16,276,207,69,3,21,329,185,144,3,1985-10-20,0,0,"was",-14
"8","Sun","October 27","W","","4-4",FALSE,"Cleveland Browns",14,7,19,284,142,142,1,17,264,167,97,4,1985-10-27,3,1,"was",7
"9","Sun","November 3","W","","5-4",FALSE,"Atlanta Falcons",44,10,24,461,154,307,0,14,298,129,169,1,1985-11-03,1,1,"was",34
"10","Sun","November 10","L","","5-5",TRUE,"Dallas Cowboys",7,13,15,267,143,124,3,14,338,219,119,0,1985-11-10,-3,0,"was",-6
"11","Mon","November 18","W","","6-5",TRUE,"New York Giants",23,21,22,356,258,98,3,12,253,101,152,1,1985-11-18,-2,1,"was",2
"12","Sun","November 24","W","","7-5",FALSE,"Pittsburgh Steelers",30,23,16,259,176,83,1,20,308,206,102,3,1985-11-24,2,1,"was",7
"13","Sun","December 1","L","","7-6",TRUE,"San Francisco 49ers",8,35,21,398,311,87,5,15,224,117,107,1,1985-12-01,-4,0,"was",-27
"14","Sun","December 8","W","","8-6",FALSE,"Philadelphia Eagles",17,12,19,310,144,166,1,14,202,165,37,3,1985-12-08,2,1,"was",5
"15","Sun","December 15","W","","9-6",TRUE,"Cincinnati Bengals",27,24,21,383,255,128,4,18,399,330,69,3,1985-12-15,-1,1,"was",3
"16","Sat","December 21","W","","10-6",FALSE,"St. Louis Cardinals",27,16,28,413,192,221,2,13,245,90,155,2,1985-12-21,0,1,"was",11
"1","Sun","September 7","W","","1-0",TRUE,"Philadelphia Eagles",41,14,21,433,274,159,1,16,267,201,66,2,1986-09-07,1,1,"was",27
"2","Sun","September 14","W","","2-0",TRUE,"Los Angeles Raiders",10,6,14,271,175,96,2,18,266,128,138,3,1986-09-14,1,1,"was",4
"3","Sun","September 21","W","","3-0",FALSE,"San Diego Chargers",30,27,19,425,333,92,1,26,351,204,147,3,1986-09-21,2,1,"was",3
"4","Sun","September 28","W","","4-0",TRUE,"Seattle Seahawks",19,14,20,357,195,162,1,17,361,213,148,2,1986-09-28,1,1,"was",5
"5","Sun","October 5","W","","5-0",FALSE,"New Orleans Saints",14,6,22,299,169,130,0,18,237,129,108,1,1986-10-05,1,1,"was",8
"6","Sun","October 12","L","","5-1",FALSE,"Dallas Cowboys",6,30,14,184,113,71,3,25,424,318,106,2,1986-10-12,-1,0,"was",-24
"7","Sun","October 19","W","","6-1",TRUE,"St. Louis Cardinals",28,21,21,354,232,122,3,20,242,124,118,1,1986-10-19,-2,1,"was",7
"8","Mon","October 27","L","","6-2",FALSE,"New York Giants",20,27,17,410,378,32,2,24,397,195,202,0,1986-10-27,-2,0,"was",-7
"9","Sun","November 2","W","OT","7-2",TRUE,"Minnesota Vikings",44,38,20,487,378,109,1,21,526,471,55,3,1986-11-02,2,1,"was",6
"10","Sun","November 9","W","","8-2",FALSE,"Green Bay Packers",16,7,17,254,167,87,1,18,281,141,140,2,1986-11-09,1,1,"was",9
"11","Mon","November 17","W","","9-2",TRUE,"San Francisco 49ers",14,6,20,266,130,136,2,24,501,418,83,4,1986-11-17,2,1,"was",8
"12","Sun","November 23","W","","10-2",TRUE,"Dallas Cowboys",41,14,23,483,316,167,1,16,251,197,54,3,1986-11-23,2,1,"was",27
"13","Sun","November 30","W","","11-2",FALSE,"St. Louis Cardinals",20,17,23,353,256,97,1,13,271,123,148,0,1986-11-30,-1,1,"was",3
"14","Sun","December 7","L","","11-3",TRUE,"New York Giants",14,24,22,349,276,73,7,17,333,259,74,2,1986-12-07,-5,0,"was",-10
"15","Sat","December 13","L","","11-4",FALSE,"Denver Broncos",30,31,19,412,285,127,2,23,330,259,71,0,1986-12-13,-2,0,"was",-1
"16","Sun","December 21","W","","12-4",FALSE,"Philadelphia Eagles",21,14,20,264,192,72,4,20,259,112,147,0,1986-12-21,-4,1,"was",7
"WildCard","Sun","December 28","W","","13-4",TRUE,"Los Angeles Rams",19,7,15,228,90,138,0,16,324,126,198,6,1986-12-28,6,1,"was",12
"Division","Sat","January 3","W","","14-4",FALSE,"Chicago Bears",27,13,19,302,168,134,1,14,220,127,93,4,1987-01-03,3,1,"was",14
"ConfChamp","Sun","January 11","L","","14-5",FALSE,"New York Giants",0,17,12,190,150,40,2,12,199,82,117,3,1987-01-11,1,0,"was",-17
"1","Sun","September 13","W","","1-0",TRUE,"Philadelphia Eagles",34,24,19,374,264,110,2,24,351,239,112,4,1987-09-13,2,1,"was",10
"2","Sun","September 20","L","","1-1",FALSE,"Atlanta Falcons",20,21,21,335,190,145,3,18,394,269,125,1,1987-09-20,-2,0,"was",-1
"3","Sun","October 4","W","","2-1",TRUE,"St. Louis Cardinals",28,21,18,452,334,118,1,27,398,231,167,0,1987-10-04,-1,1,"was",7
"4","Sun","October 11","W","","3-1",FALSE,"New York Giants",38,12,24,376,176,200,2,13,171,124,47,3,1987-10-11,1,1,"was",26
"5","Mon","October 19","W","","4-1",FALSE,"Dallas Cowboys",13,7,19,339,153,186,3,18,316,223,93,3,1987-10-19,0,1,"was",6
"6","Sun","October 25","W","","5-1",TRUE,"New York Jets",17,16,16,378,275,103,2,14,200,126,74,1,1987-10-25,-1,1,"was",1
"7","Sun","November 1","W","","6-1",FALSE,"Buffalo Bills",27,7,24,406,107,299,1,14,280,259,21,4,1987-11-01,3,1,"was",20
"8","Sun","November 8","L","","6-2",FALSE,"Philadelphia Eagles",27,31,23,360,231,129,4,23,427,232,195,4,1987-11-08,0,0,"was",-4
"9","Sun","November 15","W","","7-2",TRUE,"Detroit Lions",20,13,18,309,174,135,2,23,341,238,103,4,1987-11-15,2,1,"was",7
"10","Mon","November 23","L","","7-3",TRUE,"Los Angeles Rams",26,30,20,343,277,66,2,14,234,96,138,1,1987-11-23,-1,0,"was",-4
"11","Sun","November 29","W","","8-3",TRUE,"New York Giants",23,19,20,357,275,82,4,16,319,200,119,1,1987-11-29,-3,1,"was",4
"12","Sun","December 6","W","","9-3",FALSE,"St. Louis Cardinals",34,17,18,411,231,180,3,21,323,195,128,2,1987-12-06,-1,1,"was",17
"13","Sun","December 13","W","","10-3",TRUE,"Dallas Cowboys",24,20,15,317,249,68,2,25,428,341,87,2,1987-12-13,0,1,"was",4
"14","Sun","December 20","L","","10-4",FALSE,"Miami Dolphins",21,23,28,472,268,204,2,22,459,393,66,1,1987-12-20,-1,0,"was",-2
"15","Sat","December 26","W","OT","11-4",FALSE,"Minnesota Vikings",27,24,18,368,291,77,4,24,381,177,204,3,1987-12-26,-1,1,"was",3
"Division","Sun","January 10","W","","12-4",FALSE,"Chicago Bears",21,17,17,272,200,72,2,15,280,170,110,3,1988-01-10,1,1,"was",4
"ConfChamp","Sun","January 17","W","","13-4",TRUE,"Minnesota Vikings",17,10,11,280,119,161,0,16,259,183,76,1,1988-01-17,1,1,"was",7
"SuperBowl","Sun","January 31","W","","14-4",TRUE,"Denver Broncos",42,10,25,602,322,280,1,18,327,230,97,3,1988-01-31,2,1,"was",32
"1","Mon","September 5","L","","0-1",FALSE,"New York Giants",20,27,20,386,269,117,2,16,218,162,56,1,1988-09-05,-1,0,"was",-7
"2","Sun","September 11","W","","1-1",TRUE,"Pittsburgh Steelers",30,29,25,515,422,93,3,14,341,258,83,1,1988-09-11,-2,1,"was",1
"3","Sun","September 18","W","","2-1",TRUE,"Philadelphia Eagles",17,10,16,285,135,150,2,13,299,209,90,0,1988-09-18,-2,1,"was",7
"4","Sun","September 25","L","","2-2",FALSE,"Phoenix Cardinals",21,30,20,335,282,53,2,18,323,138,185,1,1988-09-25,-1,0,"was",-9
"5","Sun","October 2","L","","2-3",TRUE,"New York Giants",23,24,19,344,251,93,3,20,264,190,74,1,1988-10-02,-2,0,"was",-1
"6","Sun","October 9","W","","3-3",FALSE,"Dallas Cowboys",35,17,19,350,170,180,1,18,361,301,60,5,1988-10-09,4,1,"was",18
"7","Sun","October 16","W","","4-3",TRUE,"Phoenix Cardinals",33,17,16,386,289,97,1,23,381,305,76,2,1988-10-16,1,1,"was",16
"8","Sun","October 23","W","","5-3",FALSE,"Green Bay Packers",20,17,22,385,225,160,3,10,205,123,82,0,1988-10-23,-3,1,"was",3
"9","Sun","October 30","L","","5-4",FALSE,"Houston Oilers",17,41,16,250,221,29,6,21,336,184,152,2,1988-10-30,-4,0,"was",-24
"10","Sun","November 6","W","","6-4",TRUE,"New Orleans Saints",27,24,21,412,299,113,1,20,322,272,50,0,1988-11-06,-1,1,"was",3
"11","Sun","November 13","L","","6-5",TRUE,"Chicago Bears",14,34,22,323,295,28,5,20,418,273,145,1,1988-11-13,-4,0,"was",-20
"12","Mon","November 21","L","","6-6",FALSE,"San Francisco 49ers",21,37,20,327,271,56,4,18,320,208,112,2,1988-11-21,-2,0,"was",-16
"13","Sun","November 27","L","","6-7",TRUE,"Cleveland Browns",13,17,11,227,124,103,2,25,324,166,158,1,1988-11-27,-1,0,"was",-4
"14","Sun","December 4","W","","7-7",FALSE,"Philadelphia Eagles",20,19,22,410,329,81,4,21,310,147,163,3,1988-12-04,-1,1,"was",1
"15","Sun","December 11","L","","7-8",TRUE,"Dallas Cowboys",17,24,15,372,348,24,5,21,444,320,124,2,1988-12-11,-3,0,"was",-7
"16","Sat","December 17","L","OT","7-9",FALSE,"Cincinnati Bengals",17,20,23,372,206,166,2,16,318,183,135,0,1988-12-17,-2,0,"was",-3
"1","Mon","September 11","L","","0-1",TRUE,"New York Giants",24,27,19,457,345,112,3,19,390,231,159,3,1989-09-11,0,0,"was",-3
"2","Sun","September 17","L","","0-2",TRUE,"Philadelphia Eagles",37,42,16,492,272,220,6,32,474,409,65,3,1989-09-17,-3,0,"was",-5
"3","Sun","September 24","W","","1-2",FALSE,"Dallas Cowboys",30,7,20,373,208,165,1,10,190,156,34,4,1989-09-24,3,1,"was",23
"4","Sun","October 1","W","","2-2",FALSE,"New Orleans Saints",16,14,13,308,216,92,1,20,381,245,136,4,1989-10-01,3,1,"was",2
"5","Sun","October 8","W","","3-2",TRUE,"Phoenix Cardinals",30,28,28,508,333,175,1,19,381,291,90,4,1989-10-08,3,1,"was",2
"6","Sun","October 15","L","","3-3",FALSE,"New York Giants",17,20,18,316,194,122,2,19,306,173,133,1,1989-10-15,-1,0,"was",-3
"7","Sun","October 22","W","","4-3",TRUE,"Tampa Bay Buccaneers",32,28,24,388,209,179,2,13,297,296,1,2,1989-10-22,0,1,"was",4
"8","Sun","October 29","L","","4-4",FALSE,"Los Angeles Raiders",24,37,22,441,420,21,8,18,342,155,187,4,1989-10-29,-4,0,"was",-13
"9","Sun","November 5","L","","4-5",TRUE,"Dallas Cowboys",3,13,20,346,296,50,2,17,262,114,148,0,1989-11-05,-2,0,"was",-10
"10","Sun","November 12","W","","5-5",FALSE,"Philadelphia Eagles",10,3,14,254,155,99,1,12,204,157,47,2,1989-11-12,1,1,"was",7
"11","Mon","November 20","L","","5-6",TRUE,"Denver Broncos",10,14,14,223,146,77,2,19,232,106,126,2,1989-11-20,0,0,"was",-4
"12","Sun","November 26","W","","6-6",TRUE,"Chicago Bears",38,14,35,492,390,102,2,13,191,132,59,3,1989-11-26,1,1,"was",24
"13","Sun","December 3","W","","7-6",FALSE,"Phoenix Cardinals",29,10,23,303,168,135,1,15,263,234,29,3,1989-12-03,2,1,"was",19
"14","Sun","December 10","W","","8-6",TRUE,"San Diego Chargers",26,21,20,389,302,87,1,21,427,350,77,1,1989-12-10,0,1,"was",5
"15","Sun","December 17","W","","9-6",FALSE,"Atlanta Falcons",31,30,26,507,376,131,3,15,374,346,28,2,1989-12-17,-1,1,"was",1
"16","Sat","December 23","W","","10-6",FALSE,"Seattle Seahawks",29,0,26,456,319,137,1,12,201,176,25,4,1989-12-23,3,1,"was",29
"1","Sun","September 9","W","","1-0",TRUE,"Phoenix Cardinals",31,0,19,347,229,118,0,20,294,206,88,5,1990-09-09,5,1,"was",31
"2","Sun","September 16","L","","1-1",FALSE,"San Francisco 49ers",13,26,16,328,241,87,0,22,487,390,97,1,1990-09-16,1,0,"was",-13
"3","Sun","September 23","W","","2-1",TRUE,"Dallas Cowboys",19,15,11,214,135,79,1,19,234,143,91,3,1990-09-23,2,1,"was",4
"4","Sun","September 30","W","","3-1",FALSE,"Phoenix Cardinals",38,10,26,436,257,179,0,13,192,80,112,1,1990-09-30,1,1,"was",28
"6","Sun","October 14","L","","3-2",TRUE,"New York Giants",20,24,22,328,166,162,4,13,332,275,57,1,1990-10-14,-3,0,"was",-4
"7","Sun","October 21","W","","4-2",TRUE,"Philadelphia Eagles",13,7,20,321,200,121,0,16,270,176,94,1,1990-10-21,1,1,"was",6
"8","Sun","October 28","L","","4-3",FALSE,"New York Giants",10,21,16,213,149,64,3,16,263,141,122,0,1990-10-28,-3,0,"was",-11
"9","Sun","November 4","W","OT","5-3",FALSE,"Detroit Lions",41,38,39,676,482,194,4,12,351,187,164,1,1990-11-04,-3,1,"was",3
"10","Mon","November 12","L","","5-4",FALSE,"Philadelphia Eagles",14,28,13,200,150,50,3,16,262,97,165,1,1990-11-12,-2,0,"was",-14
"11","Sun","November 18","W","","6-4",TRUE,"New Orleans Saints",31,17,24,423,311,112,1,24,367,274,93,4,1990-11-18,3,1,"was",14
"12","Thu","November 22","L","","6-5",FALSE,"Dallas Cowboys",17,27,20,297,261,36,1,18,370,208,162,2,1990-11-22,1,0,"was",-10
"13","Sun","December 2","W","","7-5",TRUE,"Miami Dolphins",42,20,29,467,245,222,1,13,252,218,34,2,1990-12-02,1,1,"was",22
"14","Sun","December 9","W","","8-5",TRUE,"Chicago Bears",10,9,15,288,137,151,5,17,288,181,107,3,1990-12-09,-2,1,"was",1
"15","Sat","December 15","W","","9-5",FALSE,"New England Patriots",25,10,13,258,100,158,2,13,246,183,63,4,1990-12-15,2,1,"was",15
"16","Sat","December 22","L","","9-6",FALSE,"Indianapolis Colts",28,35,28,467,244,223,2,20,249,216,33,0,1990-12-22,-2,0,"was",-7
"17","Sun","December 30","W","","10-6",TRUE,"Buffalo Bills",29,14,16,299,172,127,1,15,273,168,105,4,1990-12-30,3,1,"was",15
"WildCard","Sat","January 5","W","","11-6",FALSE,"Philadelphia Eagles",20,6,15,299,206,93,2,16,318,170,148,3,1991-01-05,1,1,"was",14
"Division","Sat","January 12","L","","11-7",FALSE,"San Francisco 49ers",10,28,25,441,361,80,3,20,338,292,46,1,1991-01-12,-2,0,"was",-18
"1","Sun","September 1","W","","1-0",TRUE,"Detroit Lions",45,0,23,392,201,191,1,9,154,61,93,4,1991-09-01,3,1,"was",45
"2","Mon","September 9","W","","2-0",FALSE,"Dallas Cowboys",33,31,20,332,192,140,1,19,349,224,125,2,1991-09-09,1,1,"was",2
"3","Sun","September 15","W","","3-0",TRUE,"Phoenix Cardinals",34,0,22,350,181,169,2,10,165,110,55,4,1991-09-15,2,1,"was",34
"4","Sun","September 22","W","","4-0",FALSE,"Cincinnati Bengals",34,27,20,344,212,132,2,21,322,186,136,1,1991-09-22,-1,1,"was",7
"5","Mon","September 30","W","","5-0",TRUE,"Philadelphia Eagles",23,0,17,357,184,173,4,4,89,35,54,3,1991-09-30,-1,1,"was",23
"6","Sun","October 6","W","","6-0",FALSE,"Chicago Bears",20,7,12,243,168,75,1,19,319,199,120,3,1991-10-06,2,1,"was",13
"7","Sun","October 13","W","","7-0",TRUE,"Cleveland Browns",42,17,23,398,190,208,1,17,389,301,88,2,1991-10-13,1,1,"was",25
"9","Sun","October 27","W","","8-0",FALSE,"New York Giants",17,13,16,254,159,95,1,15,271,137,134,1,1991-10-27,0,1,"was",4
"10","Sun","November 3","W","OT","9-0",TRUE,"Houston Oilers",16,13,19,349,195,154,4,16,267,242,25,3,1991-11-03,-1,1,"was",3
"11","Sun","November 10","W","","10-0",TRUE,"Atlanta Falcons",56,17,20,559,451,108,0,12,271,209,62,6,1991-11-10,6,1,"was",39
"12","Sun","November 17","W","","11-0",FALSE,"Pittsburgh Steelers",41,14,23,462,365,97,0,16,282,241,41,2,1991-11-17,2,1,"was",27
"13","Sun","November 24","L","","11-1",TRUE,"Dallas Cowboys",21,24,15,262,212,50,1,23,399,277,122,1,1991-11-24,0,0,"was",-3
"14","Sun","December 1","W","","12-1",FALSE,"Los Angeles Rams",27,6,15,353,269,84,1,16,278,181,97,1,1991-12-01,0,1,"was",21
"15","Sun","December 8","W","","13-1",FALSE,"Phoenix Cardinals",20,14,21,384,249,135,1,11,194,128,66,2,1991-12-08,1,1,"was",6
"16","Sun","December 15","W","","14-1",TRUE,"New York Giants",34,17,18,415,264,151,2,20,337,259,78,3,1991-12-15,1,1,"was",17
"17","Sun","December 22","L","","14-2",FALSE,"Philadelphia Eagles",22,24,18,287,200,87,1,14,207,157,50,3,1991-12-22,2,0,"was",-2
"Division","Sat","January 4","W","","15-2",TRUE,"Atlanta Falcons",24,7,22,332,170,162,1,12,193,150,43,6,1992-01-04,5,1,"was",17
"ConfChamp","Sun","January 12","W","","16-2",TRUE,"Detroit Lions",41,10,17,345,228,117,0,20,304,232,72,3,1992-01-12,3,1,"was",31
"SuperBowl","Sun","January 26","W","","17-2",TRUE,"Buffalo Bills",37,24,24,417,292,125,1,25,283,240,43,5,1992-01-26,4,1,"was",13
"1","Mon","September 7","L","","0-1",FALSE,"Dallas Cowboys",10,23,17,260,185,75,1,23,391,216,175,2,1992-09-07,1,0,"was",-13
"2","Sun","September 13","W","","1-1",TRUE,"Atlanta Falcons",24,17,24,343,169,174,2,7,266,232,34,1,1992-09-13,-1,1,"was",7
"3","Sun","September 20","W","","2-1",TRUE,"Detroit Lions",13,10,17,275,128,147,3,8,206,169,37,2,1992-09-20,-1,1,"was",3
"5","Sun","October 4","L","","2-2",FALSE,"Phoenix Cardinals",24,27,19,365,258,107,3,21,266,163,103,2,1992-10-04,-1,0,"was",-3
"6","Mon","October 12","W","","3-2",TRUE,"Denver Broncos",34,3,17,362,245,117,1,7,128,102,26,4,1992-10-12,3,1,"was",31
"7","Sun","October 18","W","","4-2",TRUE,"Philadelphia Eagles",16,12,16,320,222,98,1,19,286,171,115,2,1992-10-18,1,1,"was",4
"8","Sun","October 25","W","","5-2",FALSE,"Minnesota Vikings",15,13,15,252,136,116,2,12,218,143,75,3,1992-10-25,1,1,"was",2
"9","Sun","November 1","L","","5-3",TRUE,"New York Giants",7,24,12,239,178,61,2,24,389,148,241,0,1992-11-01,-2,0,"was",-17
"10","Sun","November 8","W","","6-3",FALSE,"Seattle Seahawks",16,3,15,330,242,88,1,9,183,59,124,3,1992-11-08,2,1,"was",13
"11","Sun","November 15","L","","6-4",FALSE,"Kansas City Chiefs",16,35,15,285,204,81,1,20,385,287,98,1,1992-11-15,0,0,"was",-19
"12","Mon","November 23","L","","6-5",FALSE,"New Orleans Saints",3,20,14,227,169,58,1,12,224,142,82,0,1992-11-23,-1,0,"was",-17
"13","Sun","November 29","W","","7-5",TRUE,"Phoenix Cardinals",41,3,22,334,191,143,2,14,308,255,53,6,1992-11-29,4,1,"was",38
"14","Sun","December 6","W","","8-5",FALSE,"New York Giants",28,10,22,393,216,177,0,10,165,60,105,0,1992-12-06,0,1,"was",18
"15","Sun","December 13","W","","9-5",TRUE,"Dallas Cowboys",20,17,14,246,178,68,1,22,342,221,121,4,1992-12-13,3,1,"was",3
"16","Sun","December 20","L","","9-6",FALSE,"Philadelphia Eagles",13,17,19,364,246,118,3,16,299,140,159,1,1992-12-20,-2,0,"was",-4
"17","Sat","December 26","L","","9-7",TRUE,"Los Angeles Raiders",20,21,18,295,196,99,0,25,382,234,148,3,1992-12-26,3,0,"was",-1
"WildCard","Sat","January 2","W","","10-7",FALSE,"Minnesota Vikings",24,7,24,358,162,196,1,9,148,75,73,2,1993-01-02,1,1,"was",17
"Division","Sat","January 9","L","","10-8",FALSE,"San Francisco 49ers",13,20,20,323,250,73,4,22,401,214,187,4,1993-01-09,0,0,"was",-7
"1","Mon","September 6","W","","1-0",TRUE,"Dallas Cowboys",35,16,23,332,161,171,0,16,345,254,91,4,1993-09-06,4,1,"was",19
"2","Sun","September 12","L","","1-1",TRUE,"Phoenix Cardinals",10,17,14,233,175,58,2,17,303,151,152,2,1993-09-12,0,0,"was",-7
"3","Sun","September 19","L","","1-2",FALSE,"Philadelphia Eagles",31,34,19,377,210,167,2,20,438,345,93,4,1993-09-19,2,0,"was",-3
"5","Mon","October 4","L","","1-3",FALSE,"Miami Dolphins",10,17,20,232,148,84,1,17,354,248,106,1,1993-10-04,0,0,"was",-7
"6","Sun","October 10","L","","1-4",TRUE,"New York Giants",7,41,16,304,239,65,4,26,415,216,199,0,1993-10-10,-4,0,"was",-34
"7","Sun","October 17","L","","1-5",FALSE,"Phoenix Cardinals",6,36,16,246,108,138,4,18,380,224,156,1,1993-10-17,-3,0,"was",-30
"9","Mon","November 1","L","","1-6",FALSE,"Buffalo Bills",10,24,21,309,169,140,4,22,402,238,164,2,1993-11-01,-2,0,"was",-14
"10","Sun","November 7","W","","2-6",TRUE,"Indianapolis Colts",30,24,16,275,166,109,0,21,405,356,49,3,1993-11-07,3,1,"was",6
"11","Sun","November 14","L","","2-7",FALSE,"New York Giants",6,20,20,325,230,95,3,16,262,110,152,1,1993-11-14,-2,0,"was",-14
"12","Sun","November 21","L","","2-8",FALSE,"Los Angeles Rams",6,10,16,273,159,114,1,12,282,193,89,1,1993-11-21,0,0,"was",-4
"13","Sun","November 28","L","","2-9",TRUE,"Philadelphia Eagles",14,17,19,349,252,97,3,19,268,164,104,0,1993-11-28,-3,0,"was",-3
"14","Sun","December 5","W","","3-9",FALSE,"Tampa Bay Buccaneers",23,17,10,238,63,175,1,18,307,163,144,3,1993-12-05,2,1,"was",6
"15","Sat","December 11","L","","3-10",TRUE,"New York Jets",0,3,7,150,111,39,1,17,308,98,210,1,1993-12-11,0,0,"was",-3
"16","Sun","December 19","W","","4-10",TRUE,"Atlanta Falcons",30,17,8,167,129,38,2,22,378,196,182,6,1993-12-19,4,1,"was",13
"17","Sun","December 26","L","","4-11",FALSE,"Dallas Cowboys",3,38,16,198,72,126,2,27,380,205,175,1,1993-12-26,-1,0,"was",-35
"18","Fri","December 31","L","","4-12",TRUE,"Minnesota Vikings",9,14,14,265,153,112,1,16,272,226,46,1,1993-12-31,0,0,"was",-5
"1","Sun","September 4","L","","0-1",TRUE,"Seattle Seahawks",7,28,17,258,224,34,3,23,360,176,184,0,1994-09-04,-3,0,"was",-21
"2","Sun","September 11","W","","1-1",FALSE,"New Orleans Saints",38,24,22,343,190,153,1,27,408,380,28,3,1994-09-11,2,1,"was",14
"3","Sun","September 18","L","","1-2",FALSE,"New York Giants",23,31,24,456,376,80,2,20,337,231,106,0,1994-09-18,-2,0,"was",-8
"4","Sun","September 25","L","","1-3",TRUE,"Atlanta Falcons",20,27,18,354,310,44,5,19,309,238,71,1,1994-09-25,-4,0,"was",-7
"5","Sun","October 2","L","","1-4",TRUE,"Dallas Cowboys",7,34,12,110,82,28,4,26,323,181,142,1,1994-10-02,-3,0,"was",-27
"6","Sun","October 9","L","","1-5",FALSE,"Philadelphia Eagles",17,21,12,226,171,55,2,26,431,238,193,2,1994-10-09,0,0,"was",-4
"7","Sun","October 16","L","OT","1-6",TRUE,"Arizona Cardinals",16,19,11,234,149,85,5,19,324,173,151,3,1994-10-16,-2,0,"was",-3
"8","Sun","October 23","W","","2-6",FALSE,"Indianapolis Colts",41,27,20,326,226,100,0,20,381,272,109,3,1994-10-23,3,1,"was",14
"9","Sun","October 30","L","","2-7",TRUE,"Philadelphia Eagles",29,31,20,349,181,168,3,19,296,165,131,0,1994-10-30,-3,0,"was",-2
"10","Sun","November 6","L","","2-8",TRUE,"San Francisco 49ers",22,37,20,282,206,76,3,17,421,304,117,2,1994-11-06,-1,0,"was",-15
"12","Sun","November 20","L","","2-9",FALSE,"Dallas Cowboys",7,31,20,313,229,84,5,15,241,111,130,1,1994-11-20,-4,0,"was",-24
"13","Sun","November 27","L","","2-10",TRUE,"New York Giants",19,21,14,313,161,152,1,20,291,160,131,1,1994-11-27,0,0,"was",-2
"14","Sun","December 4","L","","2-11",FALSE,"Tampa Bay Buccaneers",21,26,7,268,258,10,3,28,464,251,213,2,1994-12-04,-1,0,"was",-5
"15","Sun","December 11","L","","2-12",FALSE,"Arizona Cardinals",15,17,19,406,283,123,2,14,278,194,84,1,1994-12-11,-1,0,"was",-2
"16","Sun","December 18","L","","2-13",TRUE,"Tampa Bay Buccaneers",14,17,14,267,194,73,0,20,375,267,108,2,1994-12-18,2,0,"was",-3
"17","Sat","December 24","W","","3-13",FALSE,"Los Angeles Rams",24,21,19,288,138,150,1,18,370,293,77,1,1994-12-24,0,1,"was",3
"1","Sun","September 3","W","","1-0",TRUE,"Arizona Cardinals",27,7,20,456,197,259,2,10,197,88,109,4,1995-09-03,2,1,"was",20
"2","Sun","September 10","L","","1-1",TRUE,"Oakland Raiders",8,20,15,358,260,98,3,25,358,205,153,1,1995-09-10,-2,0,"was",-12
"3","Sun","September 17","L","","1-2",FALSE,"Denver Broncos",31,38,20,354,225,129,1,28,476,318,158,0,1995-09-17,-1,0,"was",-7
"4","Sun","September 24","L","","1-3",FALSE,"Tampa Bay Buccaneers",6,14,23,311,216,95,2,15,236,123,113,1,1995-09-24,-1,0,"was",-8
"5","Sun","October 1","W","","2-3",TRUE,"Dallas Cowboys",27,23,19,319,183,136,1,19,356,238,118,2,1995-10-01,1,1,"was",4
"6","Sun","October 8","L","OT","2-4",FALSE,"Philadelphia Eagles",34,37,19,291,226,65,2,30,524,252,272,4,1995-10-08,2,0,"was",-3
"7","Sun","October 15","L","","2-5",FALSE,"Arizona Cardinals",20,24,13,259,217,42,1,20,311,198,113,2,1995-10-15,1,0,"was",-4
"8","Sun","October 22","W","OT","3-5",TRUE,"Detroit Lions",36,30,26,405,239,166,0,27,421,322,99,4,1995-10-22,4,1,"was",6
"9","Sun","October 29","L","","3-6",TRUE,"New York Giants",15,24,20,409,306,103,5,13,243,129,114,2,1995-10-29,-3,0,"was",-9
"10","Sun","November 5","L","","3-7",FALSE,"Kansas City Chiefs",3,24,13,201,122,79,2,21,368,190,178,3,1995-11-05,1,0,"was",-21
"12","Sun","November 19","L","","3-8",TRUE,"Seattle Seahawks",20,27,20,348,281,67,5,21,340,173,167,2,1995-11-19,-3,0,"was",-7
"13","Sun","November 26","L","","3-9",TRUE,"Philadelphia Eagles",7,14,15,300,153,147,2,19,316,137,179,1,1995-11-26,-1,0,"was",-7
"14","Sun","December 3","W","","4-9",FALSE,"Dallas Cowboys",24,17,18,292,152,140,0,24,381,285,96,2,1995-12-03,2,1,"was",7
"15","Sun","December 10","L","","4-10",FALSE,"New York Giants",13,20,21,306,145,161,1,9,160,72,88,1,1995-12-10,0,0,"was",-7
"16","Sun","December 17","W","","5-10",FALSE,"St. Louis Rams",35,23,18,258,140,118,3,23,441,345,96,4,1995-12-17,1,1,"was",12
"17","Sun","December 24","W","","6-10",TRUE,"Carolina Panthers",20,17,17,317,166,151,0,19,272,193,79,2,1995-12-24,2,1,"was",3
"1","Sun","September 1","L","","0-1",TRUE,"Philadelphia Eagles",14,17,11,220,93,127,0,23,402,258,144,3,1996-09-01,3,0,"was",-3
"2","Sun","September 8","W","","1-1",TRUE,"Chicago Bears",10,3,13,249,168,81,1,19,304,156,148,2,1996-09-08,1,1,"was",7
"3","Sun","September 15","W","","2-1",FALSE,"New York Giants",31,10,26,427,192,235,1,19,286,182,104,4,1996-09-15,3,1,"was",21
"4","Sun","September 22","W","","3-1",FALSE,"St. Louis Rams",17,10,16,257,151,106,2,17,285,173,112,3,1996-09-22,1,1,"was",7
"5","Sun","September 29","W","","4-1",TRUE,"New York Jets",31,16,18,396,257,139,0,27,443,287,156,1,1996-09-29,1,1,"was",15
"7","Sun","October 13","W","","5-1",FALSE,"New England Patriots",27,22,22,384,276,108,0,23,382,205,177,1,1996-10-13,1,1,"was",5
"8","Sun","October 20","W","","6-1",TRUE,"New York Giants",31,21,20,330,207,123,1,24,394,287,107,2,1996-10-20,1,1,"was",10
"9","Sun","October 27","W","","7-1",TRUE,"Indianapolis Colts",31,16,25,388,173,215,1,18,298,198,100,1,1996-10-27,0,1,"was",15
"10","Sun","November 3","L","","7-2",FALSE,"Buffalo Bills",13,38,16,234,159,75,2,31,476,210,266,0,1996-11-03,-2,0,"was",-25
"11","Sun","November 10","L","OT","7-3",TRUE,"Arizona Cardinals",34,37,25,416,212,204,2,32,615,507,108,5,1996-11-10,3,0,"was",-3
"12","Sun","November 17","W","","8-3",FALSE,"Philadelphia Eagles",26,21,19,300,205,95,1,27,364,235,129,2,1996-11-17,1,1,"was",5
"13","Sun","November 24","L","OT","8-4",TRUE,"San Francisco 49ers",16,19,15,360,282,78,0,27,392,275,117,1,1996-11-24,1,0,"was",-3
"14","Thu","November 28","L","","8-5",FALSE,"Dallas Cowboys",10,21,13,209,163,46,3,19,247,46,201,1,1996-11-28,-2,0,"was",-11
"15","Sun","December 8","L","","8-6",FALSE,"Tampa Bay Buccaneers",10,24,17,247,206,41,2,18,301,92,209,0,1996-12-08,-2,0,"was",-14
"16","Sun","December 15","L","","8-7",FALSE,"Arizona Cardinals",26,27,19,329,249,80,1,20,299,221,78,2,1996-12-15,1,0,"was",-1
"17","Sun","December 22","W","","9-7",TRUE,"Dallas Cowboys",37,10,32,483,326,157,1,14,235,116,119,2,1996-12-22,1,1,"was",27
"1","Sun","August 31","W","","1-0",FALSE,"Carolina Panthers",24,10,23,323,125,198,0,16,262,104,158,4,1997-08-31,4,1,"was",14
"2","Sun","September 7","L","","1-1",FALSE,"Pittsburgh Steelers",13,14,19,354,285,69,3,23,295,73,222,1,1997-09-07,-2,0,"was",-1
"3","Sun","September 14","W","OT","2-1",TRUE,"Arizona Cardinals",19,13,17,328,252,76,1,14,234,116,118,2,1997-09-14,1,1,"was",6
"5","Sun","September 28","W","","3-1",TRUE,"Jacksonville Jaguars",24,12,20,336,223,113,3,11,204,134,70,2,1997-09-28,-1,1,"was",12
"6","Sun","October 5","L","","3-2",FALSE,"Philadelphia Eagles",10,24,12,228,198,30,1,26,449,246,203,1,1997-10-05,0,0,"was",-14
"7","Mon","October 13","W","","4-2",TRUE,"Dallas Cowboys",21,16,16,255,139,116,1,16,290,175,115,1,1997-10-13,0,1,"was",5
"8","Sun","October 19","L","","4-3",FALSE,"Tennessee Oilers",14,28,18,312,220,92,3,23,389,185,204,0,1997-10-19,-3,0,"was",-14
"9","Sun","October 26","L","","4-4",TRUE,"Baltimore Ravens",17,20,16,249,182,67,1,20,332,133,199,1,1997-10-26,0,0,"was",-3
"10","Sun","November 2","W","","5-4",FALSE,"Chicago Bears",31,8,24,388,185,203,1,23,336,274,62,4,1997-11-02,3,1,"was",23
"11","Sun","November 9","W","","6-4",TRUE,"Detroit Lions",30,7,25,388,247,141,0,11,268,163,105,4,1997-11-09,4,1,"was",23
"12","Sun","November 16","L","","6-5",FALSE,"Dallas Cowboys",14,17,16,259,155,104,0,20,312,207,105,0,1997-11-16,0,0,"was",-3
"13","Sun","November 23","T","OT","6-5-1",TRUE,"New York Giants",7,7,23,374,291,83,4,18,262,105,157,2,1997-11-23,-2,0,"was",0
"14","Sun","November 30","L","","6-6-1",TRUE,"St. Louis Rams",20,23,19,301,240,61,2,19,398,284,114,0,1997-11-30,-2,0,"was",-3
"15","Sun","December 7","W","","7-6-1",FALSE,"Arizona Cardinals",38,28,17,362,223,139,1,14,358,301,57,3,1997-12-07,2,1,"was",10
"16","Sat","December 13","L","","7-7-1",FALSE,"New York Giants",10,30,18,320,275,45,6,14,240,110,130,2,1997-12-13,-4,0,"was",-20
"17","Sun","December 21","W","","8-7-1",TRUE,"Philadelphia Eagles",35,32,17,221,143,78,2,24,401,208,193,3,1997-12-21,1,1,"was",3
"1","Sun","September 6","L","","0-1",FALSE,"New York Giants",24,31,21,331,258,73,3,15,235,153,82,1,1998-09-06,-2,0,"was",-7
"2","Mon","September 14","L","","0-2",TRUE,"San Francisco 49ers",10,45,17,322,182,140,3,28,504,294,210,0,1998-09-14,-3,0,"was",-35
"3","Sun","September 20","L","","0-3",FALSE,"Seattle Seahawks",14,24,27,465,369,96,3,16,299,136,163,0,1998-09-20,-3,0,"was",-10
"4","Sun","September 27","L","","0-4",TRUE,"Denver Broncos",16,38,18,387,235,152,3,18,365,180,185,0,1998-09-27,-3,0,"was",-22
"5","Sun","October 4","L","","0-5",TRUE,"Dallas Cowboys",10,31,14,256,164,92,1,21,387,163,224,1,1998-10-04,0,0,"was",-21
"6","Sun","October 11","L","","0-6",FALSE,"Philadelphia Eagles",12,17,17,278,150,128,3,14,198,83,115,1,1998-10-11,-2,0,"was",-5
"7","Sun","October 18","L","","0-7",FALSE,"Minnesota Vikings",7,41,9,177,95,82,1,25,435,288,147,1,1998-10-18,0,0,"was",-34
"9","Sun","November 1","W","","1-7",TRUE,"New York Giants",21,14,21,320,196,124,0,10,229,143,86,0,1998-11-01,0,1,"was",7
"10","Sun","November 8","L","","1-8",FALSE,"Arizona Cardinals",27,29,18,256,167,89,2,23,351,164,187,1,1998-11-08,-1,0,"was",-2
"11","Sun","November 15","W","","2-8",TRUE,"Philadelphia Eagles",28,3,16,289,138,151,1,9,215,110,105,3,1998-11-15,2,1,"was",25
"12","Sun","November 22","L","","2-9",TRUE,"Arizona Cardinals",42,45,31,421,353,68,2,25,436,248,188,1,1998-11-22,-1,0,"was",-3
"13","Sun","November 29","W","","3-9",FALSE,"Oakland Raiders",29,19,17,303,209,94,1,23,376,189,187,4,1998-11-29,3,1,"was",10
"14","Sun","December 6","W","","4-9",TRUE,"San Diego Chargers",24,20,17,278,212,66,2,21,344,217,127,2,1998-12-06,0,1,"was",4
"15","Sun","December 13","W","","5-9",FALSE,"Carolina Panthers",28,25,27,409,249,160,0,16,365,241,124,3,1998-12-13,3,1,"was",3
"16","Sat","December 19","W","","6-9",TRUE,"Tampa Bay Buccaneers",20,16,11,226,136,90,2,17,237,87,150,3,1998-12-19,1,1,"was",4
"17","Sun","December 27","L","","6-10",FALSE,"Dallas Cowboys",7,23,14,292,212,80,2,22,378,222,156,0,1998-12-27,-2,0,"was",-16
"1","Sun","September 12","L","OT","0-1",TRUE,"Dallas Cowboys",35,41,25,504,369,135,2,30,541,355,186,3,1999-09-12,1,0,"was",-6
"2","Sun","September 19","W","","1-1",FALSE,"New York Giants",50,21,28,395,231,164,0,18,373,290,83,3,1999-09-19,3,1,"was",29
"3","Sun","September 26","W","","2-1",FALSE,"New York Jets",27,20,21,333,237,96,0,19,337,195,142,2,1999-09-26,2,1,"was",7
"4","Sun","October 3","W","","3-1",TRUE,"Carolina Panthers",38,36,22,418,308,110,1,23,483,328,155,1,1999-10-03,0,1,"was",2
"6","Sun","October 17","W","","4-1",FALSE,"Arizona Cardinals",24,10,24,410,243,167,3,15,274,207,67,3,1999-10-17,0,1,"was",14
"7","Sun","October 24","L","","4-2",FALSE,"Dallas Cowboys",20,38,14,272,211,61,0,23,352,244,108,1,1999-10-24,1,0,"was",-18
"8","Sun","October 31","W","","5-2",TRUE,"Chicago Bears",48,22,18,376,212,164,1,22,445,371,74,5,1999-10-31,4,1,"was",26
"9","Sun","November 7","L","","5-3",TRUE,"Buffalo Bills",17,34,16,279,222,57,2,24,413,209,204,0,1999-11-07,-2,0,"was",-17
"10","Sun","November 14","L","","5-4",FALSE,"Philadelphia Eagles",28,35,22,424,294,130,6,16,236,38,198,1,1999-11-14,-5,0,"was",-7
"11","Sun","November 21","W","","6-4",TRUE,"New York Giants",23,13,22,363,157,206,2,21,301,229,72,5,1999-11-21,3,1,"was",10
"12","Sun","November 28","W","OT","7-4",TRUE,"Philadelphia Eagles",20,17,23,312,218,94,1,16,299,156,143,0,1999-11-28,-1,1,"was",3
"13","Sun","December 5","L","","7-5",FALSE,"Detroit Lions",17,33,16,333,217,116,4,12,292,261,31,0,1999-12-05,-4,0,"was",-16
"14","Sun","December 12","W","","8-5",TRUE,"Arizona Cardinals",28,3,25,406,180,226,2,10,173,120,53,4,1999-12-12,2,1,"was",25
"15","Sun","December 19","L","","8-6",FALSE,"Indianapolis Colts",21,24,21,359,208,151,0,24,379,291,88,3,1999-12-19,3,0,"was",-3
"16","Sun","December 26","W","OT","9-6",FALSE,"San Francisco 49ers",26,20,23,511,454,57,1,24,418,168,250,2,1999-12-26,1,1,"was",6
"17","Sun","January 2","W","","10-6",TRUE,"Miami Dolphins",21,10,18,270,165,105,0,25,389,270,119,4,2000-01-02,4,1,"was",11
"WildCard","Sat","January 8","W","","11-6",TRUE,"Detroit Lions",27,13,23,389,166,223,2,14,258,213,45,2,2000-01-08,0,1,"was",14
"Division","Sat","January 15","L","","11-7",FALSE,"Tampa Bay Buccaneers",13,14,10,157,111,46,2,12,186,142,44,1,2000-01-15,-1,0,"was",-1
"1","Sun","September 3","W","","1-0",TRUE,"Carolina Panthers",20,17,23,396,234,162,0,12,236,124,112,1,2000-09-03,1,1,"was",3
"2","Sun","September 10","L","","1-1",FALSE,"Detroit Lions",10,15,20,333,229,104,4,15,244,182,62,2,2000-09-10,-2,0,"was",-5
"3","Mon","September 18","L","","1-2",TRUE,"Dallas Cowboys",21,27,24,331,224,107,2,15,332,179,153,2,2000-09-18,0,0,"was",-6
"4","Sun","September 24","W","","2-2",FALSE,"New York Giants",16,6,17,394,284,110,0,21,261,168,93,1,2000-09-24,1,1,"was",10
"5","Sun","October 1","W","OT","3-2",TRUE,"Tampa Bay Buccaneers",20,17,14,330,185,145,1,16,255,183,72,2,2000-10-01,1,1,"was",3
"6","Sun","October 8","W","","4-2",FALSE,"Philadelphia Eagles",17,14,23,407,266,141,2,16,274,199,75,4,2000-10-08,2,1,"was",3
"7","Sun","October 15","W","","5-2",TRUE,"Baltimore Ravens",10,3,15,246,145,101,2,15,199,108,91,1,2000-10-15,-1,1,"was",7
"8","Sun","October 22","W","","6-2",FALSE,"Jacksonville Jaguars",35,16,18,399,269,130,2,21,385,239,146,4,2000-10-22,2,1,"was",19
"9","Mon","October 30","L","","6-3",TRUE,"Tennessee Titans",21,27,21,266,176,90,3,13,189,93,96,0,2000-10-30,-3,0,"was",-6
"10","Sun","November 5","L","","6-4",FALSE,"Arizona Cardinals",15,16,27,422,258,164,3,11,178,133,45,2,2000-11-05,-1,0,"was",-1
"12","Mon","November 20","W","","7-4",FALSE,"St. Louis Rams",33,20,21,400,262,138,1,18,394,344,50,3,2000-11-20,2,1,"was",13
"13","Sun","November 26","L","","7-5",TRUE,"Philadelphia Eagles",20,23,20,326,282,44,2,14,289,118,171,2,2000-11-26,0,0,"was",-3
"14","Sun","December 3","L","","7-6",TRUE,"New York Giants",7,9,15,290,261,29,2,13,305,164,141,3,2000-12-03,1,0,"was",-2
"15","Sun","December 10","L","","7-7",FALSE,"Dallas Cowboys",13,32,17,270,191,79,2,19,314,72,242,0,2000-12-10,-2,0,"was",-19
"16","Sat","December 16","L","","7-8",FALSE,"Pittsburgh Steelers",3,24,14,271,207,64,5,21,374,174,200,1,2000-12-16,-4,0,"was",-21
"17","Sun","December 24","W","","8-8",TRUE,"Arizona Cardinals",20,3,19,315,175,140,2,14,245,141,104,5,2000-12-24,3,1,"was",17
"1","Sun","September 9","L","","0-1",FALSE,"San Diego Chargers",3,30,8,161,117,44,4,19,255,122,133,4,2001-09-09,0,0,"was",-27
"2","Mon","September 24","L","","0-2",FALSE,"Green Bay Packers",0,37,8,137,66,71,3,23,386,226,160,1,2001-09-24,-2,0,"was",-37
"3","Sun","September 30","L","","0-3",TRUE,"Kansas City Chiefs",13,45,11,218,107,111,1,29,546,346,200,0,2001-09-30,-1,0,"was",-32
"4","Sun","October 7","L","","0-4",FALSE,"New York Giants",9,23,9,181,124,57,5,21,309,167,142,4,2001-10-07,-1,0,"was",-14
"5","Mon","October 15","L","","0-5",FALSE,"Dallas Cowboys",7,9,10,226,123,103,1,23,386,175,211,1,2001-10-15,0,0,"was",-2
"6","Sun","October 21","W","OT","1-5",TRUE,"Carolina Panthers",17,14,16,443,345,98,2,19,342,218,124,4,2001-10-21,2,1,"was",3
"7","Sun","October 28","W","","2-5",TRUE,"New York Giants",35,21,17,353,196,157,0,25,388,346,42,2,2001-10-28,2,1,"was",14
"8","Sun","November 4","W","","3-5",TRUE,"Seattle Seahawks",27,14,21,365,139,226,1,12,275,215,60,4,2001-11-04,3,1,"was",13
"10","Sun","November 18","W","","4-5",FALSE,"Denver Broncos",17,10,18,245,127,118,3,10,186,98,88,2,2001-11-18,-1,1,"was",7
"11","Sun","November 25","W","","5-5",FALSE,"Philadelphia Eagles",13,3,16,240,85,155,0,7,186,92,94,0,2001-11-25,0,1,"was",10
"12","Sun","December 2","L","","5-6",TRUE,"Dallas Cowboys",14,20,15,277,196,81,1,19,337,122,215,1,2001-12-02,0,0,"was",-6
"13","Sun","December 9","W","","6-6",FALSE,"Arizona Cardinals",20,10,17,331,201,130,0,17,326,246,80,1,2001-12-09,1,1,"was",10
"14","Sun","December 16","L","","6-7",TRUE,"Philadelphia Eagles",6,20,16,362,205,157,3,11,287,224,63,4,2001-12-16,1,0,"was",-14
"15","Sun","December 23","L","","6-8",TRUE,"Chicago Bears",15,20,18,293,204,89,2,14,237,125,112,1,2001-12-23,-1,0,"was",-5
"16","Sun","December 30","W","","7-8",FALSE,"New Orleans Saints",40,10,19,263,90,173,1,12,213,113,100,4,2001-12-30,3,1,"was",30
"17","Sun","January 6","W","","8-8",TRUE,"Arizona Cardinals",20,17,22,340,162,178,1,10,187,142,45,1,2002-01-06,0,1,"was",3
"1","Sun","September 8","W","","1-0",TRUE,"Arizona Cardinals",31,23,21,442,320,122,1,14,257,187,70,1,2002-09-08,0,1,"was",8
"2","Mon","September 16","L","","1-1",TRUE,"Philadelphia Eagles",7,37,11,179,90,89,3,22,451,283,168,0,2002-09-16,-3,0,"was",-30
"3","Sun","September 22","L","","1-2",FALSE,"San Francisco 49ers",10,20,12,217,160,57,3,22,366,114,252,1,2002-09-22,-2,0,"was",-10
"5","Sun","October 6","W","","2-2",FALSE,"Tennessee Titans",31,14,25,442,286,156,0,17,289,230,59,4,2002-10-06,4,1,"was",17
"6","Sun","October 13","L","","2-3",TRUE,"New Orleans Saints",27,43,20,318,264,54,5,16,311,192,119,1,2002-10-13,-4,0,"was",-16
"7","Sun","October 20","L","","2-4",FALSE,"Green Bay Packers",9,30,19,238,92,146,4,19,243,155,88,1,2002-10-20,-3,0,"was",-21
"8","Sun","October 27","W","","3-4",TRUE,"Indianapolis Colts",26,21,23,370,205,165,1,18,258,195,63,3,2002-10-27,2,1,"was",5
"9","Sun","November 3","W","","4-4",FALSE,"Seattle Seahawks",14,3,16,259,113,146,1,21,324,240,84,2,2002-11-03,1,1,"was",11
"10","Sun","November 10","L","","4-5",FALSE,"Jacksonville Jaguars",7,26,23,307,239,68,3,18,309,167,142,0,2002-11-10,-3,0,"was",-19
"11","Sun","November 17","L","","4-6",FALSE,"New York Giants",17,19,12,166,106,60,2,21,299,211,88,3,2002-11-17,1,0,"was",-2
"12","Sun","November 24","W","","5-6",TRUE,"St. Louis Rams",20,17,21,362,235,127,0,25,364,280,84,2,2002-11-24,2,1,"was",3
"13","Thu","November 28","L","","5-7",FALSE,"Dallas Cowboys",20,27,16,315,232,83,4,19,328,117,211,0,2002-11-28,-4,0,"was",-7
"14","Sun","December 8","L","","5-8",TRUE,"New York Giants",21,27,23,447,315,132,5,16,316,205,111,0,2002-12-08,-5,0,"was",-6
"15","Sun","December 15","L","","5-9",FALSE,"Philadelphia Eagles",21,34,16,292,206,86,3,15,320,210,110,1,2002-12-15,-2,0,"was",-13
"16","Sun","December 22","W","","6-9",TRUE,"Houston Texans",26,10,27,437,190,247,0,10,166,99,67,3,2002-12-22,3,1,"was",16
"17","Sun","December 29","W","","7-9",TRUE,"Dallas Cowboys",20,14,18,352,201,151,5,8,186,148,38,4,2002-12-29,-1,1,"was",6
"1","Thu","September 4","W","","1-0",TRUE,"New York Jets",16,13,17,327,167,160,2,11,158,101,57,0,2003-09-04,-2,1,"was",3
"2","Sun","September 14","W","","2-0",FALSE,"Atlanta Falcons",33,31,23,435,310,125,2,17,283,184,99,2,2003-09-14,0,1,"was",2
"3","Sun","September 21","L","OT","2-1",TRUE,"New York Giants",21,24,25,456,332,124,1,25,399,270,129,0,2003-09-21,-1,0,"was",-3
"4","Sun","September 28","W","","3-1",TRUE,"New England Patriots",20,17,15,253,134,119,0,23,387,281,106,4,2003-09-28,4,1,"was",3
"5","Sun","October 5","L","","3-2",FALSE,"Philadelphia Eagles",25,27,20,307,258,49,2,18,267,140,127,2,2003-10-05,0,0,"was",-2
"6","Sun","October 12","L","","3-3",TRUE,"Tampa Bay Buccaneers",13,35,19,275,207,68,3,25,379,268,111,0,2003-10-12,-3,0,"was",-22
"7","Sun","October 19","L","","3-4",FALSE,"Buffalo Bills",7,24,8,169,110,59,1,25,432,236,196,2,2003-10-19,1,0,"was",-17
"9","Sun","November 2","L","","3-5",FALSE,"Dallas Cowboys",14,21,13,213,124,89,0,24,400,192,208,4,2003-11-02,4,0,"was",-7
"10","Sun","November 9","W","","4-5",TRUE,"Seattle Seahawks",27,20,19,379,242,137,2,21,346,221,125,3,2003-11-09,1,1,"was",7
"11","Sun","November 16","L","","4-6",FALSE,"Carolina Panthers",17,20,13,181,127,54,2,17,427,317,110,4,2003-11-16,2,0,"was",-3
"12","Sun","November 23","L","","4-7",FALSE,"Miami Dolphins",23,24,21,277,148,129,2,16,317,173,144,3,2003-11-23,1,0,"was",-1
"13","Sun","November 30","L","","4-8",TRUE,"New Orleans Saints",20,24,20,392,231,161,3,23,310,121,189,0,2003-11-30,-3,0,"was",-4
"14","Sun","December 7","W","","5-8",FALSE,"New York Giants",20,7,20,288,138,150,0,15,220,100,120,3,2003-12-07,3,1,"was",13
"15","Sun","December 14","L","","5-9",TRUE,"Dallas Cowboys",0,27,8,161,55,106,6,16,326,104,222,1,2003-12-14,-5,0,"was",-27
"16","Sun","December 21","L","","5-10",FALSE,"Chicago Bears",24,27,15,286,242,44,0,25,429,238,191,2,2003-12-21,2,0,"was",-3
"17","Sat","December 27","L","","5-11",TRUE,"Philadelphia Eagles",7,31,16,260,181,79,2,24,332,249,83,0,2003-12-27,-2,0,"was",-24
"1","Sun","September 12","W","","1-0",TRUE,"Tampa Bay Buccaneers",16,10,13,291,125,166,1,10,169,139,30,2,2004-09-12,1,1,"was",6
"2","Sun","September 19","L","","1-1",FALSE,"New York Giants",14,20,20,322,214,108,7,15,277,215,62,1,2004-09-19,-6,0,"was",-6
"3","Mon","September 27","L","","1-2",TRUE,"Dallas Cowboys",18,21,21,384,290,94,0,14,287,237,50,0,2004-09-27,0,0,"was",-3
"4","Sun","October 3","L","","1-3",FALSE,"Cleveland Browns",13,17,13,265,192,73,2,14,280,184,96,1,2004-10-03,-1,0,"was",-4
"5","Sun","October 10","L","","1-4",TRUE,"Baltimore Ravens",10,17,9,107,55,52,2,15,232,76,156,3,2004-10-10,1,0,"was",-7
"6","Sun","October 17","W","","2-4",FALSE,"Chicago Bears",13,10,18,311,93,218,1,9,160,34,126,1,2004-10-17,0,1,"was",3
"8","Sun","October 31","L","","2-5",TRUE,"Green Bay Packers",14,28,20,272,191,81,2,20,361,273,88,4,2004-10-31,2,0,"was",-14
"9","Sun","November 7","W","","3-5",FALSE,"Detroit Lions",17,10,15,229,73,156,0,21,322,258,64,1,2004-11-07,1,1,"was",7
"10","Sun","November 14","L","","3-6",TRUE,"Cincinnati Bengals",10,17,17,268,181,87,3,19,316,217,99,3,2004-11-14,0,0,"was",-7
"11","Sun","November 21","L","","3-7",FALSE,"Philadelphia Eagles",6,28,15,213,162,51,1,20,333,208,125,2,2004-11-21,1,0,"was",-22
"12","Sun","November 28","L","","3-8",FALSE,"Pittsburgh Steelers",7,16,10,156,105,51,1,15,207,100,107,0,2004-11-28,-1,0,"was",-9
"13","Sun","December 5","W","","4-8",TRUE,"New York Giants",31,7,27,379,168,211,0,7,145,107,38,0,2004-12-05,0,1,"was",24
"14","Sun","December 12","L","","4-9",TRUE,"Philadelphia Eagles",14,17,19,312,224,88,1,15,312,245,67,2,2004-12-12,1,0,"was",-3
"15","Sat","December 18","W","","5-9",FALSE,"San Francisco 49ers",26,16,17,337,209,128,1,15,254,199,55,4,2004-12-18,3,1,"was",10
"16","Sun","December 26","L","","5-10",FALSE,"Dallas Cowboys",10,13,15,233,149,84,3,21,306,217,89,2,2004-12-26,-1,0,"was",-3
"17","Sun","January 2","W","","6-10",TRUE,"Minnesota Vikings",21,18,20,318,201,117,2,21,320,268,52,0,2005-01-02,-2,1,"was",3
"1","Sun","September 11","W","","1-0",TRUE,"Chicago Bears",9,7,18,323,159,164,3,11,166,125,41,2,2005-09-11,-1,1,"was",2
"2","Mon","September 19","W","","2-0",FALSE,"Dallas Cowboys",14,13,14,346,242,104,2,14,351,261,90,0,2005-09-19,-2,1,"was",1
"4","Sun","October 2","W","OT","3-0",TRUE,"Seattle Seahawks",20,17,26,352,211,141,1,21,354,235,119,0,2005-10-02,-1,1,"was",3
"5","Sun","October 9","L","","3-1",FALSE,"Denver Broncos",19,21,28,447,322,125,1,11,257,92,165,0,2005-10-09,-1,0,"was",-2
"6","Sun","October 16","L","","3-2",FALSE,"Kansas City Chiefs",21,28,26,398,297,101,3,18,274,178,96,0,2005-10-16,-3,0,"was",-7
"7","Sun","October 23","W","","4-2",TRUE,"San Francisco 49ers",52,17,24,457,253,204,0,9,194,54,140,2,2005-10-23,2,1,"was",35
"8","Sun","October 30","L","","4-3",FALSE,"New York Giants",0,36,7,125,87,38,4,19,386,124,262,1,2005-10-30,-3,0,"was",-36
"9","Sun","November 6","W","","5-3",TRUE,"Philadelphia Eagles",17,10,17,293,215,78,1,17,336,291,45,1,2005-11-06,0,1,"was",7
"10","Sun","November 13","L","","5-4",FALSE,"Tampa Bay Buccaneers",35,36,23,389,204,185,3,19,340,279,61,1,2005-11-13,-2,0,"was",-1
"11","Sun","November 20","L","","5-5",TRUE,"Oakland Raiders",13,16,13,246,138,108,3,16,336,286,50,1,2005-11-20,-2,0,"was",-3
"12","Sun","November 27","L","OT","5-6",TRUE,"San Diego Chargers",17,23,15,282,191,91,0,24,397,195,202,3,2005-11-27,3,0,"was",-6
"13","Sun","December 4","W","","6-6",FALSE,"St. Louis Rams",24,9,19,407,150,257,0,13,191,142,49,2,2005-12-04,2,1,"was",15
"14","Sun","December 11","W","","7-6",FALSE,"Arizona Cardinals",17,13,16,231,122,109,3,17,302,240,62,4,2005-12-11,1,1,"was",4
"15","Sun","December 18","W","","8-6",TRUE,"Dallas Cowboys",35,7,19,334,163,171,1,13,216,107,109,4,2005-12-18,3,1,"was",28
"16","Sat","December 24","W","","9-6",TRUE,"New York Giants",35,20,22,380,224,156,1,18,332,233,99,1,2005-12-24,0,1,"was",15
"17","Sun","January 1","W","","10-6",FALSE,"Philadelphia Eagles",31,20,14,279,128,151,1,18,335,239,96,6,2006-01-01,5,1,"was",11
"WildCard","Sat","January 7","W","","11-6",FALSE,"Tampa Bay Buccaneers",17,10,9,120,25,95,1,17,243,168,75,3,2006-01-07,2,1,"was",7
"Division","Sat","January 14","L","","11-7",FALSE,"Seattle Seahawks",10,20,11,289,230,59,1,15,334,215,119,3,2006-01-14,2,0,"was",-10
"1","Mon","September 11","L","","0-1",TRUE,"Minnesota Vikings",16,19,15,266,163,103,0,18,309,223,86,0,2006-09-11,0,0,"was",-3
"2","Sun","September 17","L","","0-2",FALSE,"Dallas Cowboys",10,27,16,245,152,93,1,22,367,229,138,1,2006-09-17,0,0,"was",-17
"3","Sun","September 24","W","","1-2",FALSE,"Houston Texans",31,15,25,495,261,234,1,17,261,200,61,2,2006-09-24,1,1,"was",16
"4","Sun","October 1","W","OT","2-2",TRUE,"Jacksonville Jaguars",36,30,22,481,329,152,2,12,307,275,32,2,2006-10-01,0,1,"was",6
"5","Sun","October 8","L","","2-3",FALSE,"New York Giants",3,19,10,164,86,78,0,20,411,256,155,0,2006-10-08,0,0,"was",-16
"6","Sun","October 15","L","","2-4",TRUE,"Tennessee Titans",22,25,18,305,180,125,2,21,344,151,193,0,2006-10-15,-2,0,"was",-3
"7","Sun","October 22","L","","2-5",FALSE,"Indianapolis Colts",22,36,19,325,211,114,0,25,452,342,110,0,2006-10-22,0,0,"was",-14
"9","Sun","November 5","W","","3-5",TRUE,"Dallas Cowboys",22,19,18,300,183,117,1,21,378,267,111,0,2006-11-05,-1,1,"was",3
"10","Sun","November 12","L","","3-6",FALSE,"Philadelphia Eagles",3,27,16,278,132,146,1,18,400,255,145,0,2006-11-12,-1,0,"was",-24
"11","Sun","November 19","L","","3-7",FALSE,"Tampa Bay Buccaneers",17,20,15,252,193,59,1,19,359,178,181,2,2006-11-19,1,0,"was",-3
"12","Sun","November 26","W","","4-7",TRUE,"Carolina Panthers",17,13,14,253,110,143,1,15,264,163,101,2,2006-11-26,1,1,"was",4
"13","Sun","December 3","L","","4-8",TRUE,"Atlanta Falcons",14,24,25,381,204,177,2,16,369,113,256,0,2006-12-03,-2,0,"was",-10
"14","Sun","December 10","L","","4-9",TRUE,"Philadelphia Eagles",19,21,20,415,205,210,2,14,263,164,99,1,2006-12-10,-1,0,"was",-2
"15","Sun","December 17","W","","5-9",FALSE,"New Orleans Saints",16,10,19,354,193,161,0,15,270,199,71,1,2006-12-17,1,1,"was",6
"16","Sun","December 24","L","OT","5-10",FALSE,"St. Louis Rams",31,37,22,336,160,176,1,25,579,382,197,1,2006-12-24,0,0,"was",-6
"17","Sat","December 30","L","","5-11",TRUE,"New York Giants",28,34,21,393,265,128,2,23,355,94,261,0,2006-12-30,-2,0,"was",-6
"1","Sun","September 9","W","OT","1-0",TRUE,"Miami Dolphins",16,13,19,400,209,191,2,17,273,207,66,1,2007-09-09,-1,1,"was",3
"2","Mon","September 17","W","","2-0",FALSE,"Philadelphia Eagles",20,12,19,337,207,130,1,18,340,226,114,0,2007-09-17,-1,1,"was",8
"3","Sun","September 23","L","","2-1",TRUE,"New York Giants",17,24,14,260,178,82,1,19,315,219,96,3,2007-09-23,2,0,"was",-7
"5","Sun","October 7","W","","3-1",TRUE,"Detroit Lions",34,3,23,366,248,118,1,11,144,76,68,2,2007-10-07,1,1,"was",31
"6","Sun","October 14","L","","3-2",FALSE,"Green Bay Packers",14,17,18,304,210,94,3,13,225,169,56,2,2007-10-14,-1,0,"was",-3
"7","Sun","October 21","W","","4-2",TRUE,"Arizona Cardinals",21,19,10,160,87,73,1,19,364,280,84,3,2007-10-21,2,1,"was",2
"8","Sun","October 28","L","","4-3",FALSE,"New England Patriots",7,52,13,224,177,47,4,34,486,334,152,1,2007-10-28,-3,0,"was",-45
"9","Sun","November 4","W","OT","5-3",FALSE,"New York Jets",23,20,23,431,135,296,1,23,338,214,124,1,2007-11-04,0,1,"was",3
"10","Sun","November 11","L","","5-4",TRUE,"Philadelphia Eagles",25,33,25,361,203,158,2,22,379,240,139,2,2007-11-11,0,0,"was",-8
"11","Sun","November 18","L","","5-5",FALSE,"Dallas Cowboys",23,28,28,423,361,62,2,19,362,287,75,1,2007-11-18,-1,0,"was",-5
"12","Sun","November 25","L","","5-6",FALSE,"Tampa Bay Buccaneers",13,19,23,412,292,120,6,9,192,93,99,0,2007-11-25,-6,0,"was",-6
"13","Sun","December 2","L","","5-7",TRUE,"Buffalo Bills",16,17,22,281,202,79,2,15,357,257,100,1,2007-12-02,-1,0,"was",-1
"14","Thu","December 6","W","","6-7",TRUE,"Chicago Bears",24,16,15,345,314,31,1,22,356,296,60,2,2007-12-06,1,1,"was",8
"15","Sun","December 16","W","","7-7",FALSE,"New York Giants",22,10,14,309,156,153,0,20,307,168,139,1,2007-12-16,1,1,"was",12
"16","Sun","December 23","W","","8-7",FALSE,"Minnesota Vikings",32,21,19,367,261,106,0,23,299,212,87,3,2007-12-23,3,1,"was",11
"17","Sun","December 30","W","","9-7",TRUE,"Dallas Cowboys",27,6,22,354,223,131,2,7,147,146,1,1,2007-12-30,-1,1,"was",21
"WildCard","Sat","January 5","L","","9-8",FALSE,"Seattle Seahawks",14,35,21,319,244,75,2,14,304,227,77,2,2008-01-05,0,0,"was",-21
"1","Thu","September 4","L","","0-1",FALSE,"New York Giants",7,16,11,209,125,84,0,21,354,200,154,1,2008-09-04,1,0,"was",-9
"2","Sun","September 14","W","","1-1",TRUE,"New Orleans Saints",29,24,25,455,306,149,1,16,250,195,55,3,2008-09-14,2,1,"was",5
"3","Sun","September 21","W","","2-1",TRUE,"Arizona Cardinals",24,17,21,323,187,136,0,19,313,197,116,2,2008-09-21,2,1,"was",7
"4","Sun","September 28","W","","3-1",FALSE,"Dallas Cowboys",26,24,22,381,220,161,0,21,344,300,44,1,2008-09-28,1,1,"was",2
"5","Sun","October 5","W","","4-1",FALSE,"Philadelphia Eagles",23,17,22,388,185,203,0,14,254,196,58,0,2008-10-05,0,1,"was",6
"6","Sun","October 12","L","","4-2",TRUE,"St. Louis Rams",17,19,22,368,187,181,3,8,200,124,76,1,2008-10-12,-2,0,"was",-2
"7","Sun","October 19","W","","5-2",TRUE,"Cleveland Browns",14,11,17,351,158,193,1,16,236,134,102,0,2008-10-19,-1,1,"was",3
"8","Sun","October 26","W","","6-2",FALSE,"Detroit Lions",25,17,22,439,304,135,1,13,274,217,57,0,2008-10-26,-1,1,"was",8
"9","Mon","November 3","L","","6-3",TRUE,"Pittsburgh Steelers",6,23,13,221,161,60,2,15,229,165,64,1,2008-11-03,-1,0,"was",-17
"11","Sun","November 16","L","","6-4",TRUE,"Dallas Cowboys",10,14,14,228,136,92,1,17,315,198,117,2,2008-11-16,1,0,"was",-4
"12","Sun","November 23","W","","7-4",FALSE,"Seattle Seahawks",20,17,24,386,199,187,1,13,228,89,139,2,2008-11-23,1,1,"was",3
"13","Sun","November 30","L","","7-5",TRUE,"New York Giants",7,23,17,320,228,92,2,23,404,296,108,1,2008-11-30,-1,0,"was",-16
"14","Sun","December 7","L","","7-6",FALSE,"Baltimore Ravens",10,24,14,254,192,62,3,12,281,134,147,2,2008-12-07,-1,0,"was",-14
"15","Sun","December 14","L","","7-7",FALSE,"Cincinnati Bengals",13,20,15,280,167,113,2,17,310,204,106,0,2008-12-14,-2,0,"was",-7
"16","Sun","December 21","W","","8-7",TRUE,"Philadelphia Eagles",10,3,17,249,127,122,0,15,275,213,62,1,2008-12-21,1,1,"was",7
"17","Sun","December 28","L","","8-8",FALSE,"San Francisco 49ers",24,27,19,268,143,125,1,19,359,238,121,1,2008-12-28,0,0,"was",-3
"1","Sun","September 13","L","","0-1",FALSE,"New York Giants",17,23,15,272,187,85,2,18,351,248,103,2,2009-09-13,0,0,"was",-6
"2","Sun","September 20","W","","1-1",TRUE,"St. Louis Rams",9,7,21,362,237,125,1,14,245,119,126,1,2009-09-20,0,1,"was",2
"3","Sun","September 27","L","","1-2",FALSE,"Detroit Lions",14,19,22,390,325,65,1,23,381,227,154,0,2009-09-27,-1,0,"was",-5
"4","Sun","October 4","W","","2-2",TRUE,"Tampa Bay Buccaneers",16,13,14,277,152,125,4,12,229,100,129,2,2009-10-04,-2,1,"was",3
"5","Sun","October 11","L","","2-3",FALSE,"Carolina Panthers",17,20,15,198,124,74,1,16,248,162,86,2,2009-10-11,1,0,"was",-3
"6","Sun","October 18","L","","2-4",TRUE,"Kansas City Chiefs",6,14,7,265,147,118,2,16,268,158,110,0,2009-10-18,-2,0,"was",-8
"7","Mon","October 26","L","","2-5",TRUE,"Philadelphia Eagles",17,27,21,308,246,62,4,11,262,140,122,0,2009-10-26,-4,0,"was",-10
"9","Sun","November 8","L","","2-6",FALSE,"Atlanta Falcons",17,31,17,312,176,136,1,18,306,125,181,1,2009-11-08,0,0,"was",-14
"10","Sun","November 15","W","","3-6",TRUE,"Denver Broncos",27,17,22,388,214,174,0,14,305,185,120,2,2009-11-15,2,1,"was",10
"11","Sun","November 22","L","","3-7",FALSE,"Dallas Cowboys",6,7,14,324,246,78,1,17,305,152,153,2,2009-11-22,1,0,"was",-1
"12","Sun","November 29","L","","3-8",FALSE,"Philadelphia Eagles",24,27,15,303,221,82,2,17,381,258,123,1,2009-11-29,-1,0,"was",-3
"13","Sun","December 6","L","OT","3-9",TRUE,"New Orleans Saints",30,33,28,455,367,88,4,25,463,408,55,1,2009-12-06,-3,0,"was",-3
"14","Sun","December 13","W","","4-9",FALSE,"Oakland Raiders",34,13,21,295,195,100,1,15,227,162,65,1,2009-12-13,0,1,"was",21
"15","Mon","December 21","L","","4-10",TRUE,"New York Giants",12,45,15,302,213,89,3,23,387,273,114,0,2009-12-21,-3,0,"was",-33
"16","Sun","December 27","L","","4-11",TRUE,"Dallas Cowboys",0,17,15,208,165,43,1,22,393,285,108,1,2009-12-27,0,0,"was",-17
"17","Sun","January 3","L","","4-12",FALSE,"San Diego Chargers",20,23,18,341,275,66,0,19,364,314,50,1,2010-01-03,1,0,"was",-3
"1","Sun","September 12","W","","1-0",TRUE,"Dallas Cowboys",13,7,17,250,161,89,0,24,380,277,103,1,2010-09-12,1,1,"was",6
"2","Sun","September 19","L","OT","1-1",TRUE,"Houston Texans",27,30,21,421,403,18,0,29,526,468,58,1,2010-09-19,1,0,"was",-3
"3","Sun","September 26","L","","1-2",FALSE,"St. Louis Rams",16,30,15,349,233,116,2,24,365,232,133,2,2010-09-26,0,0,"was",-14
"4","Sun","October 3","W","","2-2",FALSE,"Philadelphia Eagles",17,12,16,293,124,169,1,21,353,243,110,2,2010-10-03,1,1,"was",5
"5","Sun","October 10","W","OT","3-2",TRUE,"Green Bay Packers",16,13,21,373,322,51,1,17,427,270,157,2,2010-10-10,1,1,"was",3
"6","Sun","October 17","L","","3-3",TRUE,"Indianapolis Colts",24,27,23,335,222,113,2,22,469,299,170,3,2010-10-17,1,0,"was",-3
"7","Sun","October 24","W","","4-3",FALSE,"Chicago Bears",17,14,13,308,187,121,3,19,322,256,66,6,2010-10-24,3,1,"was",3
"8","Sun","October 31","L","","4-4",FALSE,"Detroit Lions",25,37,13,275,195,80,2,19,304,202,102,2,2010-10-31,0,0,"was",-12
"10","Mon","November 15","L","","4-5",TRUE,"Philadelphia Eagles",28,59,15,375,270,105,3,28,592,332,260,0,2010-11-15,-3,0,"was",-31
"11","Sun","November 21","W","OT","5-5",FALSE,"Tennessee Titans",19,16,32,465,358,107,1,15,373,222,151,2,2010-11-21,1,1,"was",3
"12","Sun","November 28","L","","5-6",TRUE,"Minnesota Vikings",13,17,10,216,187,29,1,17,299,162,137,0,2010-11-28,-1,0,"was",-4
"13","Sun","December 5","L","","5-7",FALSE,"New York Giants",7,31,19,338,264,74,6,22,358,161,197,1,2010-12-05,-5,0,"was",-24
"14","Sun","December 12","L","","5-8",TRUE,"Tampa Bay Buccaneers",16,17,22,399,211,188,1,15,365,262,103,2,2010-12-12,1,0,"was",-1
"15","Sun","December 19","L","","5-9",FALSE,"Dallas Cowboys",30,33,23,341,286,55,3,25,434,300,134,0,2010-12-19,-3,0,"was",-3
"16","Sun","December 26","W","OT","6-9",FALSE,"Jacksonville Jaguars",20,17,15,251,172,79,1,15,336,258,78,2,2010-12-26,1,1,"was",3
"17","Sun","January 2","L","","6-10",TRUE,"New York Giants",14,17,20,403,336,67,4,14,325,243,82,1,2011-01-02,-3,0,"was",-3
"1","Sun","September 11","W","","1-0",TRUE,"New York Giants",28,14,21,332,258,74,1,15,315,240,75,1,2011-09-11,0,1,"was",14
"2","Sun","September 18","W","","2-0",TRUE,"Arizona Cardinals",22,21,28,455,283,172,2,16,324,231,93,2,2011-09-18,0,1,"was",1
"3","Mon","September 26","L","","2-1",FALSE,"Dallas Cowboys",16,18,20,298,233,65,2,17,375,250,125,2,2011-09-26,0,0,"was",-2
"4","Sun","October 2","W","","3-1",FALSE,"St. Louis Rams",17,10,16,339,143,196,2,14,172,127,45,1,2011-10-02,-1,1,"was",7
"6","Sun","October 16","L","","3-2",TRUE,"Philadelphia Eagles",13,20,17,287,245,42,4,22,422,230,192,2,2011-10-16,-2,0,"was",-7
"7","Sun","October 23","L","","3-3",FALSE,"Carolina Panthers",20,33,22,353,261,92,3,20,407,232,175,0,2011-10-23,-3,0,"was",-13
"8","Sun","October 30","L","","3-4",FALSE,"Buffalo Bills",0,23,10,178,152,26,2,17,390,252,138,2,2011-10-30,0,0,"was",-23
"9","Sun","November 6","L","","3-5",TRUE,"San Francisco 49ers",11,19,17,303,251,52,3,15,326,188,138,1,2011-11-06,-2,0,"was",-8
"10","Sun","November 13","L","","3-6",FALSE,"Miami Dolphins",9,20,16,246,185,61,2,20,303,200,103,2,2011-11-13,0,0,"was",-11
"11","Sun","November 20","L","OT","3-7",TRUE,"Dallas Cowboys",24,27,18,339,279,60,2,20,353,264,89,0,2011-11-20,-2,0,"was",-3
"12","Sun","November 27","W","","4-7",FALSE,"Seattle Seahawks",23,17,22,416,306,110,2,15,250,126,124,1,2011-11-27,-1,1,"was",6
"13","Sun","December 4","L","","4-8",TRUE,"New York Jets",19,34,17,304,204,100,3,16,266,165,101,1,2011-12-04,-2,0,"was",-15
"14","Sun","December 11","L","","4-9",TRUE,"New England Patriots",27,34,25,463,293,170,2,22,431,352,79,1,2011-12-11,-1,0,"was",-7
"15","Sun","December 18","W","","5-9",FALSE,"New York Giants",23,10,19,300,177,123,2,22,324,233,91,3,2011-12-18,1,1,"was",13
"16","Sat","December 24","L","","5-10",TRUE,"Minnesota Vikings",26,33,23,397,256,141,2,20,389,148,241,0,2011-12-24,-2,0,"was",-7
"17","Sun","January 1","L","","5-11",FALSE,"Philadelphia Eagles",10,34,21,377,247,130,1,24,390,315,75,2,2012-01-01,1,0,"was",-24
"1","Sun","September 8","L","","0-1",FALSE,"New York Giants",0,21,11,168,88,80,1,21,317,125,192,2,1985-09-08,1,0,"phi",-21
"2","Sun","September 15","L","","0-2",TRUE,"Los Angeles Rams",6,17,16,300,180,120,7,16,334,161,173,2,1985-09-15,-5,0,"phi",-11
"3","Sun","September 22","W","","1-2",FALSE,"Washington Redskins",19,6,15,327,152,175,1,15,257,117,140,2,1985-09-22,1,1,"phi",13
"4","Sun","September 29","L","OT","1-3",TRUE,"New York Giants",10,16,11,168,54,114,1,21,338,198,140,3,1985-09-29,2,0,"phi",-6
"5","Sun","October 6","L","","1-4",FALSE,"New Orleans Saints",21,23,24,363,256,107,5,12,217,146,71,2,1985-10-06,-3,0,"phi",-2
"6","Sun","October 13","W","","2-4",TRUE,"St. Louis Cardinals",30,7,18,354,243,111,0,12,268,187,81,2,1985-10-13,2,1,"phi",23
"7","Sun","October 20","W","","3-4",TRUE,"Dallas Cowboys",16,14,22,402,347,55,1,22,310,163,147,4,1985-10-20,3,1,"phi",2
"8","Sun","October 27","W","","4-4",TRUE,"Buffalo Bills",21,17,16,275,237,38,1,17,339,211,128,2,1985-10-27,1,1,"phi",4
"9","Sun","November 3","L","","4-5",FALSE,"San Francisco 49ers",13,24,20,427,366,61,5,24,364,227,137,3,1985-11-03,-2,0,"phi",-11
"10","Sun","November 10","W","OT","5-5",TRUE,"Atlanta Falcons",23,17,15,330,235,95,2,20,310,94,216,2,1985-11-10,0,1,"phi",6
"11","Sun","November 17","W","","6-5",FALSE,"St. Louis Cardinals",24,14,21,283,107,176,1,20,384,147,237,0,1985-11-17,-1,1,"phi",10
"12","Sun","November 24","L","","6-6",FALSE,"Dallas Cowboys",17,34,20,402,277,125,3,28,377,234,143,1,1985-11-24,-2,0,"phi",-17
"13","Sun","December 1","L","","6-7",TRUE,"Minnesota Vikings",23,28,24,443,306,137,3,13,239,172,67,0,1985-12-01,-3,0,"phi",-5
"14","Sun","December 8","L","","6-8",TRUE,"Washington Redskins",12,17,14,202,165,37,3,19,310,144,166,1,1985-12-08,-2,0,"phi",-5
"15","Sun","December 15","L","","6-9",FALSE,"San Diego Chargers",14,20,22,382,307,75,3,22,417,323,94,3,1985-12-15,0,0,"phi",-6
"16","Sun","December 22","W","","7-9",FALSE,"Minnesota Vikings",37,35,23,390,266,124,3,25,354,281,73,3,1985-12-22,0,1,"phi",2
"1","Sun","September 7","L","","0-1",FALSE,"Washington Redskins",14,41,16,267,201,66,2,21,433,274,159,1,1986-09-07,-1,0,"phi",-27
"2","Sun","September 14","L","OT","0-2",FALSE,"Chicago Bears",10,13,17,247,146,101,6,21,344,100,244,4,1986-09-14,-2,0,"phi",-3
"3","Sun","September 21","L","","0-3",TRUE,"Denver Broncos",7,33,16,273,196,77,2,19,328,125,203,1,1986-09-21,-1,0,"phi",-26
"4","Sun","September 28","W","","1-3",TRUE,"Los Angeles Rams",34,20,20,395,259,136,1,18,320,207,113,3,1986-09-28,2,1,"phi",14
"5","Sun","October 5","W","","2-3",FALSE,"Atlanta Falcons",16,0,15,309,212,97,1,15,228,173,55,3,1986-10-05,2,1,"phi",16
"6","Sun","October 12","L","","2-4",FALSE,"New York Giants",3,35,9,117,58,59,2,24,394,216,178,1,1986-10-12,-1,0,"phi",-32
"7","Sun","October 19","L","","2-5",TRUE,"Dallas Cowboys",14,17,19,317,100,217,0,17,389,253,136,2,1986-10-19,2,0,"phi",-3
"8","Sun","October 26","W","","3-5",TRUE,"San Diego Chargers",23,7,15,251,124,127,2,14,259,187,72,3,1986-10-26,1,1,"phi",16
"9","Sun","November 2","L","","3-6",FALSE,"St. Louis Cardinals",10,13,17,228,133,95,0,14,190,68,122,1,1986-11-02,1,0,"phi",-3
"10","Sun","November 9","L","","3-7",TRUE,"New York Giants",14,17,17,237,159,78,2,15,265,112,153,2,1986-11-09,0,0,"phi",-3
"11","Sun","November 16","L","","3-8",TRUE,"Detroit Lions",11,13,20,294,68,226,4,12,186,146,40,1,1986-11-16,-3,0,"phi",-2
"12","Sun","November 23","L","","3-9",FALSE,"Seattle Seahawks",20,24,24,324,182,142,0,14,340,260,80,3,1986-11-23,3,0,"phi",-4
"13","Sun","November 30","W","OT","4-9",FALSE,"Los Angeles Raiders",33,27,22,347,241,106,2,16,379,318,61,4,1986-11-30,2,1,"phi",6
"14","Sun","December 7","T","OT","4-9-1",TRUE,"St. Louis Cardinals",10,10,25,354,124,230,1,23,461,356,105,1,1986-12-07,0,0,"phi",0
"15","Sun","December 14","W","","5-9-1",FALSE,"Dallas Cowboys",23,21,15,323,225,98,2,15,444,248,196,2,1986-12-14,0,1,"phi",2
"16","Sun","December 21","L","","5-10-1",TRUE,"Washington Redskins",14,21,20,259,112,147,0,20,264,192,72,4,1986-12-21,4,0,"phi",-7
"1","Sun","September 13","L","","0-1",FALSE,"Washington Redskins",24,34,24,351,239,112,4,19,374,264,110,2,1987-09-13,-2,0,"phi",-10
"2","Sun","September 20","W","","1-1",TRUE,"New Orleans Saints",27,17,19,336,175,161,3,14,220,188,32,5,1987-09-20,2,1,"phi",10
"3","Sun","October 4","L","","1-2",TRUE,"Chicago Bears",3,35,14,170,65,105,2,22,318,184,134,2,1987-10-04,0,0,"phi",-32
"4","Sun","October 11","L","","1-3",FALSE,"Dallas Cowboys",22,41,24,434,362,72,3,19,400,240,160,2,1987-10-11,-1,0,"phi",-19
"5","Sun","October 18","L","OT","1-4",FALSE,"Green Bay Packers",10,16,17,365,224,141,5,20,401,226,175,4,1987-10-18,-1,0,"phi",-6
"6","Sun","October 25","W","","2-4",TRUE,"Dallas Cowboys",37,20,18,237,96,141,1,18,294,197,97,3,1987-10-25,2,1,"phi",17
"7","Sun","November 1","W","","3-4",FALSE,"St. Louis Cardinals",28,23,14,328,266,62,2,27,409,232,177,3,1987-11-01,1,1,"phi",5
"8","Sun","November 8","W","","4-4",TRUE,"Washington Redskins",31,27,23,427,232,195,4,23,360,231,129,4,1987-11-08,0,1,"phi",4
"9","Sun","November 15","L","","4-5",TRUE,"New York Giants",17,20,22,337,146,191,1,17,384,268,116,3,1987-11-15,2,0,"phi",-3
"10","Sun","November 22","L","","4-6",TRUE,"St. Louis Cardinals",19,31,17,300,240,60,3,18,324,232,92,3,1987-11-22,0,0,"phi",-12
"11","Sun","November 29","W","OT","5-6",FALSE,"New England Patriots",34,31,23,471,287,184,1,31,445,356,89,4,1987-11-29,3,1,"phi",3
"12","Sun","December 6","L","OT","5-7",FALSE,"New York Giants",20,23,15,259,164,95,1,15,299,221,78,2,1987-12-06,1,0,"phi",-3
"13","Sun","December 13","L","","5-8",TRUE,"Miami Dolphins",10,28,15,310,155,155,1,23,476,357,119,4,1987-12-13,3,0,"phi",-18
"14","Sun","December 20","W","","6-8",FALSE,"New York Jets",38,27,22,408,265,143,1,21,354,276,78,3,1987-12-20,2,1,"phi",11
"15","Sun","December 27","W","","7-8",TRUE,"Buffalo Bills",17,7,22,344,134,210,3,14,191,134,57,4,1987-12-27,1,1,"phi",10
"1","Sun","September 4","W","","1-0",FALSE,"Tampa Bay Buccaneers",41,14,18,389,248,141,2,19,362,319,43,5,1988-09-04,3,1,"phi",27
"2","Sun","September 11","L","","1-1",TRUE,"Cincinnati Bengals",24,28,28,415,225,190,1,20,431,353,78,3,1988-09-11,2,0,"phi",-4
"3","Sun","September 18","L","","1-2",FALSE,"Washington Redskins",10,17,13,299,209,90,0,16,285,135,150,2,1988-09-18,2,0,"phi",-7
"4","Sun","September 25","L","","1-3",FALSE,"Minnesota Vikings",21,23,12,205,135,70,2,21,392,287,105,3,1988-09-25,1,0,"phi",-2
"5","Sun","October 2","W","","2-3",TRUE,"Houston Oilers",32,23,26,455,265,190,1,14,202,147,55,3,1988-10-02,2,1,"phi",9
"6","Mon","October 10","W","","3-3",TRUE,"New York Giants",24,13,23,452,343,109,0,23,436,336,100,1,1988-10-10,1,1,"phi",11
"7","Sun","October 16","L","","3-4",FALSE,"Cleveland Browns",3,19,12,119,48,71,2,17,361,179,182,1,1988-10-16,-1,0,"phi",-16
"8","Sun","October 23","W","","4-4",TRUE,"Dallas Cowboys",24,23,23,339,274,65,2,25,437,332,105,1,1988-10-23,-1,1,"phi",1
"9","Sun","October 30","L","","4-5",TRUE,"Atlanta Falcons",24,27,25,424,269,155,3,11,294,202,92,1,1988-10-30,-2,0,"phi",-3
"10","Sun","November 6","W","","5-5",TRUE,"Los Angeles Rams",30,24,21,436,313,123,0,22,427,358,69,5,1988-11-06,5,1,"phi",6
"11","Sun","November 13","W","","6-5",FALSE,"Pittsburgh Steelers",27,26,27,358,252,106,3,19,361,197,164,1,1988-11-13,-2,1,"phi",1
"12","Sun","November 20","W","OT","7-5",FALSE,"New York Giants",23,17,18,283,176,107,1,21,394,316,78,3,1988-11-20,2,1,"phi",6
"13","Sun","November 27","W","","8-5",TRUE,"Phoenix Cardinals",31,21,17,292,201,91,4,25,369,202,167,5,1988-11-27,1,1,"phi",10
"14","Sun","December 4","L","","8-6",TRUE,"Washington Redskins",19,20,21,310,147,163,3,22,410,329,81,4,1988-12-04,1,0,"phi",-1
"15","Sat","December 10","W","","9-6",FALSE,"Phoenix Cardinals",23,17,16,283,142,141,2,23,399,353,46,3,1988-12-10,1,1,"phi",6
"16","Sun","December 18","W","","10-6",FALSE,"Dallas Cowboys",23,7,18,371,238,133,0,13,239,102,137,3,1988-12-18,3,1,"phi",16
"Division","Sat","December 31","L","","10-7",FALSE,"Chicago Bears",12,20,22,430,378,52,3,14,341,177,164,4,1988-12-31,1,0,"phi",-8
"1","Sun","September 10","W","","1-0",TRUE,"Seattle Seahawks",31,7,18,365,234,131,0,17,270,193,77,3,1989-09-10,3,1,"phi",24
"2","Sun","September 17","W","","2-0",FALSE,"Washington Redskins",42,37,32,474,409,65,3,16,492,272,220,6,1989-09-17,3,1,"phi",5
"3","Sun","September 24","L","","2-1",TRUE,"San Francisco 49ers",28,38,22,315,161,154,3,19,444,385,59,3,1989-09-24,0,0,"phi",-10
"4","Mon","October 2","L","","2-2",FALSE,"Chicago Bears",13,27,23,435,368,67,6,22,374,261,113,3,1989-10-02,-3,0,"phi",-14
"5","Sun","October 8","W","","3-2",TRUE,"New York Giants",21,19,18,243,85,158,0,20,323,239,84,1,1989-10-08,1,1,"phi",2
"6","Sun","October 15","W","","4-2",FALSE,"Phoenix Cardinals",17,5,18,353,186,167,4,20,337,223,114,8,1989-10-15,4,1,"phi",12
"7","Sun","October 22","W","","5-2",TRUE,"Los Angeles Raiders",10,7,13,195,63,132,0,20,268,142,126,2,1989-10-22,2,1,"phi",3
"8","Sun","October 29","W","","6-2",FALSE,"Denver Broncos",28,24,17,313,98,215,2,22,320,216,104,6,1989-10-29,4,1,"phi",4
"9","Sun","November 5","L","","6-3",FALSE,"San Diego Chargers",17,20,24,373,195,178,3,17,358,254,104,3,1989-11-05,0,0,"phi",-3
"10","Sun","November 12","L","","6-4",TRUE,"Washington Redskins",3,10,12,204,157,47,2,14,254,155,99,1,1989-11-12,-1,0,"phi",-7
"11","Sun","November 19","W","","7-4",TRUE,"Minnesota Vikings",10,9,22,270,179,91,1,18,219,136,83,5,1989-11-19,4,1,"phi",1
"12","Thu","November 23","W","","8-4",FALSE,"Dallas Cowboys",27,0,22,381,243,138,1,10,191,68,123,5,1989-11-23,4,1,"phi",27
"13","Sun","December 3","W","","9-4",FALSE,"New York Giants",24,17,13,279,130,149,2,17,294,236,58,5,1989-12-03,3,1,"phi",7
"14","Sun","December 10","W","","10-4",TRUE,"Dallas Cowboys",20,10,19,280,158,122,0,14,194,107,87,1,1989-12-10,1,1,"phi",10
"15","Mon","December 18","L","","10-5",FALSE,"New Orleans Saints",20,30,22,408,281,127,4,21,291,205,86,1,1989-12-18,-3,0,"phi",-10
"16","Sun","December 24","W","","11-5",TRUE,"Phoenix Cardinals",31,14,26,432,165,267,1,14,265,197,68,3,1989-12-24,2,1,"phi",17
"WildCard","Sun","December 31","L","","11-6",TRUE,"Los Angeles Rams",7,21,14,306,211,95,3,19,409,265,144,3,1989-12-31,0,0,"phi",-14
"1","Sun","September 9","L","","0-1",FALSE,"New York Giants",20,27,21,295,214,81,3,11,227,148,79,1,1990-09-09,-2,0,"phi",-7
"2","Sun","September 16","L","","0-2",TRUE,"Phoenix Cardinals",21,23,17,327,223,104,3,14,234,89,145,1,1990-09-16,-2,0,"phi",-2
"3","Sun","September 23","W","","1-2",FALSE,"Los Angeles Rams",27,21,25,405,234,171,3,15,281,246,35,2,1990-09-23,-1,1,"phi",6
"4","Sun","September 30","L","","1-3",TRUE,"Indianapolis Colts",23,24,21,409,266,143,1,17,357,305,52,2,1990-09-30,1,0,"phi",-1
"6","Mon","October 15","W","","2-3",TRUE,"Minnesota Vikings",32,24,16,347,219,128,2,12,273,239,34,6,1990-10-15,4,1,"phi",8
"7","Sun","October 21","L","","2-4",FALSE,"Washington Redskins",7,13,16,270,176,94,1,20,321,200,121,0,1990-10-21,-1,0,"phi",-6
"8","Sun","October 28","W","","3-4",FALSE,"Dallas Cowboys",21,20,23,304,160,144,1,23,345,215,130,1,1990-10-28,0,1,"phi",1
"9","Sun","November 4","W","","4-4",TRUE,"New England Patriots",48,20,28,514,210,304,2,16,288,247,41,1,1990-11-04,-1,1,"phi",28
"10","Mon","November 12","W","","5-4",TRUE,"Washington Redskins",28,14,16,262,97,165,1,13,200,150,50,3,1990-11-12,2,1,"phi",14
"11","Sun","November 18","W","","6-4",FALSE,"Atlanta Falcons",24,23,16,279,191,88,2,16,315,256,59,1,1990-11-18,-1,1,"phi",1
"12","Sun","November 25","W","","7-4",TRUE,"New York Giants",31,13,22,405,229,176,2,16,327,219,108,2,1990-11-25,0,1,"phi",18
"13","Sun","December 2","L","","7-5",FALSE,"Buffalo Bills",23,30,19,357,181,176,2,13,393,334,59,1,1990-12-02,-1,0,"phi",-7
"14","Sun","December 9","L","OT","7-6",FALSE,"Miami Dolphins",20,23,21,434,177,257,1,26,405,351,54,1,1990-12-09,0,0,"phi",-3
"15","Sun","December 16","W","","8-6",TRUE,"Green Bay Packers",31,0,23,422,249,173,0,10,158,103,55,2,1990-12-16,2,1,"phi",31
"16","Sun","December 23","W","","9-6",TRUE,"Dallas Cowboys",17,3,17,276,98,178,3,11,199,125,74,4,1990-12-23,1,1,"phi",14
"17","Sat","December 29","W","","10-6",FALSE,"Phoenix Cardinals",23,21,24,394,220,174,1,18,337,264,73,2,1990-12-29,1,1,"phi",2
"WildCard","Sat","January 5","L","","10-7",TRUE,"Washington Redskins",6,20,16,318,170,148,3,15,299,206,93,2,1991-01-05,-1,0,"phi",-14
"1","Sun","September 1","W","","1-0",FALSE,"Green Bay Packers",20,3,13,318,248,70,3,14,228,184,44,5,1991-09-01,2,1,"phi",17
"2","Sun","September 8","L","","1-1",TRUE,"Phoenix Cardinals",10,26,17,307,229,78,6,10,297,217,80,2,1991-09-08,-4,0,"phi",-16
"3","Sun","September 15","W","","2-1",FALSE,"Dallas Cowboys",24,0,16,262,207,55,1,8,90,45,45,4,1991-09-15,3,1,"phi",24
"4","Sun","September 22","W","","3-1",TRUE,"Pittsburgh Steelers",23,14,20,374,279,95,1,11,226,160,66,1,1991-09-22,0,1,"phi",9
"5","Mon","September 30","L","","3-2",FALSE,"Washington Redskins",0,23,4,89,35,54,3,17,357,184,173,4,1991-09-30,1,0,"phi",-23
"6","Sun","October 6","L","","3-3",FALSE,"Tampa Bay Buccaneers",13,14,12,171,54,117,4,12,193,133,60,6,1991-10-06,2,0,"phi",-1
"7","Sun","October 13","L","","3-4",TRUE,"New Orleans Saints",6,13,11,204,151,53,6,10,162,98,64,2,1991-10-13,-4,0,"phi",-7
"9","Sun","October 27","L","","3-5",TRUE,"San Francisco 49ers",7,23,16,235,206,29,5,14,222,85,137,1,1991-10-27,-4,0,"phi",-16
"10","Mon","November 4","W","","4-5",TRUE,"New York Giants",30,7,19,359,222,137,0,9,187,134,53,1,1991-11-04,1,1,"phi",23
"11","Sun","November 10","W","","5-5",FALSE,"Cleveland Browns",32,30,24,418,321,97,1,16,258,233,25,2,1991-11-10,1,1,"phi",2
"12","Sun","November 17","W","","6-5",TRUE,"Cincinnati Bengals",17,10,17,265,195,70,2,17,198,124,74,4,1991-11-17,2,1,"phi",7
"13","Sun","November 24","W","","7-5",FALSE,"Phoenix Cardinals",34,14,16,289,154,135,3,14,236,168,68,7,1991-11-24,4,1,"phi",20
"14","Mon","December 2","W","","8-5",FALSE,"Houston Oilers",13,6,14,240,146,94,1,15,247,226,21,5,1991-12-02,4,1,"phi",7
"15","Sun","December 8","W","","9-5",FALSE,"New York Giants",19,14,20,324,173,151,2,10,151,84,67,3,1991-12-08,1,1,"phi",5
"16","Sun","December 15","L","","9-6",TRUE,"Dallas Cowboys",13,25,16,240,129,111,2,11,210,138,72,0,1991-12-15,-2,0,"phi",-12
"17","Sun","December 22","W","","10-6",TRUE,"Washington Redskins",24,22,14,207,157,50,3,18,287,200,87,1,1991-12-22,-2,1,"phi",2
"1","Sun","September 6","W","","1-0",TRUE,"New Orleans Saints",15,13,21,320,136,184,4,8,202,147,55,2,1992-09-06,-2,1,"phi",2
"2","Sun","September 13","W","","2-0",FALSE,"Phoenix Cardinals",31,14,21,365,235,130,2,14,239,185,54,1,1992-09-13,-1,1,"phi",17
"3","Sun","September 20","W","","3-0",TRUE,"Denver Broncos",30,0,20,388,258,130,0,4,82,30,52,1,1992-09-20,1,1,"phi",30
"5","Mon","October 5","W","","4-0",TRUE,"Dallas Cowboys",31,7,21,266,106,160,1,17,311,231,80,4,1992-10-05,3,1,"phi",24
"6","Sun","October 11","L","","4-1",FALSE,"Kansas City Chiefs",17,24,18,313,129,184,3,11,316,254,62,1,1992-10-11,-2,0,"phi",-7
"7","Sun","October 18","L","","4-2",FALSE,"Washington Redskins",12,16,19,286,171,115,2,16,320,222,98,1,1992-10-18,-1,0,"phi",-4
"8","Sun","October 25","W","","5-2",TRUE,"Phoenix Cardinals",7,3,11,247,84,163,1,13,253,158,95,4,1992-10-25,3,1,"phi",4
"9","Sun","November 1","L","","5-3",FALSE,"Dallas Cowboys",10,20,10,190,117,73,2,22,389,214,175,2,1992-11-01,0,0,"phi",-10
"10","Sun","November 8","W","","6-3",TRUE,"Los Angeles Raiders",31,10,16,267,139,128,1,14,215,125,90,5,1992-11-08,4,1,"phi",21
"11","Sun","November 15","L","","6-4",FALSE,"Green Bay Packers",24,27,17,272,153,119,2,24,410,266,144,3,1992-11-15,1,0,"phi",-3
"12","Sun","November 22","W","","7-4",FALSE,"New York Giants",47,34,17,365,181,184,4,23,345,251,94,4,1992-11-22,0,1,"phi",13
"13","Sun","November 29","L","","7-5",FALSE,"San Francisco 49ers",14,20,18,280,234,46,0,18,425,329,96,0,1992-11-29,0,0,"phi",-6
"14","Sun","December 6","W","","8-5",TRUE,"Minnesota Vikings",28,17,26,360,135,225,2,15,219,81,138,1,1992-12-06,-1,1,"phi",11
"15","Sun","December 13","W","OT","9-5",FALSE,"Seattle Seahawks",20,17,25,466,276,190,2,11,87,24,63,2,1992-12-13,0,1,"phi",3
"16","Sun","December 20","W","","10-5",TRUE,"Washington Redskins",17,13,16,299,140,159,1,19,364,246,118,3,1992-12-20,2,1,"phi",4
"17","Sun","December 27","W","","11-5",TRUE,"New York Giants",20,10,16,296,98,198,1,13,235,168,67,3,1992-12-27,2,1,"phi",10
"WildCard","Sun","January 3","W","","12-5",FALSE,"New Orleans Saints",36,20,19,349,213,136,1,20,360,284,76,4,1993-01-03,3,1,"phi",16
"Division","Sun","January 10","L","","12-6",FALSE,"Dallas Cowboys",10,34,12,178,115,63,2,22,346,186,160,1,1993-01-10,-1,0,"phi",-24
"1","Sun","September 5","W","","1-0",TRUE,"Phoenix Cardinals",23,17,22,359,192,167,3,14,231,183,48,2,1993-09-05,-1,1,"phi",6
"2","Sun","September 12","W","","2-0",FALSE,"Green Bay Packers",20,17,23,352,191,161,4,10,159,107,52,2,1993-09-12,-2,1,"phi",3
"3","Sun","September 19","W","","3-0",TRUE,"Washington Redskins",34,31,20,438,345,93,4,19,377,210,167,2,1993-09-19,-2,1,"phi",3
"5","Sun","October 3","W","","4-0",FALSE,"New York Jets",35,30,18,303,191,112,2,19,412,297,115,3,1993-10-03,1,1,"phi",5
"6","Sun","October 10","L","","4-1",TRUE,"Chicago Bears",6,17,14,276,166,110,4,15,261,159,102,2,1993-10-10,-2,0,"phi",-11
"7","Sun","October 17","L","","4-2",FALSE,"New York Giants",10,21,19,299,209,90,3,18,347,137,210,2,1993-10-17,-1,0,"phi",-11
"9","Sun","October 31","L","","4-3",TRUE,"Dallas Cowboys",10,23,16,228,89,139,1,19,356,85,271,0,1993-10-31,-1,0,"phi",-13
"10","Sun","November 7","L","","4-4",FALSE,"Phoenix Cardinals",3,16,12,201,136,65,1,21,359,116,243,1,1993-11-07,0,0,"phi",-13
"11","Sun","November 14","L","","4-5",TRUE,"Miami Dolphins",14,19,19,260,157,103,3,13,298,178,120,2,1993-11-14,-1,0,"phi",-5
"12","Sun","November 21","L","","4-6",TRUE,"New York Giants",3,7,13,228,99,129,1,14,292,165,127,2,1993-11-21,1,0,"phi",-4
"13","Sun","November 28","W","","5-6",FALSE,"Washington Redskins",17,14,19,268,164,104,0,19,349,252,97,3,1993-11-28,3,1,"phi",3
"14","Mon","December 6","L","","5-7",FALSE,"Dallas Cowboys",17,23,21,307,248,59,1,17,347,165,182,1,1993-12-06,0,0,"phi",-6
"15","Sun","December 12","L","","5-8",TRUE,"Buffalo Bills",7,10,21,368,298,70,4,19,335,234,101,4,1993-12-12,0,0,"phi",-3
"16","Sun","December 19","W","","6-8",FALSE,"Indianapolis Colts",20,10,23,340,189,151,1,16,261,230,31,3,1993-12-19,2,1,"phi",10
"17","Sun","December 26","W","","7-8",TRUE,"New Orleans Saints",37,26,20,314,180,134,1,7,158,75,83,3,1993-12-26,2,1,"phi",11
"18","Mon","January 3","W","OT","8-8",FALSE,"San Francisco 49ers",37,34,23,381,307,74,1,31,477,346,131,3,1994-01-03,2,1,"phi",3
"1","Sun","September 4","L","","0-1",FALSE,"New York Giants",23,28,20,395,317,78,1,15,290,149,141,2,1994-09-04,1,0,"phi",-5
"2","Mon","September 12","W","","1-1",TRUE,"Chicago Bears",30,22,24,416,311,105,0,13,312,275,37,1,1994-09-12,1,1,"phi",8
"3","Sun","September 18","W","","2-1",TRUE,"Green Bay Packers",13,7,20,273,182,91,2,13,275,238,37,3,1994-09-18,1,1,"phi",6
"5","Sun","October 2","W","","3-1",FALSE,"San Francisco 49ers",40,8,26,437,246,191,0,11,189,129,60,3,1994-10-02,3,1,"phi",32
"6","Sun","October 9","W","","4-1",TRUE,"Washington Redskins",21,17,26,431,238,193,2,12,226,171,55,2,1994-10-09,0,1,"phi",4
"7","Sun","October 16","L","","4-2",FALSE,"Dallas Cowboys",13,24,18,294,170,124,5,19,266,153,113,1,1994-10-16,-4,0,"phi",-11
"8","Mon","October 24","W","","5-2",TRUE,"Houston Oilers",21,6,14,372,287,85,2,15,282,214,68,4,1994-10-24,2,1,"phi",15
"9","Sun","October 30","W","","6-2",FALSE,"Washington Redskins",31,29,19,296,165,131,0,20,349,181,168,3,1994-10-30,3,1,"phi",2
"10","Sun","November 6","W","","7-2",TRUE,"Arizona Cardinals",17,7,18,322,172,150,1,21,254,181,73,2,1994-11-06,1,1,"phi",10
"11","Sun","November 13","L","","7-3",TRUE,"Cleveland Browns",7,26,15,288,176,112,2,18,298,158,140,1,1994-11-13,-1,0,"phi",-19
"12","Sun","November 20","L","","7-4",FALSE,"Arizona Cardinals",6,12,14,185,110,75,2,16,281,123,158,1,1994-11-20,-1,0,"phi",-6
"13","Sun","November 27","L","","7-5",FALSE,"Atlanta Falcons",21,28,14,318,203,115,2,24,418,354,64,3,1994-11-27,1,0,"phi",-7
"14","Sun","December 4","L","","7-6",TRUE,"Dallas Cowboys",19,31,25,393,285,108,1,15,264,160,104,1,1994-12-04,0,0,"phi",-12
"15","Sun","December 11","L","","7-7",FALSE,"Pittsburgh Steelers",3,14,9,105,34,71,1,20,269,145,124,2,1994-12-11,1,0,"phi",-11
"16","Sun","December 18","L","","7-8",TRUE,"New York Giants",13,16,12,222,171,51,2,20,352,230,122,2,1994-12-18,0,0,"phi",-3
"17","Sat","December 24","L","","7-9",FALSE,"Cincinnati Bengals",30,33,19,378,297,81,3,23,385,233,152,4,1994-12-24,1,0,"phi",-3
"1","Sun","September 3","L","","0-1",TRUE,"Tampa Bay Buccaneers",6,21,20,273,162,111,2,15,285,202,83,1,1995-09-03,-1,0,"phi",-15
"2","Sun","September 10","W","","1-1",FALSE,"Arizona Cardinals",31,19,19,338,170,168,1,17,274,244,30,2,1995-09-10,1,1,"phi",12
"3","Sun","September 17","L","","1-2",TRUE,"San Diego Chargers",21,27,18,319,181,138,2,11,270,139,131,1,1995-09-17,-1,0,"phi",-6
"4","Sun","September 24","L","","1-3",FALSE,"Oakland Raiders",17,48,17,236,129,107,5,28,439,331,108,4,1995-09-24,-1,0,"phi",-31
"5","Sun","October 1","W","","2-3",FALSE,"New Orleans Saints",15,10,20,302,147,155,1,9,200,81,119,1,1995-10-01,0,1,"phi",5
"6","Sun","October 8","W","OT","3-3",TRUE,"Washington Redskins",37,34,30,524,252,272,4,19,291,226,65,2,1995-10-08,-2,1,"phi",3
"7","Sun","October 15","W","","4-3",FALSE,"New York Giants",17,14,14,219,66,153,4,15,196,112,84,4,1995-10-15,0,1,"phi",3
"9","Sun","October 29","W","","5-3",TRUE,"St. Louis Rams",20,9,15,274,160,114,1,24,328,224,104,4,1995-10-29,3,1,"phi",11
"10","Mon","November 6","L","","5-4",FALSE,"Dallas Cowboys",12,34,14,230,120,110,2,22,366,202,164,2,1995-11-06,0,0,"phi",-22
"11","Sun","November 12","W","","6-4",TRUE,"Denver Broncos",31,13,25,381,256,125,0,15,280,148,132,1,1995-11-12,1,1,"phi",18
"12","Sun","November 19","W","","7-4",TRUE,"New York Giants",28,19,20,330,179,151,3,15,223,118,105,4,1995-11-19,1,1,"phi",9
"13","Sun","November 26","W","","8-4",FALSE,"Washington Redskins",14,7,19,316,137,179,1,15,300,153,147,2,1995-11-26,1,1,"phi",7
"14","Sun","December 3","L","","8-5",FALSE,"Seattle Seahawks",14,26,17,269,200,69,1,20,316,149,167,0,1995-12-03,-1,0,"phi",-12
"15","Sun","December 10","W","","9-5",TRUE,"Dallas Cowboys",20,17,19,311,162,149,2,15,196,87,109,1,1995-12-10,-1,1,"phi",3
"16","Sun","December 17","W","","10-5",TRUE,"Arizona Cardinals",21,20,11,274,198,76,4,18,324,231,93,5,1995-12-17,1,1,"phi",1
"17","Sun","December 24","L","","10-6",FALSE,"Chicago Bears",14,20,12,211,167,44,3,23,350,169,181,4,1995-12-24,1,0,"phi",-6
"WildCard","Sat","December 30","W","","11-6",TRUE,"Detroit Lions",58,37,22,452,263,189,1,26,422,350,72,7,1995-12-30,6,1,"phi",21
"Division","Sun","January 7","L","","11-7",FALSE,"Dallas Cowboys",11,30,13,227,153,74,1,21,397,244,153,1,1996-01-07,0,0,"phi",-19
"1","Sun","September 1","W","","1-0",FALSE,"Washington Redskins",17,14,23,402,258,144,3,11,220,93,127,0,1996-09-01,-3,1,"phi",3
"2","Mon","September 9","L","","1-1",FALSE,"Green Bay Packers",13,39,14,259,200,59,4,23,432,261,171,0,1996-09-09,-4,0,"phi",-26
"3","Sun","September 15","W","","2-1",TRUE,"Detroit Lions",24,17,25,446,271,175,0,17,233,173,60,1,1996-09-15,1,1,"phi",7
"4","Sun","September 22","W","","3-1",FALSE,"Atlanta Falcons",33,18,14,318,195,123,1,18,391,351,40,6,1996-09-22,5,1,"phi",15
"5","Mon","September 30","L","","3-2",TRUE,"Dallas Cowboys",19,23,14,259,174,85,5,15,239,131,108,2,1996-09-30,-3,0,"phi",-4
"7","Sun","October 13","W","","4-2",FALSE,"New York Giants",19,10,17,304,164,140,0,9,150,63,87,2,1996-10-13,2,1,"phi",9
"8","Sun","October 20","W","","5-2",TRUE,"Miami Dolphins",35,28,21,419,223,196,1,18,347,254,93,1,1996-10-20,0,1,"phi",7
"9","Sun","October 27","W","","6-2",TRUE,"Carolina Panthers",20,9,16,359,329,30,1,10,300,239,61,2,1996-10-27,1,1,"phi",11
"10","Sun","November 3","W","","7-2",FALSE,"Dallas Cowboys",31,21,22,347,217,130,0,22,296,179,117,2,1996-11-03,2,1,"phi",10
"11","Sun","November 10","L","","7-3",TRUE,"Buffalo Bills",17,24,25,385,274,111,1,18,252,112,140,2,1996-11-10,1,0,"phi",-7
"12","Sun","November 17","L","","7-4",TRUE,"Washington Redskins",21,26,27,364,235,129,2,19,300,205,95,1,1996-11-17,-1,0,"phi",-5
"13","Sun","November 24","L","","7-5",FALSE,"Arizona Cardinals",30,36,22,359,292,67,2,27,447,340,107,1,1996-11-24,-1,0,"phi",-6
"14","Sun","December 1","W","","8-5",TRUE,"New York Giants",24,0,24,410,271,139,3,9,121,37,84,4,1996-12-01,1,1,"phi",24
"15","Thu","December 5","L","","8-6",FALSE,"Indianapolis Colts",10,37,18,330,254,76,3,19,361,210,151,0,1996-12-05,-3,0,"phi",-27
"16","Sat","December 14","W","","9-6",FALSE,"New York Jets",21,20,15,323,172,151,4,14,244,173,71,5,1996-12-14,1,1,"phi",1
"17","Sun","December 22","W","","10-6",TRUE,"Arizona Cardinals",29,19,22,343,216,127,2,15,229,158,71,2,1996-12-22,0,1,"phi",10
"WildCard","Sun","December 29","L","","10-7",FALSE,"San Francisco 49ers",0,14,16,283,212,71,3,17,279,161,118,0,1996-12-29,-3,0,"phi",-14
"1","Sun","August 31","L","","0-1",FALSE,"New York Giants",17,31,24,447,327,120,2,12,290,189,101,0,1997-08-31,-2,0,"phi",-14
"2","Sun","September 7","W","","1-1",TRUE,"Green Bay Packers",10,9,16,258,158,100,1,21,380,273,107,2,1997-09-07,1,1,"phi",1
"3","Mon","September 15","L","","1-2",FALSE,"Dallas Cowboys",20,21,16,333,176,157,0,18,279,187,92,2,1997-09-15,2,0,"phi",-1
"5","Sun","September 28","L","","1-3",FALSE,"Minnesota Vikings",19,28,25,372,272,100,3,17,365,221,144,1,1997-09-28,-2,0,"phi",-9
"6","Sun","October 5","W","","2-3",TRUE,"Washington Redskins",24,10,26,449,246,203,1,12,228,198,30,1,1997-10-05,0,1,"phi",14
"7","Sun","October 12","L","","2-4",FALSE,"Jacksonville Jaguars",21,38,23,393,303,90,2,21,306,157,149,1,1997-10-12,-1,0,"phi",-17
"8","Sun","October 19","W","OT","3-4",TRUE,"Arizona Cardinals",13,10,25,407,277,130,4,15,235,143,92,1,1997-10-19,-3,1,"phi",3
"9","Sun","October 26","W","","4-4",TRUE,"Dallas Cowboys",13,12,17,274,120,154,0,14,244,93,151,0,1997-10-26,0,1,"phi",1
"10","Sun","November 2","L","","4-5",FALSE,"Arizona Cardinals",21,31,18,360,265,95,4,17,231,141,90,2,1997-11-02,-2,0,"phi",-10
"11","Mon","November 10","L","","4-6",TRUE,"San Francisco 49ers",12,24,18,257,188,69,3,13,213,96,117,1,1997-11-10,-2,0,"phi",-12
"12","Sun","November 16","T","OT","4-6-1",FALSE,"Baltimore Ravens",10,10,18,273,210,63,1,19,329,125,204,2,1997-11-16,1,0,"phi",0
"13","Sun","November 23","W","","5-6-1",TRUE,"Pittsburgh Steelers",23,20,19,326,229,97,0,22,383,272,111,5,1997-11-23,5,1,"phi",3
"14","Sun","November 30","W","","6-6-1",TRUE,"Cincinnati Bengals",44,42,27,507,311,196,2,29,497,373,124,3,1997-11-30,1,1,"phi",2
"15","Sun","December 7","L","","6-7-1",TRUE,"New York Giants",21,31,15,256,186,70,5,18,345,137,208,2,1997-12-07,-3,0,"phi",-10
"16","Sun","December 14","L","","6-8-1",FALSE,"Atlanta Falcons",17,20,15,277,171,106,1,21,386,175,211,1,1997-12-14,0,0,"phi",-3
"17","Sun","December 21","L","","6-9-1",FALSE,"Washington Redskins",32,35,24,401,208,193,3,17,221,143,78,2,1997-12-21,-1,0,"phi",-3
"1","Sun","September 6","L","","0-1",TRUE,"Seattle Seahawks",0,38,14,174,12,162,3,18,406,218,188,0,1998-09-06,-3,0,"phi",-38
"2","Sun","September 13","L","","0-2",FALSE,"Atlanta Falcons",12,17,19,284,221,63,0,17,245,167,78,0,1998-09-13,0,0,"phi",-5
"3","Sun","September 20","L","","0-3",FALSE,"Arizona Cardinals",3,17,20,317,226,91,3,16,282,129,153,1,1998-09-20,-2,0,"phi",-14
"4","Sun","September 27","L","","0-4",TRUE,"Kansas City Chiefs",21,24,24,361,250,111,1,24,393,262,131,0,1998-09-27,-1,0,"phi",-3
"5","Sun","October 4","L","","0-5",FALSE,"Denver Broncos",16,41,12,157,100,57,2,22,423,192,231,2,1998-10-04,0,0,"phi",-25
"6","Sun","October 11","W","","1-5",TRUE,"Washington Redskins",17,12,14,198,83,115,1,17,278,150,128,3,1998-10-11,2,1,"phi",5
"7","Sun","October 18","L","","1-6",FALSE,"San Diego Chargers",10,13,21,261,210,51,4,11,168,28,140,1,1998-10-18,-3,0,"phi",-3
"9","Mon","November 2","L","","1-7",TRUE,"Dallas Cowboys",0,34,15,200,104,96,3,20,294,173,121,0,1998-11-02,-3,0,"phi",-34
"10","Sun","November 8","W","","2-7",TRUE,"Detroit Lions",10,9,16,289,73,216,0,9,257,111,146,0,1998-11-08,0,1,"phi",1
"11","Sun","November 15","L","","2-8",FALSE,"Washington Redskins",3,28,9,215,110,105,3,16,289,138,151,1,1998-11-15,-2,0,"phi",-25
"12","Sun","November 22","L","","2-9",FALSE,"New York Giants",0,20,16,214,97,117,2,15,261,138,123,1,1998-11-22,-1,0,"phi",-20
"13","Sun","November 29","L","","2-10",FALSE,"Green Bay Packers",16,24,15,232,167,65,0,26,499,321,178,3,1998-11-29,3,0,"phi",-8
"14","Thu","December 3","W","","3-10",TRUE,"St. Louis Rams",17,14,16,299,169,130,1,17,330,248,82,1,1998-12-03,0,1,"phi",3
"15","Sun","December 13","L","OT","3-11",TRUE,"Arizona Cardinals",17,20,21,367,219,148,1,25,424,220,204,2,1998-12-13,1,0,"phi",-3
"16","Sun","December 20","L","","3-12",FALSE,"Dallas Cowboys",9,13,15,356,231,125,1,11,248,95,153,2,1998-12-20,1,0,"phi",-4
"17","Sun","December 27","L","","3-13",TRUE,"New York Giants",10,20,12,264,141,123,1,22,339,130,209,0,1998-12-27,-1,0,"phi",-10
"1","Sun","September 12","L","","0-1",TRUE,"Arizona Cardinals",24,25,13,205,67,138,4,23,344,266,78,4,1999-09-12,0,0,"phi",-1
"2","Sun","September 19","L","","0-2",TRUE,"Tampa Bay Buccaneers",5,19,9,150,66,84,1,16,220,64,156,2,1999-09-19,1,0,"phi",-14
"3","Sun","September 26","L","","0-3",FALSE,"Buffalo Bills",0,26,11,169,147,22,2,25,377,186,191,1,1999-09-26,-1,0,"phi",-26
"4","Sun","October 3","L","","0-4",FALSE,"New York Giants",15,16,10,174,90,84,3,24,361,233,128,5,1999-10-03,2,0,"phi",-1
"5","Sun","October 10","W","","1-4",TRUE,"Dallas Cowboys",13,10,12,244,139,105,1,19,300,170,130,3,1999-10-10,2,1,"phi",3
"6","Sun","October 17","W","","2-4",FALSE,"Chicago Bears",20,16,19,316,217,99,2,17,352,239,113,2,1999-10-17,0,1,"phi",4
"7","Sun","October 24","L","","2-5",FALSE,"Miami Dolphins",13,16,11,182,89,93,2,15,283,134,149,2,1999-10-24,0,0,"phi",-3
"8","Sun","October 31","L","OT","2-6",TRUE,"New York Giants",17,23,15,360,248,112,3,20,299,207,92,0,1999-10-31,-3,0,"phi",-6
"9","Sun","November 7","L","","2-7",FALSE,"Carolina Panthers",7,33,17,249,81,168,5,24,381,270,111,0,1999-11-07,-5,0,"phi",-26
"10","Sun","November 14","W","","3-7",TRUE,"Washington Redskins",35,28,16,236,38,198,1,22,424,294,130,6,1999-11-14,5,1,"phi",7
"11","Sun","November 21","L","","3-8",TRUE,"Indianapolis Colts",17,44,13,212,118,94,5,22,455,255,200,3,1999-11-21,-2,0,"phi",-27
"12","Sun","November 28","L","OT","3-9",FALSE,"Washington Redskins",17,20,16,299,156,143,0,23,312,218,94,1,1999-11-28,1,0,"phi",-3
"13","Sun","December 5","L","","3-10",FALSE,"Arizona Cardinals",17,21,18,294,148,146,2,16,227,173,54,2,1999-12-05,0,0,"phi",-4
"14","Sun","December 12","L","","3-11",FALSE,"Dallas Cowboys",10,20,14,238,143,95,3,22,337,225,112,1,1999-12-12,-2,0,"phi",-10
"15","Sun","December 19","W","","4-11",TRUE,"New England Patriots",24,9,11,295,181,114,3,20,350,288,62,7,1999-12-19,4,1,"phi",15
"17","Sun","January 2","W","","5-11",TRUE,"St. Louis Rams",38,31,13,207,156,51,2,20,440,239,201,7,2000-01-02,5,1,"phi",7
"1","Sun","September 3","W","","1-0",FALSE,"Dallas Cowboys",41,14,27,425,119,306,3,10,167,100,67,2,2000-09-03,-1,1,"phi",27
"2","Sun","September 10","L","","1-1",TRUE,"New York Giants",18,33,13,237,181,56,0,24,387,220,167,0,2000-09-10,0,0,"phi",-15
"3","Sun","September 17","L","","1-2",FALSE,"Green Bay Packers",3,6,12,171,86,85,1,19,236,157,79,4,2000-09-17,3,0,"phi",-3
"4","Sun","September 24","W","","2-2",FALSE,"New Orleans Saints",21,7,14,268,201,67,2,17,287,141,146,4,2000-09-24,2,1,"phi",14
"5","Sun","October 1","W","","3-2",TRUE,"Atlanta Falcons",38,10,22,502,307,195,3,13,200,139,61,1,2000-10-01,-2,1,"phi",28
"6","Sun","October 8","L","","3-3",TRUE,"Washington Redskins",14,17,16,274,199,75,4,23,407,266,141,2,2000-10-08,-2,0,"phi",-3
"7","Sun","October 15","W","","4-3",FALSE,"Arizona Cardinals",33,14,28,391,219,172,0,17,305,207,98,3,2000-10-15,3,1,"phi",19
"8","Sun","October 22","W","","5-3",TRUE,"Chicago Bears",13,9,17,298,201,97,2,14,274,160,114,1,2000-10-22,-1,1,"phi",4
"9","Sun","October 29","L","","5-4",FALSE,"New York Giants",7,24,8,192,120,72,1,25,384,232,152,0,2000-10-29,-1,0,"phi",-17
"10","Sun","November 5","W","OT","6-4",TRUE,"Dallas Cowboys",16,13,23,357,228,129,2,16,295,91,204,2,2000-11-05,0,1,"phi",3
"11","Sun","November 12","W","OT","7-4",FALSE,"Pittsburgh Steelers",26,23,21,290,202,88,1,21,322,140,182,1,2000-11-12,0,1,"phi",3
"12","Sun","November 19","W","","8-4",TRUE,"Arizona Cardinals",34,9,21,338,204,134,2,12,210,156,54,1,2000-11-19,-1,1,"phi",25
"13","Sun","November 26","W","","9-4",FALSE,"Washington Redskins",23,20,14,289,118,171,2,20,326,282,44,2,2000-11-26,0,1,"phi",3
"14","Sun","December 3","L","","9-5",TRUE,"Tennessee Titans",13,15,14,262,206,56,0,24,331,213,118,1,2000-12-03,1,0,"phi",-2
"15","Sun","December 10","W","","10-5",FALSE,"Cleveland Browns",35,24,23,391,350,41,2,25,418,317,101,4,2000-12-10,2,1,"phi",11
"17","Sun","December 24","W","","11-5",TRUE,"Cincinnati Bengals",16,7,22,321,183,138,4,15,271,169,102,3,2000-12-24,-1,1,"phi",9
"WildCard","Sun","December 31","W","","12-5",TRUE,"Tampa Bay Buccaneers",21,3,20,277,151,126,1,11,199,149,50,1,2000-12-31,0,1,"phi",18
"Division","Sun","January 7","L","","12-6",FALSE,"New York Giants",10,20,11,186,140,46,3,15,237,125,112,3,2001-01-07,0,0,"phi",-10
"1","Sun","September 9","L","OT","0-1",TRUE,"St. Louis Rams",17,20,19,334,277,57,3,22,364,282,82,2,2001-09-09,-1,0,"phi",-3
"2","Sun","September 23","W","","1-1",FALSE,"Seattle Seahawks",27,3,18,344,242,102,1,9,147,21,126,1,2001-09-23,0,1,"phi",24
"3","Sun","September 30","W","","2-1",TRUE,"Dallas Cowboys",40,18,14,276,145,131,3,11,242,61,181,5,2001-09-30,2,1,"phi",22
"4","Sun","October 7","L","","2-2",TRUE,"Arizona Cardinals",20,21,19,440,261,179,2,19,329,232,97,1,2001-10-07,-1,0,"phi",-1
"6","Mon","October 22","W","","3-2",FALSE,"New York Giants",10,9,13,215,124,91,1,16,238,142,96,1,2001-10-22,0,1,"phi",1
"7","Sun","October 28","L","","3-3",TRUE,"Oakland Raiders",10,20,11,195,117,78,0,22,354,152,202,0,2001-10-28,0,0,"phi",-10
"8","Sun","November 4","W","","4-3",FALSE,"Arizona Cardinals",21,7,13,332,219,113,1,20,327,270,57,2,2001-11-04,1,1,"phi",14
"9","Sun","November 11","W","","5-3",TRUE,"Minnesota Vikings",48,17,33,487,215,272,1,16,301,245,56,4,2001-11-11,3,1,"phi",31
"10","Sun","November 18","W","","6-3",FALSE,"Dallas Cowboys",36,3,17,227,129,98,1,11,213,81,132,4,2001-11-18,3,1,"phi",33
"11","Sun","November 25","L","","6-4",TRUE,"Washington Redskins",3,13,7,186,92,94,0,16,240,85,155,0,2001-11-25,0,0,"phi",-10
"12","Thu","November 29","W","","7-4",FALSE,"Kansas City Chiefs",23,10,19,378,251,127,1,18,291,208,83,3,2001-11-29,2,1,"phi",13
"13","Sun","December 9","W","","8-4",TRUE,"San Diego Chargers",24,14,14,273,210,63,1,18,393,297,96,4,2001-12-09,3,1,"phi",10
"14","Sun","December 16","W","","9-4",FALSE,"Washington Redskins",20,6,11,287,224,63,4,16,362,205,157,3,2001-12-16,-1,1,"phi",14
"15","Sat","December 22","L","","9-5",FALSE,"San Francisco 49ers",3,13,12,292,213,79,1,14,244,127,117,0,2001-12-22,-1,0,"phi",-10
"16","Sun","December 30","W","","10-5",TRUE,"New York Giants",24,21,21,361,241,120,2,18,420,291,129,1,2001-12-30,-1,1,"phi",3
"17","Sun","January 6","W","","11-5",FALSE,"Tampa Bay Buccaneers",17,13,15,296,185,111,2,16,236,165,71,2,2002-01-06,0,1,"phi",4
"WildCard","Sat","January 12","W","","12-5",TRUE,"Tampa Bay Buccaneers",31,9,17,334,186,148,1,16,258,195,63,4,2002-01-12,3,1,"phi",22
"Division","Sat","January 19","W","","13-5",FALSE,"Chicago Bears",33,19,19,336,249,87,1,10,184,73,111,4,2002-01-19,3,1,"phi",14
"ConfChamp","Sun","January 27","L","","13-6",FALSE,"St. Louis Rams",24,29,16,256,146,110,2,22,371,210,161,0,2002-01-27,-2,0,"phi",-5
"1","Sun","September 8","L","","0-1",FALSE,"Tennessee Titans",24,27,17,261,181,80,3,22,328,267,61,4,2002-09-08,1,0,"phi",-3
"2","Mon","September 16","W","","1-1",FALSE,"Washington Redskins",37,7,22,451,283,168,0,11,179,90,89,3,2002-09-16,3,1,"phi",30
"3","Sun","September 22","W","","2-1",TRUE,"Dallas Cowboys",44,13,26,447,294,153,2,18,304,183,121,4,2002-09-22,2,1,"phi",31
"4","Sun","September 29","W","","3-1",TRUE,"Houston Texans",35,17,21,391,289,102,3,12,242,151,91,3,2002-09-29,0,1,"phi",18
"5","Sun","October 6","L","","3-2",FALSE,"Jacksonville Jaguars",25,28,28,406,207,199,0,16,267,197,70,0,2002-10-06,0,0,"phi",-3
"7","Sun","October 20","W","","4-2",TRUE,"Tampa Bay Buccaneers",20,10,14,269,110,159,2,15,207,126,81,2,2002-10-20,0,1,"phi",10
"8","Mon","October 28","W","","5-2",TRUE,"New York Giants",17,3,21,422,127,295,0,18,348,245,103,1,2002-10-28,1,1,"phi",14
"9","Sun","November 3","W","","6-2",FALSE,"Chicago Bears",19,13,23,309,192,117,1,18,260,186,74,1,2002-11-03,0,1,"phi",6
"10","Sun","November 10","L","","6-3",TRUE,"Indianapolis Colts",13,35,21,374,269,105,2,18,446,319,127,1,2002-11-10,-1,0,"phi",-22
"11","Sun","November 17","W","","7-3",TRUE,"Arizona Cardinals",38,14,26,462,250,212,2,15,248,124,124,1,2002-11-17,-1,1,"phi",24
"12","Mon","November 25","W","","8-3",FALSE,"San Francisco 49ers",38,17,19,343,236,107,0,24,409,305,104,0,2002-11-25,0,1,"phi",21
"13","Sun","December 1","W","","9-3",TRUE,"St. Louis Rams",10,3,12,265,157,108,4,13,250,174,76,5,2002-12-01,1,1,"phi",7
"14","Sun","December 8","W","","10-3",FALSE,"Seattle Seahawks",27,20,20,316,190,126,1,24,367,195,172,3,2002-12-08,2,1,"phi",7
"15","Sun","December 15","W","","11-3",TRUE,"Washington Redskins",34,21,15,320,210,110,1,16,292,206,86,3,2002-12-15,2,1,"phi",13
"16","Sat","December 21","W","","12-3",FALSE,"Dallas Cowboys",27,3,17,359,245,114,2,9,146,78,68,3,2002-12-21,1,1,"phi",24
"17","Sat","December 28","L","OT","12-4",FALSE,"New York Giants",7,10,9,209,144,65,1,23,461,248,213,4,2002-12-28,3,0,"phi",-3
"Division","Sat","January 11","W","","13-4",TRUE,"Atlanta Falcons",20,6,15,318,227,91,0,19,354,261,93,2,2003-01-11,2,1,"phi",14
"ConfChamp","Sun","January 19","L","","13-5",TRUE,"Tampa Bay Buccaneers",10,27,20,312,232,80,3,15,308,259,49,1,2003-01-19,-2,0,"phi",-17
"1","Mon","September 8","L","","0-1",TRUE,"Tampa Bay Buccaneers",0,17,13,245,124,121,2,19,328,238,90,1,2003-09-08,-1,0,"phi",-17
"2","Sun","September 14","L","","0-2",TRUE,"New England Patriots",10,31,23,268,168,100,6,17,309,247,62,0,2003-09-14,-6,0,"phi",-21
"4","Sun","September 28","W","","1-2",FALSE,"Buffalo Bills",23,13,19,335,159,176,0,15,308,287,21,1,2003-09-28,1,1,"phi",10
"5","Sun","October 5","W","","2-2",TRUE,"Washington Redskins",27,25,18,267,140,127,2,20,307,258,49,2,2003-10-05,0,1,"phi",2
"6","Sun","October 12","L","","2-3",FALSE,"Dallas Cowboys",21,23,14,232,115,117,1,15,292,173,119,1,2003-10-12,0,0,"phi",-2
"7","Sun","October 19","W","","3-3",FALSE,"New York Giants",14,10,9,134,47,87,2,25,339,159,180,2,2003-10-19,0,1,"phi",4
"8","Sun","October 26","W","","4-3",TRUE,"New York Jets",24,17,23,306,112,194,2,22,377,252,125,2,2003-10-26,0,1,"phi",7
"9","Sun","November 2","W","","5-3",FALSE,"Atlanta Falcons",23,16,24,430,302,128,0,17,278,147,131,2,2003-11-02,2,1,"phi",7
"10","Mon","November 10","W","","6-3",FALSE,"Green Bay Packers",17,14,15,282,190,92,0,17,309,68,241,3,2003-11-10,3,1,"phi",3
"11","Sun","November 16","W","","7-3",TRUE,"New York Giants",28,10,20,376,314,62,1,20,361,252,109,1,2003-11-16,0,1,"phi",18
"12","Sun","November 23","W","","8-3",TRUE,"New Orleans Saints",33,20,22,448,247,201,0,27,466,267,199,3,2003-11-23,3,1,"phi",13
"13","Sun","November 30","W","","9-3",FALSE,"Carolina Panthers",25,16,17,283,159,124,2,19,336,200,136,1,2003-11-30,-1,1,"phi",9
"14","Sun","December 7","W","","10-3",TRUE,"Dallas Cowboys",36,10,20,403,228,175,0,13,225,75,150,2,2003-12-07,2,1,"phi",26
"15","Mon","December 15","W","","11-3",FALSE,"Miami Dolphins",34,27,23,401,261,140,1,22,398,221,177,2,2003-12-15,1,1,"phi",7
"16","Sun","December 21","L","OT","11-4",TRUE,"San Francisco 49ers",28,31,18,293,205,88,3,22,414,211,203,1,2003-12-21,-2,0,"phi",-3
"17","Sat","December 27","W","","12-4",FALSE,"Washington Redskins",31,7,24,332,249,83,0,16,260,181,79,2,2003-12-27,2,1,"phi",24
"Division","Sun","January 11","W","OT","13-4",TRUE,"Green Bay Packers",20,17,19,363,199,164,1,16,381,171,210,1,2004-01-11,0,1,"phi",3
"ConfChamp","Sun","January 18","L","","13-5",TRUE,"Carolina Panthers",3,14,18,289,152,137,4,14,256,101,155,0,2004-01-18,-4,0,"phi",-11
"1","Sun","September 12","W","","1-0",TRUE,"New York Giants",31,17,21,454,313,141,0,19,413,243,170,1,2004-09-12,1,1,"phi",14
"2","Mon","September 20","W","","2-0",TRUE,"Minnesota Vikings",27,16,19,317,226,91,1,25,410,332,78,2,2004-09-20,1,1,"phi",11
"3","Sun","September 26","W","","3-0",FALSE,"Detroit Lions",30,13,19,402,343,59,1,15,256,179,77,1,2004-09-26,0,1,"phi",17
"4","Sun","October 3","W","","4-0",FALSE,"Chicago Bears",19,9,24,376,218,158,1,14,224,192,32,1,2004-10-03,0,1,"phi",10
"6","Sun","October 17","W","","5-0",TRUE,"Carolina Panthers",30,8,10,283,202,81,1,21,344,186,158,4,2004-10-17,3,1,"phi",22
"7","Sun","October 24","W","OT","6-0",FALSE,"Cleveland Browns",34,31,23,488,367,121,1,27,394,229,165,3,2004-10-24,2,1,"phi",3
"8","Sun","October 31","W","","7-0",TRUE,"Baltimore Ravens",15,10,19,298,200,98,1,19,327,214,113,2,2004-10-31,1,1,"phi",5
"9","Sun","November 7","L","","7-1",FALSE,"Pittsburgh Steelers",3,27,7,113,90,23,1,25,420,168,252,2,2004-11-07,1,0,"phi",-24
"10","Mon","November 15","W","","8-1",FALSE,"Dallas Cowboys",49,21,20,485,336,149,0,14,317,246,71,3,2004-11-15,3,1,"phi",28
"11","Sun","November 21","W","","9-1",TRUE,"Washington Redskins",28,6,20,333,208,125,2,15,213,162,51,1,2004-11-21,-1,1,"phi",22
"12","Sun","November 28","W","","10-1",FALSE,"New York Giants",27,6,22,390,238,152,1,12,272,111,161,2,2004-11-28,1,1,"phi",21
"13","Sun","December 5","W","","11-1",TRUE,"Green Bay Packers",47,17,29,542,449,93,1,20,249,199,50,2,2004-12-05,1,1,"phi",30
"14","Sun","December 12","W","","12-1",FALSE,"Washington Redskins",17,14,15,312,245,67,2,19,312,224,88,1,2004-12-12,-1,1,"phi",3
"15","Sun","December 19","W","","13-1",TRUE,"Dallas Cowboys",12,7,24,328,208,120,3,14,237,157,80,2,2004-12-19,-1,1,"phi",5
"16","Mon","December 27","L","","13-2",FALSE,"St. Louis Rams",7,20,11,155,74,81,1,24,419,210,209,1,2004-12-27,0,0,"phi",-13
"17","Sun","January 2","L","","13-3",TRUE,"Cincinnati Bengals",10,38,18,342,262,80,5,16,308,160,148,0,2005-01-02,-5,0,"phi",-28
"Division","Sun","January 16","W","","14-3",TRUE,"Minnesota Vikings",27,14,23,395,286,109,1,21,385,288,97,2,2005-01-16,1,1,"phi",13
"ConfChamp","Sun","January 23","W","","15-3",TRUE,"Atlanta Falcons",27,10,22,326,170,156,0,14,202,103,99,1,2005-01-23,1,1,"phi",17
"SuperBowl","Sun","February 6","L","","15-4",TRUE,"New England Patriots",21,24,24,369,324,45,4,21,331,219,112,1,2005-02-06,-3,0,"phi",-3
"1","Mon","September 12","L","","0-1",FALSE,"Atlanta Falcons",10,14,18,301,250,51,3,18,319,119,200,3,2005-09-12,0,0,"phi",-4
"2","Sun","September 18","W","","1-1",TRUE,"San Francisco 49ers",42,3,30,583,443,140,1,8,142,84,58,3,2005-09-18,2,1,"phi",39
"3","Sun","September 25","W","","2-1",TRUE,"Oakland Raiders",23,20,26,448,365,83,2,18,365,344,21,0,2005-09-25,-2,1,"phi",3
"4","Sun","October 2","W","","3-1",FALSE,"Kansas City Chiefs",37,31,25,396,368,28,2,19,353,209,144,4,2005-10-02,2,1,"phi",6
"5","Sun","October 9","L","","3-2",FALSE,"Dallas Cowboys",10,33,6,129,110,19,0,28,456,289,167,1,2005-10-09,1,0,"phi",-23
"7","Sun","October 23","W","","4-2",TRUE,"San Diego Chargers",20,17,22,286,262,24,2,15,291,270,21,3,2005-10-23,1,1,"phi",3
"8","Sun","October 30","L","","4-3",FALSE,"Denver Broncos",21,49,12,351,272,79,2,28,564,309,255,0,2005-10-30,-2,0,"phi",-28
"9","Sun","November 6","L","","4-4",FALSE,"Washington Redskins",10,17,17,336,291,45,1,17,293,215,78,1,2005-11-06,0,0,"phi",-7
"10","Mon","November 14","L","","4-5",TRUE,"Dallas Cowboys",20,21,21,359,178,181,1,13,241,183,58,1,2005-11-14,0,0,"phi",-1
"11","Sun","November 20","L","","4-6",FALSE,"New York Giants",17,27,20,404,298,106,1,17,315,200,115,0,2005-11-20,-1,0,"phi",-10
"12","Sun","November 27","W","","5-6",TRUE,"Green Bay Packers",19,14,15,264,88,176,1,18,292,164,128,5,2005-11-27,4,1,"phi",5
"13","Mon","December 5","L","","5-7",TRUE,"Seattle Seahawks",0,42,11,190,129,61,6,14,194,98,96,0,2005-12-05,-6,0,"phi",-42
"14","Sun","December 11","L","OT","5-8",TRUE,"New York Giants",23,26,17,337,162,175,1,28,437,299,138,3,2005-12-11,2,0,"phi",-3
"15","Sun","December 18","W","","6-8",FALSE,"St. Louis Rams",17,16,13,201,76,125,4,16,305,127,178,1,2005-12-18,-3,1,"phi",1
"16","Sat","December 24","L","","6-9",FALSE,"Arizona Cardinals",21,27,11,189,146,43,1,19,360,285,75,1,2005-12-24,0,0,"phi",-6
"17","Sun","January 1","L","","6-10",TRUE,"Washington Redskins",20,31,18,335,239,96,6,14,279,128,151,1,2006-01-01,-5,0,"phi",-11
"1","Sun","September 10","W","","1-0",FALSE,"Houston Texans",24,10,24,441,311,130,1,19,241,171,70,0,2006-09-10,-1,1,"phi",14
"2","Sun","September 17","L","OT","1-1",TRUE,"New York Giants",24,30,23,451,344,107,1,24,404,318,86,1,2006-09-17,0,0,"phi",-6
"3","Sun","September 24","W","","2-1",FALSE,"San Francisco 49ers",38,24,16,416,266,150,1,23,392,269,123,2,2006-09-24,1,1,"phi",14
"4","Mon","October 2","W","","3-1",TRUE,"Green Bay Packers",31,9,23,398,267,131,2,20,318,219,99,3,2006-10-02,1,1,"phi",22
"5","Sun","October 8","W","","4-1",TRUE,"Dallas Cowboys",38,24,16,383,331,52,2,23,320,174,146,5,2006-10-08,3,1,"phi",14
"6","Sun","October 15","L","","4-2",FALSE,"New Orleans Saints",24,27,20,325,226,99,2,22,373,275,98,2,2006-10-15,0,0,"phi",-3
"7","Sun","October 22","L","","4-3",FALSE,"Tampa Bay Buccaneers",21,23,22,506,298,208,4,14,196,85,111,0,2006-10-22,-4,0,"phi",-2
"8","Sun","October 29","L","","4-4",TRUE,"Jacksonville Jaguars",6,13,14,227,142,85,0,16,285,76,209,1,2006-10-29,1,0,"phi",-7
"10","Sun","November 12","W","","5-4",TRUE,"Washington Redskins",27,3,18,400,255,145,0,16,278,132,146,1,2006-11-12,1,1,"phi",24
"11","Sun","November 19","L","","5-5",TRUE,"Tennessee Titans",13,31,22,390,267,123,3,13,293,84,209,1,2006-11-19,-2,0,"phi",-18
"12","Sun","November 26","L","","5-6",FALSE,"Indianapolis Colts",21,45,20,300,151,149,3,27,420,183,237,1,2006-11-26,-2,0,"phi",-24
"13","Mon","December 4","W","","6-6",TRUE,"Carolina Panthers",27,24,18,402,304,98,0,18,377,269,108,2,2006-12-04,2,1,"phi",3
"14","Sun","December 10","W","","7-6",FALSE,"Washington Redskins",21,19,14,263,164,99,1,20,415,205,210,2,2006-12-10,1,1,"phi",2
"15","Sun","December 17","W","","8-6",FALSE,"New York Giants",36,22,21,382,221,161,2,22,358,270,88,4,2006-12-17,2,1,"phi",14
"16","Mon","December 25","W","","9-6",FALSE,"Dallas Cowboys",23,7,20,426,222,204,1,16,201,118,83,3,2006-12-25,2,1,"phi",16
"17","Sun","December 31","W","","10-6",TRUE,"Atlanta Falcons",24,17,21,393,350,43,1,21,378,219,159,1,2006-12-31,0,1,"phi",7
"WildCard","Sun","January 7","W","","11-6",TRUE,"New York Giants",23,20,19,323,138,185,0,17,305,154,151,1,2007-01-07,1,1,"phi",3
"Division","Sat","January 13","L","","11-7",FALSE,"New Orleans Saints",24,27,14,355,232,123,0,27,435,227,208,1,2007-01-13,1,0,"phi",-3
"1","Sun","September 9","L","","0-1",FALSE,"Green Bay Packers",13,16,13,283,180,103,3,10,215,169,46,2,2007-09-09,-1,0,"phi",-3
"2","Mon","September 17","L","","0-2",TRUE,"Washington Redskins",12,20,18,340,226,114,0,19,337,207,130,1,2007-09-17,1,0,"phi",-8
"3","Sun","September 23","W","","1-2",TRUE,"Detroit Lions",56,21,29,536,363,173,2,20,432,393,39,3,2007-09-23,1,1,"phi",35
"4","Sun","September 30","L","","1-3",FALSE,"New York Giants",3,16,16,190,76,114,1,16,212,129,83,1,2007-09-30,0,0,"phi",-13
"6","Sun","October 14","W","","2-3",FALSE,"New York Jets",16,9,20,413,262,151,1,15,267,109,158,1,2007-10-14,0,1,"phi",7
"7","Sun","October 21","L","","2-4",TRUE,"Chicago Bears",16,19,21,334,211,123,0,19,386,314,72,0,2007-10-21,0,0,"phi",-3
"8","Sun","October 28","W","","3-4",FALSE,"Minnesota Vikings",23,16,22,385,323,62,0,20,256,151,105,0,2007-10-28,0,1,"phi",7
"9","Sun","November 4","L","","3-5",TRUE,"Dallas Cowboys",17,38,21,316,250,66,3,24,434,324,110,1,2007-11-04,-2,0,"phi",-21
"10","Sun","November 11","W","","4-5",FALSE,"Washington Redskins",33,25,22,379,240,139,2,25,361,203,158,2,2007-11-11,0,1,"phi",8
"11","Sun","November 18","W","","5-5",TRUE,"Miami Dolphins",17,7,20,352,150,202,3,9,186,109,77,0,2007-11-18,-3,1,"phi",10
"12","Sun","November 25","L","","5-6",FALSE,"New England Patriots",28,31,22,391,336,55,3,25,410,362,48,0,2007-11-25,-3,0,"phi",-3
"13","Sun","December 2","L","","5-7",TRUE,"Seattle Seahawks",24,28,17,363,219,144,4,16,311,176,135,2,2007-12-02,-2,0,"phi",-4
"14","Sun","December 9","L","","5-8",TRUE,"New York Giants",13,16,18,306,165,141,1,15,318,207,111,2,2007-12-09,1,0,"phi",-3
"15","Sun","December 16","W","","6-8",FALSE,"Dallas Cowboys",10,6,20,315,181,134,1,11,240,187,53,3,2007-12-16,2,1,"phi",4
"16","Sun","December 23","W","","7-8",FALSE,"New Orleans Saints",38,23,24,435,251,184,1,22,346,276,70,1,2007-12-23,0,1,"phi",15
"17","Sun","December 30","W","","8-8",TRUE,"Buffalo Bills",17,9,20,391,322,69,2,13,271,133,138,0,2007-12-30,-2,1,"phi",8
"1","Sun","September 7","W","","1-0",TRUE,"St. Louis Rams",38,3,28,522,414,108,0,8,166,130,36,0,2008-09-07,0,1,"phi",35
"2","Mon","September 15","L","","1-1",FALSE,"Dallas Cowboys",37,41,23,337,259,78,1,20,380,312,68,2,2008-09-15,1,0,"phi",-4
"3","Sun","September 21","W","","2-1",TRUE,"Pittsburgh Steelers",15,6,16,260,195,65,3,14,181,147,34,3,2008-09-21,0,1,"phi",9
"4","Sun","September 28","L","","2-2",FALSE,"Chicago Bears",20,24,18,340,237,103,2,13,256,178,78,4,2008-09-28,2,0,"phi",-4
"5","Sun","October 5","L","","2-3",TRUE,"Washington Redskins",17,23,14,254,196,58,0,22,388,185,203,0,2008-10-05,0,0,"phi",-6
"6","Sun","October 12","W","","3-3",FALSE,"San Francisco 49ers",40,26,21,383,280,103,1,14,306,175,131,3,2008-10-12,2,1,"phi",14
"8","Sun","October 26","W","","4-3",TRUE,"Atlanta Falcons",27,14,24,432,240,192,1,19,335,258,77,3,2008-10-26,2,1,"phi",13
"9","Sun","November 2","W","","5-3",FALSE,"Seattle Seahawks",26,7,20,419,347,72,1,10,233,147,86,0,2008-11-02,-1,1,"phi",19
"10","Sun","November 9","L","","5-4",TRUE,"New York Giants",31,36,17,300,194,106,2,26,401,182,219,2,2008-11-09,0,0,"phi",-5
"11","Sun","November 16","T","OT","5-4-1",FALSE,"Cincinnati Bengals",13,13,16,391,323,68,4,19,282,226,56,1,2008-11-16,-3,0,"phi",0
"12","Sun","November 23","L","","5-5-1",FALSE,"Baltimore Ravens",7,36,13,206,120,86,5,14,248,138,110,0,2008-11-23,-5,0,"phi",-29
"13","Thu","November 27","W","","6-5-1",TRUE,"Arizona Cardinals",48,20,32,437,252,185,1,12,260,235,25,4,2008-11-27,3,1,"phi",28
"14","Sun","December 7","W","","7-5-1",FALSE,"New York Giants",20,14,24,331,191,140,0,14,211,123,88,0,2008-12-07,0,1,"phi",6
"15","Mon","December 15","W","","8-5-1",TRUE,"Cleveland Browns",30,10,21,418,284,134,3,11,196,139,57,2,2008-12-15,-1,1,"phi",20
"16","Sun","December 21","L","","8-6-1",FALSE,"Washington Redskins",3,10,15,275,213,62,1,17,249,127,122,0,2008-12-21,-1,0,"phi",-7
"17","Sun","December 28","W","","9-6-1",TRUE,"Dallas Cowboys",44,6,16,303,166,137,1,15,298,211,87,5,2008-12-28,4,1,"phi",38
"WildCard","Sun","January 4","W","","10-6-1",FALSE,"Minnesota Vikings",26,14,15,350,283,67,2,16,301,153,148,2,2009-01-04,0,1,"phi",12
"Division","Sun","January 11","W","","11-6-1",FALSE,"New York Giants",23,11,20,276,217,59,2,16,307,169,138,3,2009-01-11,1,1,"phi",12
"ConfChamp","Sun","January 18","L","","11-7-1",FALSE,"Arizona Cardinals",25,32,22,454,357,97,3,21,369,267,102,1,2009-01-18,-2,0,"phi",-7
"1","Sun","September 13","W","","1-0",FALSE,"Carolina Panthers",38,10,17,267,82,185,2,14,169,83,86,7,2009-09-13,5,1,"phi",28
"2","Sun","September 20","L","","1-1",TRUE,"New Orleans Saints",22,48,23,463,384,79,4,23,421,288,133,1,2009-09-20,-3,0,"phi",-26
"3","Sun","September 27","W","","2-1",TRUE,"Kansas City Chiefs",34,14,21,420,327,93,1,11,196,97,99,1,2009-09-27,0,1,"phi",20
"5","Sun","October 11","W","","3-1",TRUE,"Tampa Bay Buccaneers",33,14,16,325,249,76,0,22,303,218,85,3,2009-10-11,3,1,"phi",19
"6","Sun","October 18","L","","3-2",FALSE,"Oakland Raiders",9,13,14,283,216,67,0,18,325,209,116,2,2009-10-18,2,0,"phi",-4
"7","Mon","October 26","W","","4-2",FALSE,"Washington Redskins",27,17,11,262,140,122,0,21,308,246,62,4,2009-10-26,4,1,"phi",10
"8","Sun","November 1","W","","5-2",TRUE,"New York Giants",40,17,17,391,211,180,2,21,356,215,141,3,2009-11-01,1,1,"phi",23
"9","Sun","November 8","L","","5-3",TRUE,"Dallas Cowboys",16,20,17,297,208,89,2,18,358,282,76,1,2009-11-08,-1,0,"phi",-4
"10","Sun","November 15","L","","5-4",FALSE,"San Diego Chargers",23,31,26,462,433,29,1,22,331,212,119,0,2009-11-15,-1,0,"phi",-8
"11","Sun","November 22","W","","6-4",FALSE,"Chicago Bears",24,20,18,377,220,157,3,14,284,158,126,1,2009-11-22,-2,1,"phi",4
"12","Sun","November 29","W","","7-4",TRUE,"Washington Redskins",27,24,17,381,258,123,1,15,303,221,82,2,2009-11-29,1,1,"phi",3
"13","Sun","December 6","W","","8-4",FALSE,"Atlanta Falcons",34,7,20,380,277,103,0,22,295,234,61,3,2009-12-06,3,1,"phi",27
"14","Sun","December 13","W","","9-4",FALSE,"New York Giants",45,38,20,374,297,77,1,27,512,379,133,4,2009-12-13,3,1,"phi",7
"15","Sun","December 20","W","","10-4",TRUE,"San Francisco 49ers",27,13,21,422,306,116,2,13,261,154,107,4,2009-12-20,2,1,"phi",14
"16","Sun","December 27","W","","11-4",TRUE,"Denver Broncos",30,27,22,394,289,105,3,13,241,171,70,1,2009-12-27,-2,1,"phi",3
"17","Sun","January 3","L","","11-5",FALSE,"Dallas Cowboys",0,24,10,228,191,37,1,21,474,295,179,1,2010-01-03,0,0,"phi",-24
"WildCard","Sat","January 9","L","","11-6",FALSE,"Dallas Cowboys",14,34,17,340,284,56,4,27,426,228,198,1,2010-01-09,-3,0,"phi",-20
"1","Sun","September 12","L","","0-1",TRUE,"Green Bay Packers",20,27,16,320,171,149,1,22,299,167,132,2,2010-09-12,1,0,"phi",-7
"2","Sun","September 19","W","","1-1",FALSE,"Detroit Lions",35,32,24,410,248,162,0,22,444,329,115,2,2010-09-19,2,1,"phi",3
"3","Sun","September 26","W","","2-1",FALSE,"Jacksonville Jaguars",28,3,15,373,267,106,0,16,191,52,139,1,2010-09-26,1,1,"phi",25
"4","Sun","October 3","L","","2-2",TRUE,"Washington Redskins",12,17,21,353,243,110,2,16,293,124,169,1,2010-10-03,-1,0,"phi",-5
"5","Sun","October 10","W","","3-2",FALSE,"San Francisco 49ers",27,24,17,352,227,125,1,21,364,290,74,5,2010-10-10,4,1,"phi",3
"6","Sun","October 17","W","","4-2",TRUE,"Atlanta Falcons",31,17,23,474,320,154,1,20,293,228,65,2,2010-10-17,1,1,"phi",14
"7","Sun","October 24","L","","4-3",FALSE,"Tennessee Titans",19,37,21,326,227,99,4,15,328,253,75,3,2010-10-24,-1,0,"phi",-18
"9","Sun","November 7","W","","5-3",TRUE,"Indianapolis Colts",26,24,19,402,207,195,0,27,338,276,62,2,2010-11-07,2,1,"phi",2
"10","Mon","November 15","W","","6-3",FALSE,"Washington Redskins",59,28,28,592,332,260,0,15,375,270,105,3,2010-11-15,3,1,"phi",31
"11","Sun","November 21","W","","7-3",TRUE,"New York Giants",27,17,17,392,244,148,2,13,208,147,61,5,2010-11-21,3,1,"phi",10
"12","Sun","November 28","L","","7-4",FALSE,"Chicago Bears",26,31,24,398,293,105,1,18,349,218,131,0,2010-11-28,-1,0,"phi",-5
"13","Thu","December 2","W","","8-4",TRUE,"Houston Texans",34,24,22,416,301,115,1,27,431,323,108,2,2010-12-02,1,1,"phi",10
"14","Sun","December 12","W","","9-4",FALSE,"Dallas Cowboys",30,27,18,429,258,171,2,22,349,239,110,2,2010-12-12,0,1,"phi",3
"15","Sun","December 19","W","","10-4",FALSE,"New York Giants",38,31,19,418,221,197,3,20,364,264,100,2,2010-12-19,-1,1,"phi",7
"16","Tue","December 28","L","","10-5",TRUE,"Minnesota Vikings",14,24,24,331,224,107,3,21,337,176,161,1,2010-12-28,-2,0,"phi",-10
"17","Sun","January 2","L","","10-6",TRUE,"Dallas Cowboys",13,14,14,244,123,121,4,14,272,113,159,1,2011-01-02,-3,0,"phi",-1
"WildCard","Sun","January 9","L","","10-7",TRUE,"Green Bay Packers",16,21,18,352,271,81,1,20,309,171,138,2,2011-01-09,1,0,"phi",-5
"1","Sun","September 11","W","","1-0",FALSE,"St. Louis Rams",31,13,27,403,167,236,1,21,335,181,154,1,2011-09-11,0,1,"phi",18
"2","Sun","September 18","L","","1-1",FALSE,"Atlanta Falcons",31,35,27,447,314,133,3,20,318,180,138,2,2011-09-18,-1,0,"phi",-4
"3","Sun","September 25","L","","1-2",TRUE,"New York Giants",16,29,25,376,199,177,3,14,334,232,102,0,2011-09-25,-3,0,"phi",-13
"4","Sun","October 2","L","","1-3",TRUE,"San Francisco 49ers",23,24,23,513,405,108,3,22,442,278,164,1,2011-10-02,-2,0,"phi",-1
"5","Sun","October 9","L","","1-4",FALSE,"Buffalo Bills",24,31,24,489,315,174,5,21,331,188,143,1,2011-10-09,-4,0,"phi",-7
"6","Sun","October 16","W","","2-4",FALSE,"Washington Redskins",20,13,22,422,230,192,2,17,287,245,42,4,2011-10-16,2,1,"phi",7
"8","Sun","October 30","W","","3-4",TRUE,"Dallas Cowboys",34,7,31,495,256,239,0,12,267,182,85,1,2011-10-30,1,1,"phi",27
"9","Mon","November 7","L","","3-5",TRUE,"Chicago Bears",24,30,20,330,211,119,2,22,372,208,164,2,2011-11-07,0,0,"phi",-6
"10","Sun","November 13","L","","3-6",TRUE,"Arizona Cardinals",17,21,15,289,123,166,2,23,370,282,88,2,2011-11-13,0,0,"phi",-4
"11","Sun","November 20","W","","4-6",FALSE,"New York Giants",17,10,17,391,255,136,3,12,278,249,29,2,2011-11-20,-1,1,"phi",7
"12","Sun","November 27","L","","4-7",TRUE,"New England Patriots",20,38,23,466,393,73,1,29,457,353,104,0,2011-11-27,-1,0,"phi",-18
"13","Thu","December 1","L","","4-8",FALSE,"Seattle Seahawks",14,31,20,330,198,132,4,15,347,173,174,0,2011-12-01,-4,0,"phi",-17
"14","Sun","December 11","W","","5-8",FALSE,"Miami Dolphins",26,10,18,239,188,51,2,11,204,95,109,3,2011-12-11,1,1,"phi",16
"15","Sun","December 18","W","","6-8",TRUE,"New York Jets",45,19,20,420,260,160,4,13,241,147,94,4,2011-12-18,0,1,"phi",26
"16","Sat","December 24","W","","7-8",FALSE,"Dallas Cowboys",20,7,20,386,281,105,1,16,238,157,81,0,2011-12-24,-1,1,"phi",13
"17","Sun","January 1","W","","8-8",TRUE,"Washington Redskins",34,10,24,390,315,75,2,21,377,247,130,1,2012-01-01,-1,1,"phi",24
"1","Sun","September 8","L","","0-1",FALSE,"New England Patriots",20,26,16,205,146,59,2,26,410,202,208,5,1985-09-08,3,0,"gnb",-6
"2","Sun","September 15","W","","1-1",TRUE,"New York Giants",23,20,20,290,164,126,2,17,315,239,76,1,1985-09-15,-1,1,"gnb",3
"3","Sun","September 22","L","","1-2",TRUE,"New York Jets",3,24,10,193,122,71,4,15,226,120,106,0,1985-09-22,-4,0,"gnb",-21
"4","Sun","September 29","L","","1-3",FALSE,"St. Louis Cardinals",28,43,24,454,238,216,3,24,397,233,164,1,1985-09-29,-2,0,"gnb",-15
"5","Sun","October 6","W","","2-3",TRUE,"Detroit Lions",43,10,30,512,227,285,1,19,373,317,56,6,1985-10-06,5,1,"gnb",33
"6","Sun","October 13","W","","3-3",TRUE,"Minnesota Vikings",20,17,18,280,145,135,3,18,285,223,62,3,1985-10-13,0,1,"gnb",3
"7","Mon","October 21","L","","3-4",FALSE,"Chicago Bears",7,23,16,319,223,96,5,24,342,167,175,4,1985-10-21,-1,0,"gnb",-16
"8","Sun","October 27","L","","3-5",FALSE,"Indianapolis Colts",10,37,17,277,203,74,6,24,496,266,230,2,1985-10-27,-4,0,"gnb",-27
"9","Sun","November 3","L","","3-6",TRUE,"Chicago Bears",10,16,15,242,155,87,1,16,253,65,188,1,1985-11-03,0,0,"gnb",-6
"10","Sun","November 10","W","","4-6",FALSE,"Minnesota Vikings",27,17,20,370,195,175,1,19,311,134,177,3,1985-11-10,2,1,"gnb",10
"11","Sun","November 17","W","","5-6",TRUE,"New Orleans Saints",38,14,26,433,296,137,2,12,207,132,75,0,1985-11-17,-2,1,"gnb",24
"12","Sun","November 24","L","","5-7",FALSE,"Los Angeles Rams",17,34,20,281,203,78,1,20,329,142,187,1,1985-11-24,0,0,"gnb",-17
"13","Sun","December 1","W","","6-7",TRUE,"Tampa Bay Buccaneers",21,0,31,512,280,232,4,5,65,11,54,1,1985-12-01,-3,1,"gnb",21
"14","Sun","December 8","L","","6-8",TRUE,"Miami Dolphins",24,34,20,366,241,125,4,24,408,345,63,3,1985-12-08,-1,0,"gnb",-10
"15","Sun","December 15","W","","7-8",FALSE,"Detroit Lions",26,23,17,306,133,173,2,25,426,289,137,5,1985-12-15,3,1,"gnb",3
"16","Sun","December 22","W","","8-8",FALSE,"Tampa Bay Buccaneers",20,17,18,331,192,139,4,22,330,241,89,4,1985-12-22,0,1,"gnb",3
"1","Sun","September 7","L","","0-1",TRUE,"Houston Oilers",3,31,9,224,147,77,2,23,375,218,157,1,1986-09-07,-1,0,"gnb",-28
"2","Sun","September 14","L","","0-2",FALSE,"New Orleans Saints",10,24,20,358,295,63,7,13,289,191,98,3,1986-09-14,-4,0,"gnb",-14
"3","Mon","September 22","L","","0-3",TRUE,"Chicago Bears",12,25,16,278,231,47,1,18,296,183,113,2,1986-09-22,1,0,"gnb",-13
"4","Sun","September 28","L","","0-4",FALSE,"Minnesota Vikings",7,42,15,220,138,82,4,25,383,297,86,1,1986-09-28,-3,0,"gnb",-35
"5","Sun","October 5","L","","0-5",TRUE,"Cincinnati Bengals",28,34,24,328,253,75,2,26,378,183,195,1,1986-10-05,-1,0,"gnb",-6
"6","Sun","October 12","L","","0-6",TRUE,"Detroit Lions",14,21,16,279,235,44,2,25,338,102,236,1,1986-10-12,-1,0,"gnb",-7
"7","Sun","October 19","W","","1-6",FALSE,"Cleveland Browns",17,14,19,360,264,96,1,14,265,233,32,2,1986-10-19,1,1,"gnb",3
"8","Sun","October 26","L","","1-7",TRUE,"San Francisco 49ers",17,31,29,464,312,152,4,16,222,130,92,3,1986-10-26,-1,0,"gnb",-14
"9","Sun","November 2","L","","1-8",FALSE,"Pittsburgh Steelers",3,27,11,240,179,61,4,19,321,195,126,2,1986-11-02,-2,0,"gnb",-24
"10","Sun","November 9","L","","1-9",TRUE,"Washington Redskins",7,16,18,281,141,140,2,17,254,167,87,1,1986-11-09,-1,0,"gnb",-9
"11","Sun","November 16","W","","2-9",TRUE,"Tampa Bay Buccaneers",31,7,24,437,283,154,4,16,263,200,63,3,1986-11-16,-1,1,"gnb",24
"12","Sun","November 23","L","","2-10",FALSE,"Chicago Bears",10,12,11,195,106,89,3,15,300,102,198,5,1986-11-23,2,0,"gnb",-2
"13","Thu","November 27","W","","3-10",FALSE,"Detroit Lions",44,40,18,367,272,95,3,22,338,234,104,2,1986-11-27,-1,1,"gnb",4
"14","Sun","December 7","L","","3-11",TRUE,"Minnesota Vikings",6,32,19,367,223,144,3,20,303,146,157,1,1986-12-07,-2,0,"gnb",-26
"15","Sun","December 14","W","","4-11",FALSE,"Tampa Bay Buccaneers",21,7,20,349,173,176,0,14,242,117,125,2,1986-12-14,2,1,"gnb",14
"16","Sat","December 20","L","","4-12",FALSE,"New York Giants",24,55,17,314,195,119,3,30,448,222,226,2,1986-12-20,-1,0,"gnb",-31
"1","Sun","September 13","L","","0-1",TRUE,"Los Angeles Raiders",0,20,9,147,81,66,3,21,293,100,193,0,1987-09-13,-3,0,"gnb",-20
"2","Sun","September 20","T","OT","0-1-1",TRUE,"Denver Broncos",17,17,14,234,100,134,1,29,478,281,197,6,1987-09-20,5,0,"gnb",0
"3","Sun","October 4","W","","1-1-1",FALSE,"Minnesota Vikings",23,16,16,300,153,147,0,17,315,219,96,2,1987-10-04,2,1,"gnb",7
"4","Sun","October 11","L","OT","1-2-1",TRUE,"Detroit Lions",16,19,16,273,122,151,3,21,342,220,122,2,1987-10-11,-1,0,"gnb",-3
"5","Sun","October 18","W","OT","2-2-1",TRUE,"Philadelphia Eagles",16,10,20,401,226,175,4,17,365,224,141,5,1987-10-18,1,1,"gnb",6
"6","Sun","October 25","W","","3-2-1",FALSE,"Detroit Lions",34,33,23,465,293,172,3,23,353,336,17,1,1987-10-25,-2,1,"gnb",1
"7","Sun","November 1","L","","3-3-1",TRUE,"Tampa Bay Buccaneers",17,23,22,279,190,89,2,20,279,190,89,1,1987-11-01,-1,0,"gnb",-6
"8","Sun","November 8","L","","3-4-1",TRUE,"Chicago Bears",24,26,17,340,298,42,1,22,351,247,104,2,1987-11-08,1,0,"gnb",-2
"9","Sun","November 15","L","","3-5-1",FALSE,"Seattle Seahawks",13,24,13,298,198,100,5,16,281,88,193,5,1987-11-15,0,0,"gnb",-11
"10","Sun","November 22","W","","4-5-1",FALSE,"Kansas City Chiefs",23,3,14,273,165,108,1,10,201,85,116,3,1987-11-22,2,1,"gnb",20
"11","Sun","November 29","L","","4-6-1",FALSE,"Chicago Bears",10,23,20,348,237,111,2,20,319,192,127,3,1987-11-29,1,0,"gnb",-13
"12","Sun","December 6","L","","4-7-1",TRUE,"San Francisco 49ers",12,23,18,315,127,188,5,22,439,296,143,4,1987-12-06,-1,0,"gnb",-11
"13","Sun","December 13","W","","5-7-1",TRUE,"Minnesota Vikings",16,10,19,300,179,121,1,14,289,162,127,2,1987-12-13,1,1,"gnb",6
"14","Sat","December 19","L","","5-8-1",FALSE,"New York Giants",10,20,10,179,105,74,1,21,326,215,111,3,1987-12-19,2,0,"gnb",-10
"15","Sun","December 27","L","","5-9-1",FALSE,"New Orleans Saints",24,33,17,330,207,123,3,22,292,148,144,3,1987-12-27,0,0,"gnb",-9
"1","Sun","September 4","L","","0-1",TRUE,"Los Angeles Rams",7,34,12,209,131,78,7,18,290,176,114,1,1988-09-04,-6,0,"gnb",-27
"2","Sun","September 11","L","","0-2",TRUE,"Tampa Bay Buccaneers",10,13,13,240,181,59,2,18,266,118,148,2,1988-09-11,0,0,"gnb",-3
"3","Sun","September 18","L","","0-3",FALSE,"Miami Dolphins",17,24,22,338,260,78,0,17,354,256,98,3,1988-09-18,3,0,"gnb",-7
"4","Sun","September 25","L","","0-4",TRUE,"Chicago Bears",6,24,16,233,199,34,3,22,358,116,242,3,1988-09-25,0,0,"gnb",-18
"5","Sun","October 2","L","","0-5",FALSE,"Tampa Bay Buccaneers",24,27,22,426,354,72,3,17,368,283,85,5,1988-10-02,2,0,"gnb",-3
"6","Sun","October 9","W","","1-5",TRUE,"New England Patriots",45,3,23,399,192,207,0,14,267,191,76,5,1988-10-09,5,1,"gnb",42
"7","Sun","October 16","W","","2-5",FALSE,"Minnesota Vikings",34,14,22,355,230,125,2,20,324,257,67,5,1988-10-16,3,1,"gnb",20
"8","Sun","October 23","L","","2-6",TRUE,"Washington Redskins",17,20,10,205,123,82,0,22,385,225,160,3,1988-10-23,3,0,"gnb",-3
"9","Sun","October 30","L","","2-7",FALSE,"Buffalo Bills",0,28,10,131,54,77,4,18,261,66,195,3,1988-10-30,-1,0,"gnb",-28
"10","Sun","November 6","L","","2-8",FALSE,"Atlanta Falcons",0,20,13,284,183,101,7,18,341,177,164,3,1988-11-06,-4,0,"gnb",-20
"11","Sun","November 13","L","","2-9",TRUE,"Indianapolis Colts",13,20,22,297,199,98,4,14,247,111,136,1,1988-11-13,-3,0,"gnb",-7
"12","Sun","November 20","L","","2-10",TRUE,"Detroit Lions",9,19,24,356,304,52,3,15,270,114,156,1,1988-11-20,-2,0,"gnb",-10
"13","Sun","November 27","L","","2-11",FALSE,"Chicago Bears",0,16,9,189,167,22,2,22,372,159,213,2,1988-11-27,0,0,"gnb",-16
"14","Sun","December 4","L","","2-12",FALSE,"Detroit Lions",14,30,21,360,268,92,6,15,220,126,94,1,1988-12-04,-5,0,"gnb",-16
"15","Sun","December 11","W","","3-12",TRUE,"Minnesota Vikings",18,6,19,298,201,97,4,15,255,211,44,2,1988-12-11,-2,1,"gnb",12
"16","Sun","December 18","W","","4-12",FALSE,"Phoenix Cardinals",26,17,22,344,239,105,3,16,265,147,118,1,1988-12-18,-2,1,"gnb",9
"1","Sun","September 10","L","","0-1",TRUE,"Tampa Bay Buccaneers",21,23,17,321,218,103,3,26,347,205,142,0,1989-09-10,-3,0,"gnb",-2
"2","Sun","September 17","W","","1-1",TRUE,"New Orleans Saints",35,34,29,490,341,149,2,21,367,282,85,2,1989-09-17,0,1,"gnb",1
"3","Sun","September 24","L","","1-2",FALSE,"Los Angeles Rams",38,41,29,442,326,116,5,20,440,223,217,2,1989-09-24,-3,0,"gnb",-3
"4","Sun","October 1","W","","2-2",TRUE,"Atlanta Falcons",23,21,27,448,295,153,2,17,333,258,75,1,1989-10-01,-1,1,"gnb",2
"5","Sun","October 8","W","","3-2",TRUE,"Dallas Cowboys",31,13,28,502,313,189,1,12,213,168,45,2,1989-10-08,1,1,"gnb",18
"6","Sun","October 15","L","","3-3",FALSE,"Minnesota Vikings",14,26,11,219,151,68,3,21,398,160,238,2,1989-10-15,-1,0,"gnb",-12
"7","Sun","October 22","L","","3-4",FALSE,"Miami Dolphins",20,23,21,296,215,81,0,24,438,333,105,3,1989-10-22,3,0,"gnb",-3
"8","Sun","October 29","W","OT","4-4",TRUE,"Detroit Lions",23,20,24,421,345,76,2,21,402,192,210,2,1989-10-29,0,1,"gnb",3
"9","Sun","November 5","W","","5-4",TRUE,"Chicago Bears",14,13,19,339,270,69,2,19,321,188,133,0,1989-11-05,-2,1,"gnb",1
"10","Sun","November 12","L","","5-5",FALSE,"Detroit Lions",22,31,30,432,328,104,4,8,128,54,74,2,1989-11-12,-2,0,"gnb",-9
"11","Sun","November 19","W","","6-5",FALSE,"San Francisco 49ers",21,17,21,248,139,109,1,22,360,289,71,4,1989-11-19,3,1,"gnb",4
"12","Sun","November 26","W","","7-5",TRUE,"Minnesota Vikings",20,19,16,332,248,84,1,22,377,301,76,2,1989-11-26,1,1,"gnb",1
"13","Sun","December 3","W","","8-5",FALSE,"Tampa Bay Buccaneers",17,16,19,376,315,61,3,18,258,170,88,5,1989-12-03,2,1,"gnb",1
"14","Sun","December 10","L","","8-6",TRUE,"Kansas City Chiefs",3,21,11,208,98,110,2,21,381,203,178,3,1989-12-10,1,0,"gnb",-18
"15","Sun","December 17","W","","9-6",FALSE,"Chicago Bears",40,28,24,456,239,217,1,19,355,197,158,5,1989-12-17,4,1,"gnb",12
"16","Sun","December 24","W","","10-6",FALSE,"Dallas Cowboys",20,10,16,250,207,43,1,16,229,116,113,5,1989-12-24,4,1,"gnb",10
"1","Sun","September 9","W","","1-0",TRUE,"Los Angeles Rams",36,24,18,333,238,95,1,18,408,321,87,5,1990-09-09,4,1,"gnb",12
"2","Sun","September 16","L","","1-1",TRUE,"Chicago Bears",13,31,18,270,189,81,5,18,303,157,146,1,1990-09-16,-4,0,"gnb",-18
"3","Sun","September 23","L","","1-2",TRUE,"Kansas City Chiefs",3,17,17,257,136,121,4,14,271,118,153,1,1990-09-23,-3,0,"gnb",-14
"4","Sun","September 30","W","","2-2",FALSE,"Detroit Lions",24,21,24,412,269,143,2,21,338,194,144,0,1990-09-30,-2,1,"gnb",3
"5","Sun","October 7","L","","2-3",FALSE,"Chicago Bears",13,27,10,237,205,32,3,21,353,151,202,2,1990-10-07,-1,0,"gnb",-14
"6","Sun","October 14","L","","2-4",FALSE,"Tampa Bay Buccaneers",14,26,22,381,345,36,6,15,356,256,100,1,1990-10-14,-5,0,"gnb",-12
"8","Sun","October 28","W","","3-4",TRUE,"Minnesota Vikings",24,10,14,292,166,126,1,16,316,219,97,6,1990-10-28,5,1,"gnb",14
"9","Sun","November 4","L","","3-5",TRUE,"San Francisco 49ers",20,24,17,321,251,70,1,17,445,411,34,0,1990-11-04,-1,0,"gnb",-4
"10","Sun","November 11","W","","4-5",FALSE,"Los Angeles Raiders",29,16,20,256,155,101,1,12,165,112,53,4,1990-11-11,3,1,"gnb",13
"11","Sun","November 18","W","","5-5",FALSE,"Phoenix Cardinals",24,21,22,375,250,125,2,21,441,280,161,2,1990-11-18,0,1,"gnb",3
"12","Sun","November 25","W","","6-5",TRUE,"Tampa Bay Buccaneers",20,10,16,331,187,144,1,19,322,261,61,2,1990-11-25,1,1,"gnb",10
"13","Sun","December 2","L","","6-6",FALSE,"Minnesota Vikings",7,23,11,190,131,59,5,16,286,149,137,0,1990-12-02,-5,0,"gnb",-16
"14","Sun","December 9","L","","6-7",TRUE,"Seattle Seahawks",14,20,19,252,239,13,1,14,291,133,158,2,1990-12-09,1,0,"gnb",-6
"15","Sun","December 16","L","","6-8",FALSE,"Philadelphia Eagles",0,31,10,158,103,55,2,23,422,249,173,0,1990-12-16,-2,0,"gnb",-31
"16","Sat","December 22","L","","6-9",TRUE,"Detroit Lions",17,24,24,314,234,80,4,17,352,184,168,3,1990-12-22,-1,0,"gnb",-7
"17","Sun","December 30","L","","6-10",FALSE,"Denver Broncos",13,22,14,296,208,88,4,24,373,188,185,1,1990-12-30,-3,0,"gnb",-9
"1","Sun","September 1","L","","0-1",TRUE,"Philadelphia Eagles",3,20,14,228,184,44,5,13,318,248,70,3,1991-09-01,-2,0,"gnb",-17
"2","Sun","September 8","L","","0-2",FALSE,"Detroit Lions",14,23,20,253,177,76,1,21,347,271,76,0,1991-09-08,-1,0,"gnb",-9
"3","Sun","September 15","W","","1-2",TRUE,"Tampa Bay Buccaneers",15,13,21,340,243,97,1,17,305,231,74,1,1991-09-15,0,1,"gnb",2
"4","Sun","September 22","L","","1-3",FALSE,"Miami Dolphins",13,16,13,263,219,44,3,11,232,195,37,1,1991-09-22,-2,0,"gnb",-3
"5","Sun","September 29","L","","1-4",FALSE,"Los Angeles Rams",21,23,17,260,172,88,3,18,310,233,77,2,1991-09-29,-1,0,"gnb",-2
"6","Sun","October 6","L","","1-5",TRUE,"Dallas Cowboys",17,20,15,259,199,60,3,25,411,287,124,0,1991-10-06,-3,0,"gnb",-3
"8","Thu","October 17","L","","1-6",TRUE,"Chicago Bears",0,10,5,141,50,91,2,18,298,137,161,2,1991-10-17,0,0,"gnb",-10
"9","Sun","October 27","W","","2-6",FALSE,"Tampa Bay Buccaneers",27,0,13,244,185,59,2,12,170,135,35,8,1991-10-27,6,1,"gnb",27
"10","Sun","November 3","L","OT","2-7",FALSE,"New York Jets",16,19,15,262,171,91,3,17,293,172,121,1,1991-11-03,-2,0,"gnb",-3
"11","Sun","November 10","L","","2-8",TRUE,"Buffalo Bills",24,34,23,381,297,84,2,27,370,223,147,0,1991-11-10,-2,0,"gnb",-10
"12","Sun","November 17","L","","2-9",TRUE,"Minnesota Vikings",21,35,18,300,271,29,2,32,443,212,231,1,1991-11-17,-1,0,"gnb",-14
"13","Sun","November 24","W","","3-9",TRUE,"Indianapolis Colts",14,10,11,192,28,164,3,16,189,117,72,2,1991-11-24,-1,1,"gnb",4
"14","Sun","December 1","L","","3-10",FALSE,"Atlanta Falcons",31,35,22,393,261,132,2,23,352,273,79,1,1991-12-01,-1,0,"gnb",-4
"15","Sun","December 8","L","","3-11",FALSE,"Chicago Bears",13,27,17,261,199,62,2,22,296,195,101,2,1991-12-08,0,0,"gnb",-14
"16","Sun","December 15","L","","3-12",TRUE,"Detroit Lions",17,21,19,367,207,160,2,14,206,112,94,2,1991-12-15,0,0,"gnb",-4
"17","Sat","December 21","W","","4-12",FALSE,"Minnesota Vikings",27,7,16,188,80,108,0,12,272,225,47,3,1991-12-21,3,1,"gnb",20
"1","Sun","September 6","L","OT","0-1",TRUE,"Minnesota Vikings",20,23,18,271,155,116,3,18,425,248,177,3,1992-09-06,0,0,"gnb",-3
"2","Sun","September 13","L","","0-2",FALSE,"Tampa Bay Buccaneers",3,31,16,215,106,109,3,21,395,333,62,1,1992-09-13,-2,0,"gnb",-28
"3","Sun","September 20","W","","1-2",TRUE,"Cincinnati Bengals",24,23,22,345,252,93,3,18,301,137,164,3,1992-09-20,0,1,"gnb",1
"4","Sun","September 27","W","","2-2",TRUE,"Pittsburgh Steelers",17,3,16,294,195,99,0,16,353,208,145,1,1992-09-27,1,1,"gnb",14
"5","Sun","October 4","L","","2-3",FALSE,"Atlanta Falcons",10,24,21,338,261,77,2,17,268,166,102,0,1992-10-04,-2,0,"gnb",-14
"7","Sun","October 18","L","","2-4",FALSE,"Cleveland Browns",6,17,16,280,208,72,2,20,300,158,142,1,1992-10-18,-1,0,"gnb",-11
"8","Sun","October 25","L","","2-5",TRUE,"Chicago Bears",10,30,14,248,188,60,2,26,356,226,130,0,1992-10-25,-2,0,"gnb",-20
"9","Sun","November 1","W","","3-5",FALSE,"Detroit Lions",27,13,24,347,202,145,2,9,190,152,38,1,1992-11-01,-1,1,"gnb",14
"10","Sun","November 8","L","","3-6",FALSE,"New York Giants",7,27,20,361,273,88,5,9,177,119,58,2,1992-11-08,-3,0,"gnb",-20
"11","Sun","November 15","W","","4-6",TRUE,"Philadelphia Eagles",27,24,24,410,266,144,3,17,272,153,119,2,1992-11-15,-1,1,"gnb",3
"12","Sun","November 22","W","","5-6",FALSE,"Chicago Bears",17,3,18,334,204,130,1,15,305,251,54,2,1992-11-22,1,1,"gnb",14
"13","Sun","November 29","W","","6-6",TRUE,"Tampa Bay Buccaneers",19,14,17,283,218,65,1,14,281,152,129,5,1992-11-29,4,1,"gnb",5
"14","Sun","December 6","W","","7-6",TRUE,"Detroit Lions",38,10,21,374,208,166,2,17,304,148,156,5,1992-12-06,3,1,"gnb",28
"15","Sun","December 13","W","","8-6",FALSE,"Houston Oilers",16,14,16,215,154,61,1,21,387,328,59,4,1992-12-13,3,1,"gnb",2
"16","Sun","December 20","W","","9-6",TRUE,"Los Angeles Rams",28,13,15,259,158,101,3,17,337,216,121,3,1992-12-20,0,1,"gnb",15
"17","Sun","December 27","L","","9-7",FALSE,"Minnesota Vikings",7,27,13,211,182,29,3,22,447,282,165,1,1992-12-27,-2,0,"gnb",-20
"1","Sun","September 5","W","","1-0",TRUE,"Los Angeles Rams",36,6,22,381,243,138,1,14,228,175,53,2,1993-09-05,1,1,"gnb",30
"2","Sun","September 12","L","","1-1",TRUE,"Philadelphia Eagles",17,20,10,159,107,52,2,23,352,191,161,4,1993-09-12,2,0,"gnb",-3
"4","Sun","September 26","L","","1-2",FALSE,"Minnesota Vikings",13,15,15,256,150,106,2,17,317,210,107,1,1993-09-26,-1,0,"gnb",-2
"5","Sun","October 3","L","","1-3",FALSE,"Dallas Cowboys",14,36,18,214,178,36,0,20,395,297,98,0,1993-10-03,0,0,"gnb",-22
"6","Sun","October 10","W","","2-3",TRUE,"Denver Broncos",30,27,15,299,235,64,3,26,388,333,55,2,1993-10-10,-1,1,"gnb",3
"8","Sun","October 24","W","","3-3",FALSE,"Tampa Bay Buccaneers",37,14,18,421,259,162,2,13,246,162,84,4,1993-10-24,2,1,"gnb",23
"9","Sun","October 31","W","","4-3",TRUE,"Chicago Bears",17,3,16,261,126,135,1,15,230,112,118,3,1993-10-31,2,1,"gnb",14
"10","Mon","November 8","L","","4-4",FALSE,"Kansas City Chiefs",16,23,20,287,188,99,6,15,253,153,100,0,1993-11-08,-6,0,"gnb",-7
"11","Sun","November 14","W","","5-4",FALSE,"New Orleans Saints",19,17,13,194,125,69,1,19,329,172,157,5,1993-11-14,4,1,"gnb",2
"12","Sun","November 21","W","","6-4",TRUE,"Detroit Lions",26,17,25,404,251,153,2,12,205,89,116,2,1993-11-21,0,1,"gnb",9
"13","Sun","November 28","W","","7-4",TRUE,"Tampa Bay Buccaneers",13,10,14,259,152,107,0,11,207,115,92,0,1993-11-28,0,1,"gnb",3
"14","Sun","December 5","L","","7-5",FALSE,"Chicago Bears",17,30,29,466,387,79,5,10,210,141,69,2,1993-12-05,-3,0,"gnb",-13
"15","Sun","December 12","W","","8-5",FALSE,"San Diego Chargers",20,13,17,227,124,103,1,17,282,225,57,3,1993-12-12,2,1,"gnb",7
"16","Sun","December 19","L","","8-6",TRUE,"Minnesota Vikings",17,21,16,320,253,67,2,21,361,207,154,0,1993-12-19,-2,0,"gnb",-4
"17","Sun","December 26","W","","9-6",TRUE,"Los Angeles Raiders",28,0,17,329,181,148,1,11,182,136,46,4,1993-12-26,3,1,"gnb",28
"18","Sun","January 2","L","","9-7",FALSE,"Detroit Lions",20,30,17,273,172,101,5,16,297,182,115,1,1994-01-02,-4,0,"gnb",-10
"WildCard","Sat","January 8","W","","10-7",FALSE,"Detroit Lions",28,24,16,293,204,89,1,25,410,235,175,2,1994-01-08,1,1,"gnb",4
"Division","Sun","January 16","L","","10-8",FALSE,"Dallas Cowboys",17,27,19,358,327,31,4,23,381,284,97,3,1994-01-16,-1,0,"gnb",-10
"1","Sun","September 4","W","","1-0",TRUE,"Minnesota Vikings",16,10,15,264,170,94,1,12,194,146,48,3,1994-09-04,2,1,"gnb",6
"2","Sun","September 11","L","","1-1",TRUE,"Miami Dolphins",14,24,23,383,345,38,2,20,308,162,146,0,1994-09-11,-2,0,"gnb",-10
"3","Sun","September 18","L","","1-2",FALSE,"Philadelphia Eagles",7,13,13,275,238,37,3,20,273,182,91,2,1994-09-18,-1,0,"gnb",-6
"4","Sun","September 25","W","","2-2",TRUE,"Tampa Bay Buccaneers",30,3,24,401,306,95,0,15,231,177,54,3,1994-09-25,3,1,"gnb",27
"5","Sun","October 2","L","","2-3",FALSE,"New England Patriots",16,17,20,364,264,100,2,21,360,312,48,2,1994-10-02,0,0,"gnb",-1
"6","Sun","October 9","W","","3-3",TRUE,"Los Angeles Rams",24,17,21,292,208,84,2,13,211,147,64,2,1994-10-09,0,1,"gnb",7
"8","Thu","October 20","L","OT","3-4",FALSE,"Minnesota Vikings",10,13,12,158,87,71,2,16,252,230,22,2,1994-10-20,0,0,"gnb",-3
"9","Mon","October 31","W","","4-4",FALSE,"Chicago Bears",33,6,17,305,82,223,0,12,253,159,94,5,1994-10-31,5,1,"gnb",27
"10","Sun","November 6","W","","5-4",TRUE,"Detroit Lions",38,30,21,347,230,117,2,20,366,317,49,5,1994-11-06,3,1,"gnb",8
"11","Sun","November 13","W","","6-4",TRUE,"New York Jets",17,10,14,234,172,62,1,16,315,199,116,1,1994-11-13,0,1,"gnb",7
"12","Sun","November 20","L","","6-5",FALSE,"Buffalo Bills",20,29,18,266,205,61,1,27,455,347,108,1,1994-11-20,0,0,"gnb",-9
"13","Thu","November 24","L","","6-6",FALSE,"Dallas Cowboys",31,42,17,277,248,29,0,23,436,298,138,1,1994-11-24,1,0,"gnb",-11
"14","Sun","December 4","L","","6-7",FALSE,"Detroit Lions",31,34,23,417,359,58,2,21,387,188,199,0,1994-12-04,-2,0,"gnb",-3
"15","Sun","December 11","W","","7-7",TRUE,"Chicago Bears",40,3,28,516,259,257,1,9,176,149,27,2,1994-12-11,1,1,"gnb",37
"16","Sun","December 18","W","","8-7",TRUE,"Atlanta Falcons",21,17,23,384,310,74,1,22,333,236,97,2,1994-12-18,1,1,"gnb",4
"17","Sat","December 24","W","","9-7",FALSE,"Tampa Bay Buccaneers",34,19,25,433,290,143,2,14,214,152,62,2,1994-12-24,0,1,"gnb",15
"WildCard","Sat","December 31","W","","10-7",TRUE,"Detroit Lions",16,12,18,336,255,81,0,9,171,175,-4,0,1994-12-31,0,1,"gnb",4
"Division","Sun","January 8","L","","10-8",FALSE,"Dallas Cowboys",9,35,18,327,228,99,1,27,450,330,120,2,1995-01-08,1,0,"gnb",-26
"1","Sun","September 3","L","","0-1",TRUE,"St. Louis Rams",14,17,21,315,262,53,3,11,187,133,54,0,1995-09-03,-3,0,"gnb",-3
"2","Mon","September 11","W","","1-1",FALSE,"Chicago Bears",27,24,23,431,306,125,1,17,243,151,92,2,1995-09-11,1,1,"gnb",3
"3","Sun","September 17","W","","2-1",TRUE,"New York Giants",14,6,16,198,113,85,0,17,303,187,116,1,1995-09-17,1,1,"gnb",8
"4","Sun","September 24","W","","3-1",FALSE,"Jacksonville Jaguars",24,14,16,322,193,129,1,13,201,125,76,0,1995-09-24,-1,1,"gnb",10
"6","Sun","October 8","L","","3-2",FALSE,"Dallas Cowboys",24,34,20,369,295,74,1,25,448,312,136,0,1995-10-08,-1,0,"gnb",-10
"7","Sun","October 15","W","","4-2",TRUE,"Detroit Lions",30,21,26,436,327,109,0,18,334,205,129,1,1995-10-15,1,1,"gnb",9
"8","Sun","October 22","W","","5-2",TRUE,"Minnesota Vikings",38,21,22,346,277,69,1,17,263,170,93,4,1995-10-22,3,1,"gnb",17
"9","Sun","October 29","L","","5-3",FALSE,"Detroit Lions",16,24,28,443,298,145,4,18,407,238,169,0,1995-10-29,-4,0,"gnb",-8
"10","Sun","November 5","L","","5-4",FALSE,"Minnesota Vikings",24,27,23,344,261,83,6,17,319,225,94,1,1995-11-05,-5,0,"gnb",-3
"11","Sun","November 12","W","","6-4",TRUE,"Chicago Bears",35,28,18,356,313,43,0,26,444,304,140,1,1995-11-12,1,1,"gnb",7
"12","Sun","November 19","W","","7-4",FALSE,"Cleveland Browns",31,20,20,285,203,82,1,18,317,240,77,1,1995-11-19,0,1,"gnb",11
"13","Sun","November 26","W","","8-4",TRUE,"Tampa Bay Buccaneers",35,13,22,369,261,108,0,22,325,283,42,0,1995-11-26,0,1,"gnb",22
"14","Sun","December 3","W","","9-4",TRUE,"Cincinnati Bengals",24,10,23,434,339,95,1,12,217,186,31,2,1995-12-03,1,1,"gnb",14
"15","Sun","December 10","L","OT","9-5",FALSE,"Tampa Bay Buccaneers",10,13,20,346,285,61,1,19,345,218,127,2,1995-12-10,1,0,"gnb",-3
"16","Sat","December 16","W","","10-5",FALSE,"New Orleans Saints",34,23,22,397,294,103,0,26,404,349,55,1,1995-12-16,1,1,"gnb",11
"17","Sun","December 24","W","","11-5",TRUE,"Pittsburgh Steelers",24,19,19,359,295,64,1,27,398,314,84,0,1995-12-24,-1,1,"gnb",5
"WildCard","Sun","December 31","W","","12-5",TRUE,"Atlanta Falcons",37,20,23,307,190,117,0,18,360,339,21,2,1995-12-31,2,1,"gnb",17
"Division","Sat","January 6","W","","13-5",FALSE,"San Francisco 49ers",27,17,18,368,294,74,0,26,395,308,87,4,1996-01-06,4,1,"gnb",10
"ConfChamp","Sun","January 14","L","","13-6",FALSE,"Dallas Cowboys",27,38,17,328,280,48,2,27,419,250,169,0,1996-01-14,-2,0,"gnb",-11
"1","Sun","September 1","W","","1-0",FALSE,"Tampa Bay Buccaneers",34,3,24,406,267,139,2,15,176,117,59,6,1996-09-01,4,1,"gnb",31
"2","Mon","September 9","W","","2-0",TRUE,"Philadelphia Eagles",39,13,23,432,261,171,0,14,259,200,59,4,1996-09-09,4,1,"gnb",26
"3","Sun","September 15","W","","3-0",TRUE,"San Diego Chargers",42,10,23,336,204,132,3,11,141,108,33,3,1996-09-15,0,1,"gnb",32
"4","Sun","September 22","L","","3-1",FALSE,"Minnesota Vikings",21,30,8,217,157,60,4,18,351,263,88,4,1996-09-22,0,0,"gnb",-9
"5","Sun","September 29","W","","4-1",FALSE,"Seattle Seahawks",31,10,23,344,202,142,0,19,329,170,159,5,1996-09-29,5,1,"gnb",21
"6","Sun","October 6","W","","5-1",FALSE,"Chicago Bears",37,6,21,343,243,100,1,15,243,190,53,3,1996-10-06,2,1,"gnb",31
"7","Mon","October 14","W","OT","6-1",TRUE,"San Francisco 49ers",23,20,24,446,378,68,2,14,253,179,74,2,1996-10-14,0,1,"gnb",3
"9","Sun","October 27","W","","7-1",TRUE,"Tampa Bay Buccaneers",13,7,24,298,169,129,2,14,196,139,57,2,1996-10-27,0,1,"gnb",6
"10","Sun","November 3","W","","8-1",TRUE,"Detroit Lions",28,18,23,355,254,101,1,18,293,127,166,0,1996-11-03,-1,1,"gnb",10
"11","Sun","November 10","L","","8-2",FALSE,"Kansas City Chiefs",20,27,24,364,289,75,2,19,383,201,182,0,1996-11-10,-2,0,"gnb",-7
"12","Mon","November 18","L","","8-3",FALSE,"Dallas Cowboys",6,21,15,254,164,90,0,15,317,205,112,0,1996-11-18,0,0,"gnb",-15
"13","Sun","November 24","W","","9-3",FALSE,"St. Louis Rams",24,9,15,243,185,58,2,15,230,165,65,3,1996-11-24,1,1,"gnb",15
"14","Sun","December 1","W","","10-3",TRUE,"Chicago Bears",28,17,20,342,216,126,0,21,292,204,88,1,1996-12-01,1,1,"gnb",11
"15","Sun","December 8","W","","11-3",TRUE,"Denver Broncos",41,6,22,379,276,103,2,9,176,83,93,3,1996-12-08,1,1,"gnb",35
"16","Sun","December 15","W","","12-3",FALSE,"Detroit Lions",31,3,20,336,225,111,1,19,265,186,79,1,1996-12-15,0,1,"gnb",28
"17","Sun","December 22","W","","13-3",TRUE,"Minnesota Vikings",38,10,29,440,207,233,2,12,252,203,49,2,1996-12-22,0,1,"gnb",28
"Division","Sat","January 4","W","","14-3",TRUE,"San Francisco 49ers",35,14,15,210,71,139,1,12,196,128,68,5,1997-01-04,4,1,"gnb",21
"ConfChamp","Sun","January 12","W","","15-3",TRUE,"Carolina Panthers",30,13,22,479,278,201,2,12,251,206,45,3,1997-01-12,1,1,"gnb",17
"SuperBowl","Sun","January 26","W","","16-3",TRUE,"New England Patriots",35,21,16,323,208,115,0,16,257,214,43,4,1997-01-26,4,1,"gnb",14
"1","Mon","September 1","W","","1-0",TRUE,"Chicago Bears",38,24,18,315,208,107,2,19,336,172,164,3,1997-09-01,1,1,"gnb",14
"2","Sun","September 7","L","","1-1",FALSE,"Philadelphia Eagles",9,10,21,380,273,107,2,16,258,158,100,1,1997-09-07,-1,0,"gnb",-1
"3","Sun","September 14","W","","2-1",TRUE,"Miami Dolphins",23,18,22,392,250,142,2,20,299,240,59,1,1997-09-14,-1,1,"gnb",5
"4","Sun","September 21","W","","3-1",TRUE,"Minnesota Vikings",38,32,24,350,257,93,3,22,393,208,185,2,1997-09-21,-1,1,"gnb",6
"5","Sun","September 28","L","","3-2",FALSE,"Detroit Lions",15,26,23,396,289,107,4,18,376,203,173,0,1997-09-28,-4,0,"gnb",-11
"6","Sun","October 5","W","","4-2",TRUE,"Tampa Bay Buccaneers",21,16,13,234,170,64,1,23,372,155,217,2,1997-10-05,1,1,"gnb",5
"7","Sun","October 12","W","","5-2",FALSE,"Chicago Bears",24,23,22,277,177,100,1,26,353,232,121,2,1997-10-12,1,1,"gnb",1
"9","Mon","October 27","W","","6-2",FALSE,"New England Patriots",28,10,27,371,227,144,1,18,324,255,69,4,1997-10-27,3,1,"gnb",18
"10","Sun","November 2","W","","7-2",TRUE,"Detroit Lions",20,10,11,244,163,81,2,18,256,131,125,4,1997-11-02,2,1,"gnb",10
"11","Sun","November 9","W","","8-2",TRUE,"St. Louis Rams",17,7,18,387,291,96,3,16,269,203,66,1,1997-11-09,-2,1,"gnb",10
"12","Sun","November 16","L","","8-3",FALSE,"Indianapolis Colts",38,41,20,441,334,107,3,26,467,320,147,1,1997-11-16,-2,0,"gnb",-3
"13","Sun","November 23","W","","9-3",TRUE,"Dallas Cowboys",45,17,29,409,189,220,1,11,213,120,93,2,1997-11-23,1,1,"gnb",28
"14","Mon","December 1","W","","10-3",FALSE,"Minnesota Vikings",27,11,17,326,187,139,0,17,253,154,99,2,1997-12-01,2,1,"gnb",16
"15","Sun","December 7","W","","11-3",FALSE,"Tampa Bay Buccaneers",17,6,20,362,280,82,3,8,161,94,67,2,1997-12-07,-1,1,"gnb",11
"16","Sun","December 14","W","","12-3",FALSE,"Carolina Panthers",31,10,26,458,240,218,1,9,172,32,140,1,1997-12-14,0,1,"gnb",21
"17","Sat","December 20","W","","13-3",TRUE,"Buffalo Bills",31,21,14,272,170,102,3,21,325,274,51,4,1997-12-20,1,1,"gnb",10
"Division","Sun","January 4","W","","14-3",TRUE,"Tampa Bay Buccaneers",21,7,16,289,171,118,3,15,263,173,90,2,1998-01-04,-1,1,"gnb",14
"ConfChamp","Sun","January 11","W","","15-3",FALSE,"San Francisco 49ers",23,10,19,325,219,106,0,15,257,224,33,2,1998-01-11,2,1,"gnb",13
"SuperBowl","Sun","January 25","L","","15-4",TRUE,"Denver Broncos",24,31,21,350,255,95,3,21,302,123,179,2,1998-01-25,-1,0,"gnb",-7
"1","Sun","September 6","W","","1-0",TRUE,"Detroit Lions",38,19,21,342,267,75,0,20,321,236,85,2,1998-09-06,2,1,"gnb",19
"2","Sun","September 13","W","","2-0",TRUE,"Tampa Bay Buccaneers",23,15,15,260,223,37,2,17,211,161,50,4,1998-09-13,2,1,"gnb",8
"3","Sun","September 20","W","","3-0",FALSE,"Cincinnati Bengals",13,6,22,328,242,86,3,7,160,132,28,0,1998-09-20,-3,1,"gnb",7
"4","Sun","September 27","W","","4-0",FALSE,"Carolina Panthers",37,30,26,487,378,109,4,13,230,170,60,1,1998-09-27,-3,1,"gnb",7
"5","Mon","October 5","L","","4-1",TRUE,"Minnesota Vikings",24,37,21,306,204,102,3,22,545,442,103,1,1998-10-05,-2,0,"gnb",-13
"7","Thu","October 15","L","","4-2",FALSE,"Detroit Lions",20,27,23,368,275,93,3,16,385,199,186,1,1998-10-15,-2,0,"gnb",-7
"8","Sun","October 25","W","","5-2",TRUE,"Baltimore Ravens",28,10,20,328,252,76,2,11,233,177,56,2,1998-10-25,0,1,"gnb",18
"9","Sun","November 1","W","","6-2",TRUE,"San Francisco 49ers",36,22,15,372,274,98,3,19,266,132,134,2,1998-11-01,-1,1,"gnb",14
"10","Mon","November 9","L","","6-3",FALSE,"Pittsburgh Steelers",20,27,17,256,217,39,1,19,360,218,142,1,1998-11-09,0,0,"gnb",-7
"11","Sun","November 15","W","","7-3",FALSE,"New York Giants",37,3,24,433,264,169,0,9,127,62,65,3,1998-11-15,3,1,"gnb",34
"12","Sun","November 22","L","","7-4",FALSE,"Minnesota Vikings",14,28,22,330,277,53,3,15,340,248,92,1,1998-11-22,-2,0,"gnb",-14
"13","Sun","November 29","W","","8-4",TRUE,"Philadelphia Eagles",24,16,26,499,321,178,3,15,232,167,65,0,1998-11-29,-3,1,"gnb",8
"14","Mon","December 7","L","","8-5",FALSE,"Tampa Bay Buccaneers",22,24,23,333,228,105,2,12,283,178,105,1,1998-12-07,-1,0,"gnb",-2
"15","Sun","December 13","W","","9-5",TRUE,"Chicago Bears",26,20,24,393,274,119,2,12,192,98,94,0,1998-12-13,-2,1,"gnb",6
"16","Sun","December 20","W","","10-5",TRUE,"Tennessee Oilers",30,22,16,362,245,117,0,22,341,262,79,1,1998-12-20,1,1,"gnb",8
"17","Sun","December 27","W","","11-5",FALSE,"Chicago Bears",16,13,14,239,169,70,3,17,281,183,98,3,1998-12-27,0,1,"gnb",3
"WildCard","Sun","January 3","L","","11-6",FALSE,"San Francisco 49ers",27,30,24,403,282,121,4,20,347,169,178,3,1999-01-03,-1,0,"gnb",-3
"1","Sun","September 12","W","","1-0",TRUE,"Oakland Raiders",28,24,25,409,318,91,4,20,363,210,153,1,1999-09-12,-3,1,"gnb",4
"2","Sun","September 19","L","","1-1",FALSE,"Detroit Lions",15,23,21,437,283,154,3,9,278,196,82,2,1999-09-19,-1,0,"gnb",-8
"3","Sun","September 26","W","","2-1",TRUE,"Minnesota Vikings",23,20,20,360,289,71,0,21,328,231,97,2,1999-09-26,2,1,"gnb",3
"5","Sun","October 10","W","","3-1",TRUE,"Tampa Bay Buccaneers",26,23,18,450,352,98,1,21,273,100,173,4,1999-10-10,3,1,"gnb",3
"6","Sun","October 17","L","","3-2",FALSE,"Denver Broncos",10,31,5,133,112,21,3,28,514,363,151,1,1999-10-17,-2,0,"gnb",-21
"7","Sun","October 24","W","","4-2",FALSE,"San Diego Chargers",31,3,19,295,166,129,2,21,303,227,76,6,1999-10-24,4,1,"gnb",28
"8","Mon","November 1","L","","4-3",TRUE,"Seattle Seahawks",7,27,17,307,182,125,7,12,222,90,132,2,1999-11-01,-5,0,"gnb",-20
"9","Sun","November 7","L","","4-4",TRUE,"Chicago Bears",13,14,21,339,254,85,1,19,311,151,160,4,1999-11-07,3,0,"gnb",-1
"10","Sun","November 14","L","","4-5",FALSE,"Dallas Cowboys",13,27,20,284,244,40,2,19,339,190,149,2,1999-11-14,0,0,"gnb",-14
"11","Sun","November 21","W","","5-5",TRUE,"Detroit Lions",26,17,24,371,307,64,0,20,335,225,110,2,1999-11-21,2,1,"gnb",9
"12","Mon","November 29","W","","6-5",FALSE,"San Francisco 49ers",20,3,19,308,229,79,0,14,322,185,137,2,1999-11-29,2,1,"gnb",17
"13","Sun","December 5","W","","7-5",FALSE,"Chicago Bears",35,19,19,327,139,188,3,17,297,206,91,2,1999-12-05,-1,1,"gnb",16
"14","Sun","December 12","L","","7-6",TRUE,"Carolina Panthers",31,33,26,362,283,79,2,21,381,368,13,4,1999-12-12,2,0,"gnb",-2
"15","Mon","December 20","L","","7-7",FALSE,"Minnesota Vikings",20,24,20,319,212,107,3,15,305,229,76,2,1999-12-20,-1,0,"gnb",-4
"16","Sun","December 26","L","","7-8",FALSE,"Tampa Bay Buccaneers",10,29,14,243,231,12,4,17,274,150,124,1,1999-12-26,-3,0,"gnb",-19
"17","Sun","January 2","W","","8-8",TRUE,"Arizona Cardinals",49,24,26,475,299,176,1,30,464,384,80,4,2000-01-02,3,1,"gnb",25
"1","Sun","September 3","L","","0-1",TRUE,"New York Jets",16,20,13,211,149,62,2,24,379,261,118,1,2000-09-03,-1,0,"gnb",-4
"2","Sun","September 10","L","","0-2",FALSE,"Buffalo Bills",18,27,14,274,234,40,3,20,309,220,89,1,2000-09-10,-2,0,"gnb",-9
"3","Sun","September 17","W","","1-2",TRUE,"Philadelphia Eagles",6,3,19,236,157,79,4,12,171,86,85,1,2000-09-17,-3,1,"gnb",3
"4","Sun","September 24","W","","2-2",FALSE,"Arizona Cardinals",29,3,23,455,279,176,1,12,209,181,28,4,2000-09-24,3,1,"gnb",26
"5","Sun","October 1","L","","2-3",TRUE,"Chicago Bears",24,27,22,364,320,44,3,13,370,192,178,0,2000-10-01,-3,0,"gnb",-3
"6","Sun","October 8","L","","2-4",FALSE,"Detroit Lions",24,31,19,339,270,69,5,11,253,179,74,1,2000-10-08,-4,0,"gnb",-7
"7","Sun","October 15","W","","3-4",TRUE,"San Francisco 49ers",31,28,22,378,246,132,0,23,414,319,95,0,2000-10-15,0,1,"gnb",3
"9","Sun","October 29","L","","3-5",FALSE,"Miami Dolphins",20,28,21,319,186,133,2,17,296,156,140,1,2000-10-29,-1,0,"gnb",-8
"10","Mon","November 6","W","OT","4-5",TRUE,"Minnesota Vikings",26,20,19,298,217,81,0,22,407,250,157,5,2000-11-06,5,1,"gnb",6
"11","Sun","November 12","L","","4-6",FALSE,"Tampa Bay Buccaneers",15,20,16,302,205,97,1,14,272,164,108,1,2000-11-12,0,0,"gnb",-5
"12","Sun","November 19","W","","5-6",TRUE,"Indianapolis Colts",26,24,25,432,287,145,1,25,338,267,71,2,2000-11-19,1,1,"gnb",2
"13","Mon","November 27","L","","5-7",FALSE,"Carolina Panthers",14,31,20,326,239,87,5,24,356,223,133,2,2000-11-27,-3,0,"gnb",-17
"14","Sun","December 3","W","","6-7",FALSE,"Chicago Bears",28,6,17,304,223,81,0,17,330,226,104,2,2000-12-03,2,1,"gnb",22
"15","Sun","December 10","W","","7-7",TRUE,"Detroit Lions",26,13,16,330,202,128,2,15,293,190,103,5,2000-12-10,3,1,"gnb",13
"16","Sun","December 17","W","","8-7",FALSE,"Minnesota Vikings",33,28,28,434,280,154,0,19,400,332,68,2,2000-12-17,2,1,"gnb",5
"17","Sun","December 24","W","OT","9-7",TRUE,"Tampa Bay Buccaneers",17,14,21,319,184,135,4,16,272,205,67,0,2000-12-24,-4,1,"gnb",3
"1","Sun","September 9","W","","1-0",TRUE,"Detroit Lions",28,6,20,424,245,179,1,14,288,232,56,3,2001-09-09,2,1,"gnb",22
"2","Mon","September 24","W","","2-0",TRUE,"Washington Redskins",37,0,23,386,226,160,1,8,137,66,71,3,2001-09-24,2,1,"gnb",37
"3","Sun","September 30","W","","3-0",FALSE,"Carolina Panthers",28,7,22,383,308,75,2,9,169,133,36,3,2001-09-30,1,1,"gnb",21
"4","Sun","October 7","L","","3-1",FALSE,"Tampa Bay Buccaneers",10,14,15,322,253,69,3,12,253,154,99,1,2001-10-07,-2,0,"gnb",-4
"5","Sun","October 14","W","","4-1",TRUE,"Baltimore Ravens",31,23,23,391,331,60,1,22,357,199,158,4,2001-10-14,3,1,"gnb",8
"6","Sun","October 21","L","","4-2",FALSE,"Minnesota Vikings",13,35,10,234,160,74,1,23,377,177,200,2,2001-10-21,1,0,"gnb",-22
"8","Sun","November 4","W","","5-2",TRUE,"Tampa Bay Buccaneers",21,20,16,352,168,184,3,15,194,133,61,0,2001-11-04,-3,1,"gnb",1
"9","Sun","November 11","W","","6-2",FALSE,"Chicago Bears",20,12,17,368,268,100,2,17,262,215,47,1,2001-11-11,-1,1,"gnb",8
"10","Sun","November 18","L","","6-3",TRUE,"Atlanta Falcons",20,23,14,313,243,70,4,25,417,335,82,2,2001-11-18,-2,0,"gnb",-3
"11","Thu","November 22","W","","7-3",FALSE,"Detroit Lions",29,27,23,339,235,104,2,19,360,193,167,2,2001-11-22,0,1,"gnb",2
"12","Mon","December 3","W","","8-3",FALSE,"Jacksonville Jaguars",28,21,20,389,352,37,1,20,348,286,62,4,2001-12-03,3,1,"gnb",7
"13","Sun","December 9","W","","9-3",TRUE,"Chicago Bears",17,7,17,352,185,167,1,11,189,139,50,1,2001-12-09,0,1,"gnb",10
"14","Sun","December 16","L","","9-4",FALSE,"Tennessee Titans",20,26,14,223,192,31,2,23,423,256,167,2,2001-12-16,0,0,"gnb",-6
"15","Sun","December 23","W","","10-4",TRUE,"Cleveland Browns",30,7,17,361,139,222,1,16,337,169,168,5,2001-12-23,4,1,"gnb",23
"16","Sun","December 30","W","","11-4",TRUE,"Minnesota Vikings",24,13,13,213,157,56,1,19,302,103,199,3,2001-12-30,2,1,"gnb",11
"17","Sun","January 6","W","","12-4",FALSE,"New York Giants",34,25,18,413,308,105,1,25,524,378,146,3,2002-01-06,2,1,"gnb",9
"WildCard","Sun","January 13","W","","13-4",TRUE,"San Francisco 49ers",25,15,21,368,262,106,1,19,290,219,71,2,2002-01-13,1,1,"gnb",10
"Division","Sun","January 20","L","","13-5",FALSE,"St. Louis Rams",17,45,19,383,265,118,8,13,292,201,91,1,2002-01-20,-7,0,"gnb",-28
"1","Sun","September 8","W","OT","1-0",TRUE,"Atlanta Falcons",37,34,29,484,273,211,1,22,374,194,180,1,2002-09-08,0,1,"gnb",3
"2","Sun","September 15","L","","1-1",FALSE,"New Orleans Saints",20,35,18,357,262,95,4,16,357,211,146,2,2002-09-15,-2,0,"gnb",-15
"3","Sun","September 22","W","","2-1",FALSE,"Detroit Lions",37,31,22,442,347,95,3,14,271,176,95,5,2002-09-22,2,1,"gnb",6
"4","Sun","September 29","W","","3-1",TRUE,"Carolina Panthers",17,14,17,298,199,99,1,18,332,193,139,3,2002-09-29,2,1,"gnb",3
"5","Mon","October 7","W","","4-1",FALSE,"Chicago Bears",34,21,20,457,333,124,1,20,380,335,45,4,2002-10-07,3,1,"gnb",13
"6","Sun","October 13","W","","5-1",FALSE,"New England Patriots",28,10,20,301,143,158,0,20,289,166,123,4,2002-10-13,4,1,"gnb",18
"7","Sun","October 20","W","","6-1",TRUE,"Washington Redskins",30,9,19,243,155,88,1,19,238,92,146,4,2002-10-20,3,1,"gnb",21
"9","Mon","November 4","W","","7-1",TRUE,"Miami Dolphins",24,10,16,270,166,104,1,25,306,163,143,4,2002-11-04,3,1,"gnb",14
"10","Sun","November 10","W","","8-1",TRUE,"Detroit Lions",40,14,24,503,353,150,2,13,362,236,126,2,2002-11-10,0,1,"gnb",26
"11","Sun","November 17","L","","8-2",FALSE,"Minnesota Vikings",21,31,18,367,296,71,3,24,425,207,218,3,2002-11-17,0,0,"gnb",-10
"12","Sun","November 24","L","","8-3",FALSE,"Tampa Bay Buccaneers",7,21,15,267,171,96,4,14,246,153,93,1,2002-11-24,-3,0,"gnb",-14
"13","Sun","December 1","W","","9-3",TRUE,"Chicago Bears",30,20,26,396,215,181,2,19,304,230,74,4,2002-12-01,2,1,"gnb",10
"14","Sun","December 8","W","","10-3",TRUE,"Minnesota Vikings",26,22,20,328,204,124,2,15,316,125,191,1,2002-12-08,-1,1,"gnb",4
"15","Sun","December 15","W","","11-3",FALSE,"San Francisco 49ers",20,14,21,302,198,104,0,16,263,156,107,1,2002-12-15,1,1,"gnb",6
"16","Sun","December 22","W","","12-3",TRUE,"Buffalo Bills",10,0,14,223,104,119,2,17,185,142,43,6,2002-12-22,4,1,"gnb",10
"17","Sun","December 29","L","","12-4",FALSE,"New York Jets",17,42,19,322,208,114,1,22,337,208,129,0,2002-12-29,-1,0,"gnb",-25
"WildCard","Sat","January 4","L","","12-5",TRUE,"Atlanta Falcons",7,27,17,289,233,56,5,21,309,117,192,0,2003-01-04,-5,0,"gnb",-20
"1","Sun","September 7","L","","0-1",TRUE,"Minnesota Vikings",25,30,22,304,242,62,5,21,337,183,154,2,2003-09-07,-3,0,"gnb",-5
"2","Sun","September 14","W","","1-1",TRUE,"Detroit Lions",31,6,17,332,132,200,2,14,293,237,56,3,2003-09-14,1,1,"gnb",25
"3","Sun","September 21","L","","1-2",FALSE,"Arizona Cardinals",13,20,18,311,245,66,2,21,354,273,81,1,2003-09-21,-1,0,"gnb",-7
"4","Mon","September 29","W","","2-2",FALSE,"Chicago Bears",38,23,20,380,193,187,1,23,361,180,181,2,2003-09-29,1,1,"gnb",15
"5","Sun","October 5","W","","3-2",TRUE,"Seattle Seahawks",35,13,27,336,177,159,0,23,343,215,128,2,2003-10-05,2,1,"gnb",22
"6","Sun","October 12","L","OT","3-3",TRUE,"Kansas City Chiefs",34,40,24,440,257,183,2,22,482,400,82,0,2003-10-12,-2,0,"gnb",-6
"7","Sun","October 19","L","","3-4",FALSE,"St. Louis Rams",24,34,22,372,256,116,4,22,370,239,131,2,2003-10-19,-2,0,"gnb",-10
"9","Sun","November 2","W","","4-4",FALSE,"Minnesota Vikings",30,27,24,451,190,261,1,20,323,198,125,0,2003-11-02,-1,1,"gnb",3
"10","Mon","November 10","L","","4-5",TRUE,"Philadelphia Eagles",14,17,17,309,68,241,3,15,282,190,92,0,2003-11-10,-3,0,"gnb",-3
"11","Sun","November 16","W","","5-5",FALSE,"Tampa Bay Buccaneers",20,13,15,282,92,190,1,10,285,131,154,3,2003-11-16,2,1,"gnb",7
"12","Sun","November 23","W","","6-5",TRUE,"San Francisco 49ers",20,10,18,379,136,243,3,13,192,119,73,1,2003-11-23,-2,1,"gnb",10
"13","Thu","November 27","L","","6-6",FALSE,"Detroit Lions",14,22,18,320,268,52,5,17,266,172,94,1,2003-11-27,-4,0,"gnb",-8
"14","Sun","December 7","W","","7-6",TRUE,"Chicago Bears",34,21,17,307,210,97,1,13,275,231,44,5,2003-12-07,4,1,"gnb",13
"15","Sun","December 14","W","","8-6",FALSE,"San Diego Chargers",38,21,17,361,278,83,1,23,424,336,88,4,2003-12-14,3,1,"gnb",17
"16","Mon","December 22","W","","9-6",FALSE,"Oakland Raiders",41,7,23,548,392,156,0,18,298,194,104,3,2003-12-22,3,1,"gnb",34
"17","Sun","December 28","W","","10-6",TRUE,"Denver Broncos",31,3,16,366,104,262,1,13,216,102,114,3,2003-12-28,2,1,"gnb",28
"WildCard","Sun","January 4","W","OT","11-6",TRUE,"Seattle Seahawks",33,27,22,397,319,78,0,22,340,291,49,1,2004-01-04,1,1,"gnb",6
"Division","Sun","January 11","L","OT","11-7",FALSE,"Philadelphia Eagles",17,20,16,381,171,210,1,19,363,199,164,1,2004-01-11,0,0,"gnb",-3
"1","Mon","September 13","W","","1-0",FALSE,"Carolina Panthers",24,14,22,279,127,152,0,17,300,262,38,2,2004-09-13,2,1,"gnb",10
"2","Sun","September 19","L","","1-1",TRUE,"Chicago Bears",10,21,23,404,252,152,3,18,307,125,182,2,2004-09-19,-1,0,"gnb",-11
"3","Sun","September 26","L","","1-2",FALSE,"Indianapolis Colts",31,45,24,459,385,74,2,26,453,393,60,0,2004-09-26,-2,0,"gnb",-14
"4","Sun","October 3","L","","1-3",TRUE,"New York Giants",7,14,15,301,220,81,3,21,403,158,245,1,2004-10-03,-2,0,"gnb",-7
"5","Mon","October 11","L","","1-4",TRUE,"Tennessee Titans",27,48,22,437,402,35,6,23,456,232,224,0,2004-10-11,-6,0,"gnb",-21
"6","Sun","October 17","W","","2-4",FALSE,"Detroit Lions",38,10,28,434,277,157,0,5,125,92,33,1,2004-10-17,1,1,"gnb",28
"7","Sun","October 24","W","","3-4",TRUE,"Dallas Cowboys",41,20,23,480,260,220,0,18,362,296,66,0,2004-10-24,0,1,"gnb",21
"8","Sun","October 31","W","","4-4",FALSE,"Washington Redskins",28,14,20,361,273,88,4,20,272,191,81,2,2004-10-31,-2,1,"gnb",14
"10","Sun","November 14","W","","5-4",TRUE,"Minnesota Vikings",34,31,24,442,236,206,1,22,416,345,71,0,2004-11-14,-1,1,"gnb",3
"11","Sun","November 21","W","","6-4",FALSE,"Houston Texans",16,13,22,473,383,90,2,13,251,144,107,0,2004-11-21,-2,1,"gnb",3
"12","Mon","November 29","W","","7-4",TRUE,"St. Louis Rams",45,17,22,446,215,231,0,25,452,405,47,3,2004-11-29,3,1,"gnb",28
"13","Sun","December 5","L","","7-5",FALSE,"Philadelphia Eagles",17,47,20,249,199,50,2,29,542,449,93,1,2004-12-05,-1,0,"gnb",-30
"14","Sun","December 12","W","","8-5",TRUE,"Detroit Lions",16,13,20,301,185,116,0,17,228,35,193,0,2004-12-12,0,1,"gnb",3
"15","Sun","December 19","L","","8-6",TRUE,"Jacksonville Jaguars",25,28,26,444,350,94,5,19,312,115,197,2,2004-12-19,-3,0,"gnb",-3
"16","Fri","December 24","W","","9-6",FALSE,"Minnesota Vikings",34,31,26,460,358,102,1,17,416,285,131,0,2004-12-24,-1,1,"gnb",3
"17","Sun","January 2","W","","10-6",FALSE,"Chicago Bears",31,14,17,387,327,60,0,17,246,136,110,1,2005-01-02,1,1,"gnb",17
"WildCard","Sun","January 9","L","","10-7",TRUE,"Minnesota Vikings",17,31,24,306,201,105,4,18,384,261,123,0,2005-01-09,-4,0,"gnb",-14
"1","Sun","September 11","L","","0-1",FALSE,"Detroit Lions",3,17,13,216,170,46,3,18,254,152,102,0,2005-09-11,-3,0,"gnb",-14
"2","Sun","September 18","L","","0-2",TRUE,"Cleveland Browns",24,26,27,452,336,116,2,19,391,336,55,0,2005-09-18,-2,0,"gnb",-2
"3","Sun","September 25","L","","0-3",TRUE,"Tampa Bay Buccaneers",16,17,15,260,185,75,4,19,293,132,161,1,2005-09-25,-3,0,"gnb",-1
"4","Mon","October 3","L","","0-4",FALSE,"Carolina Panthers",29,32,22,352,294,58,2,17,286,196,90,1,2005-10-03,-1,0,"gnb",-3
"5","Sun","October 9","W","","1-4",TRUE,"New Orleans Saints",52,3,21,309,215,94,0,14,254,159,95,5,2005-10-09,5,1,"gnb",49
"7","Sun","October 23","L","","1-5",FALSE,"Minnesota Vikings",20,23,19,374,329,45,0,24,363,255,108,1,2005-10-23,1,0,"gnb",-3
"8","Sun","October 30","L","","1-6",FALSE,"Cincinnati Bengals",14,21,23,353,277,76,5,21,317,222,95,1,2005-10-30,-4,0,"gnb",-7
"9","Sun","November 6","L","","1-7",TRUE,"Pittsburgh Steelers",10,20,16,268,203,65,3,13,213,59,154,1,2005-11-06,-2,0,"gnb",-10
"10","Sun","November 13","W","","2-7",FALSE,"Atlanta Falcons",33,25,25,351,244,107,1,19,321,192,129,3,2005-11-13,2,1,"gnb",8
"11","Mon","November 21","L","","2-8",TRUE,"Minnesota Vikings",17,20,13,236,215,21,2,22,331,171,160,2,2005-11-21,0,0,"gnb",-3
"12","Sun","November 27","L","","2-9",FALSE,"Philadelphia Eagles",14,19,18,292,164,128,5,15,264,88,176,1,2005-11-27,-4,0,"gnb",-5
"13","Sun","December 4","L","","2-10",FALSE,"Chicago Bears",7,19,26,358,258,100,4,10,190,49,141,2,2005-12-04,-2,0,"gnb",-12
"14","Sun","December 11","W","OT","3-10",TRUE,"Detroit Lions",16,13,19,330,149,181,2,11,241,112,129,0,2005-12-11,-2,1,"gnb",3
"15","Mon","December 19","L","","3-11",FALSE,"Baltimore Ravens",3,48,16,288,181,107,5,25,435,253,182,0,2005-12-19,-5,0,"gnb",-45
"16","Sun","December 25","L","","3-12",TRUE,"Chicago Bears",17,24,24,365,300,65,4,16,292,157,135,1,2005-12-25,-3,0,"gnb",-7
"17","Sun","January 1","W","","4-12",TRUE,"Seattle Seahawks",23,17,21,314,246,68,3,17,245,147,98,2,2006-01-01,-1,1,"gnb",6
"1","Sun","September 10","L","","0-1",TRUE,"Chicago Bears",0,26,14,267,164,103,3,18,361,252,109,1,2006-09-10,-2,0,"gnb",-26
"2","Sun","September 17","L","","0-2",TRUE,"New Orleans Saints",27,34,21,385,322,63,2,20,380,332,48,3,2006-09-17,1,0,"gnb",-7
"3","Sun","September 24","W","","1-2",FALSE,"Detroit Lions",31,24,18,400,340,60,2,23,424,319,105,1,2006-09-24,-1,1,"gnb",7
"4","Mon","October 2","L","","1-3",FALSE,"Philadelphia Eagles",9,31,20,318,219,99,3,23,398,267,131,2,2006-10-02,-1,0,"gnb",-22
"5","Sun","October 8","L","","1-4",TRUE,"St. Louis Rams",20,23,20,336,215,121,2,19,327,209,118,0,2006-10-08,-2,0,"gnb",-3
"7","Sun","October 22","W","","2-4",FALSE,"Miami Dolphins",34,24,19,346,191,155,1,26,448,381,67,3,2006-10-22,2,1,"gnb",10
"8","Sun","October 29","W","","3-4",TRUE,"Arizona Cardinals",31,14,28,383,180,203,0,20,218,132,86,1,2006-10-29,1,1,"gnb",17
"9","Sun","November 5","L","","3-5",FALSE,"Buffalo Bills",10,24,26,427,280,147,4,11,184,64,120,0,2006-11-05,-4,0,"gnb",-14
"10","Sun","November 12","W","","4-5",FALSE,"Minnesota Vikings",23,17,16,394,347,47,0,14,312,222,90,2,2006-11-12,2,1,"gnb",6
"11","Sun","November 19","L","","4-6",TRUE,"New England Patriots",0,35,5,120,76,44,1,22,357,235,122,1,2006-11-19,0,0,"gnb",-35
"12","Mon","November 27","L","","4-7",FALSE,"Seattle Seahawks",24,34,14,316,265,51,4,29,382,147,235,4,2006-11-27,0,0,"gnb",-10
"13","Sun","December 3","L","","4-8",TRUE,"New York Jets",10,38,23,351,202,149,3,27,441,263,178,2,2006-12-03,-1,0,"gnb",-28
"14","Sun","December 10","W","","5-8",FALSE,"San Francisco 49ers",30,19,19,420,281,139,0,13,340,194,146,3,2006-12-10,3,1,"gnb",11
"15","Sun","December 17","W","","6-8",TRUE,"Detroit Lions",17,9,19,303,164,139,4,10,142,84,58,3,2006-12-17,-1,1,"gnb",8
"16","Thu","December 21","W","","7-8",TRUE,"Minnesota Vikings",9,7,19,319,273,46,3,3,104,27,77,1,2006-12-21,-2,1,"gnb",2
"17","Sun","December 31","W","","8-8",FALSE,"Chicago Bears",26,7,20,373,276,97,1,13,316,181,135,6,2006-12-31,5,1,"gnb",19
"1","Sun","September 9","W","","1-0",TRUE,"Philadelphia Eagles",16,13,10,215,169,46,2,13,283,180,103,3,2007-09-09,1,1,"gnb",3
"2","Sun","September 16","W","","2-0",FALSE,"New York Giants",35,13,25,368,285,83,1,20,325,231,94,2,2007-09-16,1,1,"gnb",22
"3","Sun","September 23","W","","3-0",TRUE,"San Diego Chargers",31,24,20,405,363,42,0,25,364,291,73,1,2007-09-23,1,1,"gnb",7
"4","Sun","September 30","W","","4-0",FALSE,"Minnesota Vikings",23,16,20,384,338,46,2,20,382,227,155,2,2007-09-30,0,1,"gnb",7
"5","Sun","October 7","L","","4-1",TRUE,"Chicago Bears",20,27,18,439,318,121,5,16,285,203,82,1,2007-10-07,-4,0,"gnb",-7
"6","Sun","October 14","W","","5-1",TRUE,"Washington Redskins",17,14,13,225,169,56,2,18,304,210,94,3,2007-10-14,1,1,"gnb",3
"8","Mon","October 29","W","OT","6-1",FALSE,"Denver Broncos",19,13,20,430,325,105,0,24,332,244,88,1,2007-10-29,1,1,"gnb",6
"9","Sun","November 4","W","","7-1",FALSE,"Kansas City Chiefs",33,22,19,432,354,78,2,20,234,173,61,2,2007-11-04,0,1,"gnb",11
"10","Sun","November 11","W","","8-1",TRUE,"Minnesota Vikings",34,0,29,488,368,120,0,11,247,161,86,1,2007-11-11,1,1,"gnb",34
"11","Sun","November 18","W","","9-1",TRUE,"Carolina Panthers",31,17,18,317,214,103,0,21,382,251,131,3,2007-11-18,3,1,"gnb",14
"12","Thu","November 22","W","","10-1",FALSE,"Detroit Lions",37,26,25,481,381,100,1,25,331,197,134,1,2007-11-22,0,1,"gnb",11
"13","Thu","November 29","L","","10-2",FALSE,"Dallas Cowboys",27,37,20,357,233,124,2,23,414,309,105,1,2007-11-29,-1,0,"gnb",-10
"14","Sun","December 9","W","","11-2",TRUE,"Oakland Raiders",38,7,21,445,266,179,1,10,233,148,85,3,2007-12-09,2,1,"gnb",31
"15","Sun","December 16","W","","12-2",FALSE,"St. Louis Rams",33,14,17,277,225,52,3,21,364,191,173,2,2007-12-16,-1,1,"gnb",19
"16","Sun","December 23","L","","12-3",FALSE,"Chicago Bears",7,35,13,274,149,125,2,14,240,104,136,0,2007-12-23,-2,0,"gnb",-28
"17","Sun","December 30","W","","13-3",TRUE,"Detroit Lions",34,13,19,394,177,217,1,16,293,246,47,2,2007-12-30,1,1,"gnb",21
"Division","Sat","January 12","W","","14-3",TRUE,"Seattle Seahawks",42,20,25,408,173,235,2,15,200,172,28,1,2008-01-12,-1,1,"gnb",22
"ConfChamp","Sun","January 20","L","OT","14-4",TRUE,"New York Giants",20,23,13,264,236,28,2,24,377,243,134,1,2008-01-20,-1,0,"gnb",-3
"1","Mon","September 8","W","","1-0",TRUE,"Minnesota Vikings",24,19,15,317,178,139,0,21,355,168,187,1,2008-09-08,1,1,"gnb",5
"2","Sun","September 14","W","","2-0",FALSE,"Detroit Lions",48,25,19,447,324,123,1,15,311,262,49,3,2008-09-14,2,1,"gnb",23
"3","Sun","September 21","L","","2-1",TRUE,"Dallas Cowboys",16,27,17,334,250,84,1,22,453,236,217,2,2008-09-21,1,0,"gnb",-11
"4","Sun","September 28","L","","2-2",FALSE,"Tampa Bay Buccaneers",21,30,8,181,153,28,4,20,327,149,178,3,2008-09-28,-1,0,"gnb",-9
"5","Sun","October 5","L","","2-3",TRUE,"Atlanta Falcons",24,27,21,408,304,104,1,22,370,194,176,1,2008-10-05,0,0,"gnb",-3
"6","Sun","October 12","W","","3-3",FALSE,"Seattle Seahawks",27,17,20,313,200,113,1,13,177,64,113,2,2008-10-12,1,1,"gnb",10
"7","Sun","October 19","W","","4-3",TRUE,"Indianapolis Colts",34,14,24,302,186,116,0,21,302,229,73,2,2008-10-19,2,1,"gnb",20
"9","Sun","November 2","L","OT","4-4",FALSE,"Tennessee Titans",16,19,18,390,288,102,2,20,347,169,178,0,2008-11-02,-2,0,"gnb",-3
"10","Sun","November 9","L","","4-5",FALSE,"Minnesota Vikings",27,28,12,184,110,74,0,18,361,141,220,3,2008-11-09,3,0,"gnb",-1
"11","Sun","November 16","W","","5-5",TRUE,"Chicago Bears",37,3,24,427,227,200,1,9,234,151,83,1,2008-11-16,0,1,"gnb",34
"12","Mon","November 24","L","","5-6",FALSE,"New Orleans Saints",29,51,22,343,234,109,3,21,416,318,98,1,2008-11-24,-2,0,"gnb",-22
"13","Sun","November 30","L","","5-7",TRUE,"Carolina Panthers",31,35,25,438,293,145,2,15,298,170,128,1,2008-11-30,-1,0,"gnb",-4
"14","Sun","December 7","L","","5-8",TRUE,"Houston Texans",21,24,16,387,279,108,1,25,549,408,141,4,2008-12-07,3,0,"gnb",-3
"15","Sun","December 14","L","","5-9",FALSE,"Jacksonville Jaguars",16,20,18,338,254,84,1,18,323,229,94,0,2008-12-14,-1,0,"gnb",-4
"16","Mon","December 22","L","OT","5-10",FALSE,"Chicago Bears",17,20,20,325,260,65,2,15,210,136,74,2,2008-12-22,0,0,"gnb",-3
"17","Sun","December 28","W","","6-10",TRUE,"Detroit Lions",31,21,20,484,273,211,1,19,316,220,96,2,2008-12-28,1,1,"gnb",10
"1","Sun","September 13","W","","1-0",TRUE,"Chicago Bears",21,15,12,226,150,76,0,18,352,266,86,4,2009-09-13,4,1,"gnb",6
"2","Sun","September 20","L","","1-1",TRUE,"Cincinnati Bengals",24,31,22,311,222,89,1,19,319,168,151,2,2009-09-20,1,0,"gnb",-7
"3","Sun","September 27","W","","2-1",FALSE,"St. Louis Rams",36,17,24,402,250,152,0,22,336,187,149,3,2009-09-27,3,1,"gnb",19
"4","Mon","October 5","L","","2-2",FALSE,"Minnesota Vikings",23,30,19,424,342,82,2,22,334,271,63,1,2009-10-05,-1,0,"gnb",-7
"6","Sun","October 18","W","","3-2",TRUE,"Detroit Lions",26,0,23,435,328,107,2,10,149,71,78,3,2009-10-18,1,1,"gnb",26
"7","Sun","October 25","W","","4-2",FALSE,"Cleveland Browns",31,3,25,460,258,202,0,12,139,81,58,2,2009-10-25,2,1,"gnb",28
"8","Sun","November 1","L","","4-3",TRUE,"Minnesota Vikings",26,38,21,351,261,90,0,19,355,244,111,2,2009-11-01,2,0,"gnb",-12
"9","Sun","November 8","L","","4-4",FALSE,"Tampa Bay Buccaneers",28,38,20,404,234,170,3,17,279,198,81,1,2009-11-08,-2,0,"gnb",-10
"10","Sun","November 15","W","","5-4",TRUE,"Dallas Cowboys",17,7,20,283,178,105,0,17,278,217,61,3,2009-11-15,3,1,"gnb",10
"11","Sun","November 22","W","","6-4",TRUE,"San Francisco 49ers",30,24,26,484,326,158,0,11,284,215,69,1,2009-11-22,1,1,"gnb",6
"12","Thu","November 26","W","","7-4",FALSE,"Detroit Lions",34,12,20,422,342,80,2,16,272,199,73,5,2009-11-26,3,1,"gnb",22
"13","Mon","December 7","W","","8-4",TRUE,"Baltimore Ravens",27,14,25,350,256,94,3,17,185,119,66,4,2009-12-07,1,1,"gnb",13
"14","Sun","December 13","W","","9-4",FALSE,"Chicago Bears",21,14,16,315,157,158,2,14,254,195,59,2,2009-12-13,0,1,"gnb",7
"15","Sun","December 20","L","","9-5",FALSE,"Pittsburgh Steelers",36,37,18,436,376,60,0,28,537,472,65,0,2009-12-20,0,0,"gnb",-1
"16","Sun","December 27","W","","10-5",TRUE,"Seattle Seahawks",48,10,20,417,264,153,0,17,291,176,115,4,2009-12-27,4,1,"gnb",38
"17","Sun","January 3","W","","11-5",FALSE,"Arizona Cardinals",33,7,24,345,236,109,1,13,187,139,48,3,2010-01-03,2,1,"gnb",26
"WildCard","Sun","January 10","L","OT","11-6",FALSE,"Arizona Cardinals",45,51,32,493,404,89,3,30,531,375,156,1,2010-01-10,-2,0,"gnb",-6
"1","Sun","September 12","W","","1-0",FALSE,"Philadelphia Eagles",27,20,22,299,167,132,2,16,320,171,149,1,2010-09-12,-1,1,"gnb",7
"2","Sun","September 19","W","","2-0",TRUE,"Buffalo Bills",34,7,18,346,255,91,0,14,186,62,124,2,2010-09-19,2,1,"gnb",27
"3","Mon","September 27","L","","2-1",FALSE,"Chicago Bears",17,20,21,379,316,63,2,18,276,199,77,1,2010-09-27,-1,0,"gnb",-3
"4","Sun","October 3","W","","3-1",TRUE,"Detroit Lions",28,26,16,261,169,92,4,24,431,308,123,3,2010-10-03,-1,1,"gnb",2
"5","Sun","October 10","L","OT","3-2",FALSE,"Washington Redskins",13,16,17,427,270,157,2,21,373,322,51,1,2010-10-10,-1,0,"gnb",-3
"6","Sun","October 17","L","OT","3-3",TRUE,"Miami Dolphins",20,23,16,359,283,76,1,26,381,231,150,1,2010-10-17,0,0,"gnb",-3
"7","Sun","October 24","W","","4-3",TRUE,"Minnesota Vikings",28,24,20,379,295,84,2,21,402,206,196,3,2010-10-24,1,1,"gnb",4
"8","Sun","October 31","W","","5-3",FALSE,"New York Jets",9,0,13,237,156,81,0,15,360,241,119,3,2010-10-31,3,1,"gnb",9
"9","Sun","November 7","W","","6-3",TRUE,"Dallas Cowboys",45,7,26,415,277,138,0,12,205,166,39,4,2010-11-07,4,1,"gnb",38
"11","Sun","November 21","W","","7-3",FALSE,"Minnesota Vikings",31,3,20,374,283,91,0,15,300,207,93,2,2010-11-21,2,1,"gnb",28
"12","Sun","November 28","L","","7-4",FALSE,"Atlanta Falcons",17,20,22,418,341,77,1,19,294,177,117,0,2010-11-28,-1,0,"gnb",-3
"13","Sun","December 5","W","","8-4",TRUE,"San Francisco 49ers",34,16,21,410,274,136,0,11,269,172,97,1,2010-12-05,1,1,"gnb",18
"14","Sun","December 12","L","","8-5",FALSE,"Detroit Lions",3,7,13,258,192,66,3,15,286,96,190,2,2010-12-12,-1,0,"gnb",-4
"15","Sun","December 19","L","","8-6",FALSE,"New England Patriots",27,31,26,369,226,143,2,14,249,136,113,0,2010-12-19,-2,0,"gnb",-4
"16","Sun","December 26","W","","9-6",TRUE,"New York Giants",45,17,27,515,396,119,1,16,386,296,90,6,2010-12-26,5,1,"gnb",28
"17","Sun","January 2","W","","10-6",TRUE,"Chicago Bears",10,3,14,284,224,60,2,13,227,117,110,2,2011-01-02,0,1,"gnb",7
"WildCard","Sun","January 9","W","","11-6",FALSE,"Philadelphia Eagles",21,16,20,309,171,138,2,18,352,271,81,1,2011-01-09,-1,1,"gnb",5
"Division","Sat","January 15","W","","12-6",FALSE,"Atlanta Falcons",48,21,28,442,346,96,1,15,194,149,45,4,2011-01-15,3,1,"gnb",27
"ConfChamp","Sun","January 23","W","","13-6",FALSE,"Chicago Bears",21,14,23,356,236,120,2,17,301,218,83,3,2011-01-23,1,1,"gnb",7
"SuperBowl","Sun","February 6","W","","14-6",TRUE,"Pittsburgh Steelers",31,25,15,338,288,50,0,19,387,261,126,3,2011-02-06,3,1,"gnb",6
"1","Thu","September 8","W","","1-0",TRUE,"New Orleans Saints",42,34,27,399,296,103,0,27,477,396,81,1,2011-09-08,1,1,"gnb",8
"2","Sun","September 18","W","","2-0",FALSE,"Carolina Panthers",30,23,16,419,295,124,1,26,475,404,71,4,2011-09-18,3,1,"gnb",7
"3","Sun","September 25","W","","3-0",FALSE,"Chicago Bears",27,17,24,392,292,100,2,12,291,278,13,2,2011-09-25,0,1,"gnb",10
"4","Sun","October 2","W","","4-0",TRUE,"Denver Broncos",49,23,26,507,396,111,2,18,384,265,119,4,2011-10-02,2,1,"gnb",26
"5","Sun","October 9","W","","5-0",FALSE,"Atlanta Falcons",25,14,19,426,369,57,1,18,251,156,95,2,2011-10-09,1,1,"gnb",11
"6","Sun","October 16","W","","6-0",TRUE,"St. Louis Rams",24,3,20,399,309,90,1,22,424,306,118,1,2011-10-16,0,1,"gnb",21
"7","Sun","October 23","W","","7-0",FALSE,"Minnesota Vikings",33,27,25,421,307,114,1,22,435,217,218,2,2011-10-23,1,1,"gnb",6
"9","Sun","November 6","W","","8-0",FALSE,"San Diego Chargers",45,38,21,368,232,136,0,28,460,375,85,3,2011-11-06,3,1,"gnb",7
"10","Mon","November 14","W","","9-0",TRUE,"Minnesota Vikings",45,7,23,356,266,90,1,14,266,162,104,1,2011-11-14,0,1,"gnb",38
"11","Sun","November 20","W","","10-0",TRUE,"Tampa Bay Buccaneers",35,26,24,378,287,91,1,22,455,334,121,2,2011-11-20,1,1,"gnb",9
"12","Thu","November 24","W","","11-0",FALSE,"Detroit Lions",27,15,18,349,296,53,0,23,409,273,136,3,2011-11-24,3,1,"gnb",12
"13","Sun","December 4","W","","12-0",FALSE,"New York Giants",38,35,29,449,360,89,1,24,447,347,100,2,2011-12-04,1,1,"gnb",3
"14","Sun","December 11","W","","13-0",TRUE,"Oakland Raiders",46,16,22,391,255,136,1,23,357,240,117,5,2011-12-11,4,1,"gnb",30
"15","Sun","December 18","L","","13-1",FALSE,"Kansas City Chiefs",14,19,16,315,213,102,0,23,438,299,139,0,2011-12-18,0,0,"gnb",-5
"16","Sun","December 25","W","","14-1",TRUE,"Chicago Bears",35,21,19,363,282,81,0,24,441,242,199,2,2011-12-25,2,1,"gnb",14
"17","Sun","January 1","W","","15-1",TRUE,"Detroit Lions",45,41,27,550,469,81,2,32,575,502,73,4,2012-01-01,2,1,"gnb",4
"Division","Sun","January 15","L","","15-2",TRUE,"New York Giants",20,37,25,388,241,147,4,19,420,325,95,1,2012-01-15,-3,0,"gnb",-17
"1","Sun","September 8","W","","1-0",TRUE,"Tampa Bay Buccaneers",38,28,27,436,251,185,3,17,307,141,166,2,1985-09-08,-1,1,"chi",10
"2","Sun","September 15","W","","2-0",TRUE,"New England Patriots",20,7,18,369,209,160,2,10,206,179,27,4,1985-09-15,2,1,"chi",13
"3","Thu","September 19","W","","3-0",FALSE,"Minnesota Vikings",33,24,21,480,353,127,1,23,445,411,34,5,1985-09-19,4,1,"chi",9
"4","Sun","September 29","W","","4-0",TRUE,"Washington Redskins",45,10,16,250,159,91,1,19,376,184,192,3,1985-09-29,2,1,"chi",35
"5","Sun","October 6","W","","5-0",FALSE,"Tampa Bay Buccaneers",27,19,22,433,286,147,3,19,373,346,27,3,1985-10-06,0,1,"chi",8
"6","Sun","October 13","W","","6-0",FALSE,"San Francisco 49ers",26,10,22,372,183,189,1,11,183,116,67,2,1985-10-13,1,1,"chi",16
"7","Mon","October 21","W","","7-0",TRUE,"Green Bay Packers",23,7,24,342,167,175,4,16,319,223,96,5,1985-10-21,1,1,"chi",16
"8","Sun","October 27","W","","8-0",TRUE,"Minnesota Vikings",27,9,24,413,211,202,2,16,236,206,30,5,1985-10-27,3,1,"chi",18
"9","Sun","November 3","W","","9-0",FALSE,"Green Bay Packers",16,10,16,253,65,188,1,15,242,155,87,1,1985-11-03,0,1,"chi",6
"10","Sun","November 10","W","","10-0",TRUE,"Detroit Lions",24,3,26,360,110,250,2,8,106,38,68,4,1985-11-10,2,1,"chi",21
"11","Sun","November 17","W","","11-0",FALSE,"Dallas Cowboys",44,0,18,378,162,216,1,12,171,119,52,5,1985-11-17,4,1,"chi",44
"12","Sun","November 24","W","","12-0",TRUE,"Atlanta Falcons",36,0,24,379,183,196,1,10,119,-22,141,3,1985-11-24,2,1,"chi",36
"13","Mon","December 2","L","","12-1",FALSE,"Miami Dolphins",24,38,23,343,176,167,4,17,335,245,90,2,1985-12-02,-2,0,"chi",-14
"14","Sun","December 8","W","","13-1",TRUE,"Indianapolis Colts",17,10,22,328,137,191,0,10,232,133,99,0,1985-12-08,0,1,"chi",7
"15","Sat","December 14","W","","14-1",FALSE,"New York Jets",19,6,20,319,203,116,1,11,159,89,70,3,1985-12-14,2,1,"chi",13
"16","Sun","December 22","W","","15-1",FALSE,"Detroit Lions",37,17,20,382,221,161,4,22,326,253,73,7,1985-12-22,3,1,"chi",20
"Division","Sun","January 5","W","","16-1",TRUE,"New York Giants",21,0,17,363,216,147,0,10,181,149,32,1,1986-01-05,1,1,"chi",21
"ConfChamp","Sun","January 12","W","","17-1",TRUE,"Los Angeles Rams",24,0,13,232,141,91,1,9,130,44,86,3,1986-01-12,2,1,"chi",24
"SuperBowl","Sun","January 26","W","","18-1",TRUE,"New England Patriots",46,10,23,408,241,167,2,12,123,116,7,6,1986-01-26,4,1,"chi",36
"1","Sun","September 7","W","","1-0",TRUE,"Cleveland Browns",41,31,26,367,174,193,1,21,349,280,69,1,1986-09-07,0,1,"chi",10
"2","Sun","September 14","W","OT","2-0",TRUE,"Philadelphia Eagles",13,10,21,344,100,244,4,17,247,146,101,6,1986-09-14,2,1,"chi",3
"3","Mon","September 22","W","","3-0",FALSE,"Green Bay Packers",25,12,18,296,183,113,2,16,278,231,47,1,1986-09-22,-1,1,"chi",13
"4","Sun","September 28","W","","4-0",FALSE,"Cincinnati Bengals",44,7,23,476,254,222,2,16,338,278,60,5,1986-09-28,3,1,"chi",37
"5","Sun","October 5","W","","5-0",TRUE,"Minnesota Vikings",23,0,18,370,199,171,3,11,159,114,45,3,1986-10-05,0,1,"chi",23
"6","Sun","October 12","W","","6-0",FALSE,"Houston Oilers",20,7,23,360,203,157,2,19,283,155,128,1,1986-10-12,-1,1,"chi",13
"7","Sun","October 19","L","","6-1",FALSE,"Minnesota Vikings",7,23,10,190,137,53,2,19,376,219,157,1,1986-10-19,-1,0,"chi",-16
"8","Sun","October 26","W","","7-1",TRUE,"Detroit Lions",13,7,19,252,128,124,3,11,214,138,76,3,1986-10-26,0,1,"chi",6
"9","Mon","November 3","L","","7-2",TRUE,"Los Angeles Rams",17,20,14,269,123,146,3,14,278,137,141,3,1986-11-03,0,0,"chi",-3
"10","Sun","November 9","W","","8-2",FALSE,"Tampa Bay Buccaneers",23,3,20,434,258,176,1,14,272,188,84,2,1986-11-09,1,1,"chi",20
"11","Sun","November 16","W","","9-2",FALSE,"Atlanta Falcons",13,10,15,368,203,165,3,11,159,41,118,3,1986-11-16,0,1,"chi",3
"12","Sun","November 23","W","","10-2",TRUE,"Green Bay Packers",12,10,15,300,102,198,5,11,195,106,89,3,1986-11-23,-2,1,"chi",2
"13","Sun","November 30","W","OT","11-2",TRUE,"Pittsburgh Steelers",13,10,25,406,235,171,3,18,291,159,132,3,1986-11-30,0,1,"chi",3
"14","Sun","December 7","W","","12-2",TRUE,"Tampa Bay Buccaneers",48,14,23,432,187,245,3,13,271,221,50,5,1986-12-07,2,1,"chi",34
"15","Mon","December 15","W","","13-2",FALSE,"Detroit Lions",16,13,18,273,112,161,4,14,160,104,56,2,1986-12-15,-2,1,"chi",3
"16","Sun","December 21","W","","14-2",FALSE,"Dallas Cowboys",24,10,17,322,161,161,6,16,260,150,110,5,1986-12-21,-1,1,"chi",14
"Division","Sat","January 3","L","","14-3",TRUE,"Washington Redskins",13,27,14,220,127,93,4,19,302,168,134,1,1987-01-03,-3,0,"chi",-14
"1","Mon","September 14","W","","1-0",TRUE,"New York Giants",34,19,17,416,292,124,2,14,203,122,81,1,1987-09-14,-1,1,"chi",15
"2","Sun","September 20","W","","2-0",TRUE,"Tampa Bay Buccaneers",20,3,18,301,133,168,4,18,262,173,89,4,1987-09-20,0,1,"chi",17
"3","Sun","October 4","W","","3-0",FALSE,"Philadelphia Eagles",35,3,22,318,184,134,2,14,170,65,105,2,1987-10-04,0,1,"chi",32
"4","Sun","October 11","W","","4-0",TRUE,"Minnesota Vikings",27,7,26,344,159,185,1,15,151,108,43,2,1987-10-11,1,1,"chi",20
"5","Sun","October 18","L","","4-1",TRUE,"New Orleans Saints",17,19,11,133,66,67,4,18,291,179,112,3,1987-10-18,-1,0,"chi",-2
"6","Sun","October 25","W","","5-1",FALSE,"Tampa Bay Buccaneers",27,26,19,300,209,91,4,20,285,184,101,0,1987-10-25,-4,1,"chi",1
"7","Sun","November 1","W","","6-1",TRUE,"Kansas City Chiefs",31,28,20,343,263,80,2,20,367,256,111,2,1987-11-01,0,1,"chi",3
"8","Sun","November 8","W","","7-1",FALSE,"Green Bay Packers",26,24,22,351,247,104,2,17,340,298,42,1,1987-11-08,-1,1,"chi",2
"9","Mon","November 16","L","","7-2",FALSE,"Denver Broncos",29,31,24,446,300,146,2,26,439,341,98,2,1987-11-16,0,0,"chi",-2
"10","Sun","November 22","W","","8-2",TRUE,"Detroit Lions",30,10,29,383,205,178,1,10,179,149,30,2,1987-11-22,1,1,"chi",20
"11","Sun","November 29","W","","9-2",TRUE,"Green Bay Packers",23,10,20,319,192,127,3,20,348,237,111,2,1987-11-29,-1,1,"chi",13
"12","Sun","December 6","W","","10-2",FALSE,"Minnesota Vikings",30,24,26,423,264,159,3,18,356,281,75,1,1987-12-06,-2,1,"chi",6
"13","Mon","December 14","L","","10-3",FALSE,"San Francisco 49ers",0,41,16,263,154,109,6,20,331,133,198,1,1987-12-14,-5,0,"chi",-41
"14","Sun","December 20","L","","10-4",TRUE,"Seattle Seahawks",21,34,31,437,276,161,5,17,300,184,116,0,1987-12-20,-5,0,"chi",-13
"15","Sun","December 27","W","","11-4",FALSE,"Los Angeles Raiders",6,3,18,267,146,121,3,14,193,92,101,1,1987-12-27,-2,1,"chi",3
"Division","Sun","January 10","L","","11-5",TRUE,"Washington Redskins",17,21,15,280,170,110,3,17,272,200,72,2,1988-01-10,-1,0,"chi",-4
"1","Sun","September 4","W","","1-0",TRUE,"Miami Dolphins",34,7,28,427,165,262,0,10,163,118,45,2,1988-09-04,2,1,"chi",27
"2","Sun","September 11","W","","2-0",FALSE,"Indianapolis Colts",17,13,23,326,172,154,1,11,173,65,108,3,1988-09-11,2,1,"chi",4
"3","Sun","September 18","L","","2-1",TRUE,"Minnesota Vikings",7,31,14,235,165,70,5,20,376,249,127,1,1988-09-18,-4,0,"chi",-24
"4","Sun","September 25","W","","3-1",FALSE,"Green Bay Packers",24,6,22,358,116,242,3,16,233,199,34,3,1988-09-25,0,1,"chi",18
"5","Sun","October 2","W","","4-1",TRUE,"Buffalo Bills",24,3,22,423,260,163,2,13,217,217,0,1,1988-10-02,-1,1,"chi",21
"6","Sun","October 9","W","","5-1",FALSE,"Detroit Lions",24,7,20,323,222,101,1,18,262,220,42,2,1988-10-09,1,1,"chi",17
"7","Sun","October 16","W","","6-1",TRUE,"Dallas Cowboys",17,7,24,385,261,124,1,18,291,195,96,2,1988-10-16,1,1,"chi",10
"8","Mon","October 24","W","","7-1",TRUE,"San Francisco 49ers",10,9,14,237,115,122,1,12,213,135,78,1,1988-10-24,0,1,"chi",1
"9","Sun","October 30","L","","7-2",FALSE,"New England Patriots",7,30,11,208,74,134,3,19,350,165,185,1,1988-10-30,-2,0,"chi",-23
"10","Sun","November 6","W","","8-2",TRUE,"Tampa Bay Buccaneers",28,10,19,338,269,69,3,25,357,273,84,2,1988-11-06,-1,1,"chi",18
"11","Sun","November 13","W","","9-2",FALSE,"Washington Redskins",34,14,20,418,273,145,1,22,323,295,28,5,1988-11-13,4,1,"chi",20
"12","Sun","November 20","W","","10-2",FALSE,"Tampa Bay Buccaneers",27,15,16,339,200,139,4,18,321,153,168,3,1988-11-20,-1,1,"chi",12
"13","Sun","November 27","W","","11-2",TRUE,"Green Bay Packers",16,0,22,372,159,213,2,9,189,167,22,2,1988-11-27,0,1,"chi",16
"14","Mon","December 5","L","","11-3",FALSE,"Los Angeles Rams",3,23,13,213,99,114,3,22,364,232,132,3,1988-12-05,0,0,"chi",-20
"15","Sun","December 11","W","","12-3",TRUE,"Detroit Lions",13,12,14,250,168,82,1,14,310,195,115,2,1988-12-11,1,1,"chi",1
"16","Mon","December 19","L","","12-4",FALSE,"Minnesota Vikings",27,28,21,465,280,185,3,17,218,156,62,2,1988-12-19,-1,0,"chi",-1
"Division","Sat","December 31","W","","13-4",TRUE,"Philadelphia Eagles",20,12,14,341,177,164,4,22,430,378,52,3,1988-12-31,-1,1,"chi",8
"ConfChamp","Sun","January 8","L","","13-5",TRUE,"San Francisco 49ers",3,28,15,267,176,91,2,21,406,268,138,1,1989-01-08,-1,0,"chi",-25
"1","Sun","September 10","W","","1-0",TRUE,"Cincinnati Bengals",17,14,19,365,153,212,3,23,330,151,179,0,1989-09-10,-3,1,"chi",3
"2","Sun","September 17","W","","2-0",TRUE,"Minnesota Vikings",38,7,20,306,142,164,1,18,320,253,67,4,1989-09-17,3,1,"chi",31
"3","Sun","September 24","W","","3-0",FALSE,"Detroit Lions",47,27,23,542,323,219,0,20,305,107,198,5,1989-09-24,5,1,"chi",20
"4","Mon","October 2","W","","4-0",TRUE,"Philadelphia Eagles",27,13,22,374,261,113,3,23,435,368,67,6,1989-10-02,3,1,"chi",14
"5","Sun","October 8","L","","4-1",FALSE,"Tampa Bay Buccaneers",35,42,22,350,214,136,3,27,415,268,147,2,1989-10-08,-1,0,"chi",-7
"6","Sun","October 15","L","","4-2",TRUE,"Houston Oilers",28,33,22,332,239,93,6,20,457,317,140,2,1989-10-15,-4,0,"chi",-5
"7","Mon","October 23","L","","4-3",FALSE,"Cleveland Browns",7,27,16,301,152,149,1,17,326,273,53,0,1989-10-23,-1,0,"chi",-20
"8","Sun","October 29","W","","5-3",TRUE,"Los Angeles Rams",20,10,19,318,170,148,0,17,252,168,84,3,1989-10-29,3,1,"chi",10
"9","Sun","November 5","L","","5-4",FALSE,"Green Bay Packers",13,14,19,321,188,133,0,19,339,270,69,2,1989-11-05,2,0,"chi",-1
"10","Sun","November 12","W","","6-4",FALSE,"Pittsburgh Steelers",20,0,20,337,134,203,4,10,216,162,54,6,1989-11-12,2,1,"chi",20
"11","Sun","November 19","L","","6-5",TRUE,"Tampa Bay Buccaneers",31,32,14,377,266,111,4,21,390,263,127,0,1989-11-19,-4,0,"chi",-1
"12","Sun","November 26","L","","6-6",FALSE,"Washington Redskins",14,38,13,191,132,59,3,35,492,390,102,2,1989-11-26,-1,0,"chi",-24
"13","Sun","December 3","L","","6-7",FALSE,"Minnesota Vikings",16,27,18,315,178,137,2,24,387,251,136,2,1989-12-03,0,0,"chi",-11
"14","Sun","December 10","L","","6-8",TRUE,"Detroit Lions",17,27,21,302,172,130,2,17,295,168,127,2,1989-12-10,0,0,"chi",-10
"15","Sun","December 17","L","","6-9",TRUE,"Green Bay Packers",28,40,19,355,197,158,5,24,456,239,217,1,1989-12-17,-4,0,"chi",-12
"16","Sun","December 24","L","","6-10",FALSE,"San Francisco 49ers",0,26,15,289,167,122,5,17,314,184,130,1,1989-12-24,-4,0,"chi",-26
"1","Sun","September 9","W","","1-0",TRUE,"Seattle Seahawks",17,0,21,366,195,171,1,6,132,74,58,3,1990-09-09,2,1,"chi",17
"2","Sun","September 16","W","","2-0",FALSE,"Green Bay Packers",31,13,18,303,157,146,1,18,270,189,81,5,1990-09-16,4,1,"chi",18
"3","Sun","September 23","W","","3-0",TRUE,"Minnesota Vikings",19,16,15,255,40,215,1,15,285,152,133,2,1990-09-23,1,1,"chi",3
"4","Sun","September 30","L","","3-1",FALSE,"Los Angeles Raiders",10,24,11,229,128,101,1,18,326,170,156,2,1990-09-30,1,0,"chi",-14
"5","Sun","October 7","W","","4-1",TRUE,"Green Bay Packers",27,13,21,353,151,202,2,10,237,205,32,3,1990-10-07,1,1,"chi",14
"6","Sun","October 14","W","","5-1",TRUE,"Los Angeles Rams",38,9,22,402,248,154,0,15,267,179,88,1,1990-10-14,1,1,"chi",29
"8","Sun","October 28","W","","6-1",FALSE,"Phoenix Cardinals",31,21,20,382,159,223,1,19,331,223,108,1,1990-10-28,0,1,"chi",10
"9","Sun","November 4","W","","7-1",FALSE,"Tampa Bay Buccaneers",26,6,21,378,191,187,3,9,205,113,92,6,1990-11-04,3,1,"chi",20
"10","Sun","November 11","W","","8-1",TRUE,"Atlanta Falcons",30,24,19,287,187,100,2,17,276,227,49,5,1990-11-11,3,1,"chi",6
"11","Sun","November 18","W","OT","9-1",FALSE,"Denver Broncos",16,13,21,341,139,202,0,21,330,222,108,2,1990-11-18,2,1,"chi",3
"12","Sun","November 25","L","","9-2",FALSE,"Minnesota Vikings",13,41,19,266,159,107,3,20,246,145,101,0,1990-11-25,-3,0,"chi",-28
"13","Sun","December 2","W","OT","10-2",TRUE,"Detroit Lions",23,17,21,361,197,164,0,17,296,204,92,2,1990-12-02,2,1,"chi",6
"14","Sun","December 9","L","","10-3",FALSE,"Washington Redskins",9,10,17,288,181,107,3,15,288,137,151,5,1990-12-09,2,0,"chi",-1
"15","Sun","December 16","L","","10-4",FALSE,"Detroit Lions",21,38,19,225,88,137,2,20,411,310,101,3,1990-12-16,1,0,"chi",-17
"16","Sun","December 23","W","","11-4",TRUE,"Tampa Bay Buccaneers",27,14,24,368,249,119,3,13,209,110,99,3,1990-12-23,0,1,"chi",13
"17","Sat","December 29","L","","11-5",TRUE,"Kansas City Chiefs",10,21,6,176,75,101,3,23,383,260,123,2,1990-12-29,-1,0,"chi",-11
"WildCard","Sun","January 6","W","","12-5",TRUE,"New Orleans Saints",16,6,18,365,176,189,1,11,193,128,65,3,1991-01-06,2,1,"chi",10
"Division","Sun","January 13","L","","12-6",FALSE,"New York Giants",3,31,11,232,205,27,2,23,288,94,194,1,1991-01-13,-1,0,"chi",-28
"1","Sun","September 1","W","","1-0",TRUE,"Minnesota Vikings",10,6,17,276,186,90,0,14,331,245,86,3,1991-09-01,3,1,"chi",4
"2","Sun","September 8","W","","2-0",FALSE,"Tampa Bay Buccaneers",21,20,20,247,147,100,4,16,257,125,132,1,1991-09-08,-3,1,"chi",1
"3","Sun","September 15","W","","3-0",TRUE,"New York Giants",20,17,10,307,206,101,3,21,337,205,132,2,1991-09-15,-1,1,"chi",3
"4","Mon","September 23","W","OT","4-0",TRUE,"New York Jets",19,13,26,393,289,104,1,24,346,177,169,1,1991-09-23,0,1,"chi",6
"5","Sun","September 29","L","","4-1",FALSE,"Buffalo Bills",20,35,20,353,269,84,1,22,422,280,142,1,1991-09-29,0,0,"chi",-15
"6","Sun","October 6","L","","4-2",TRUE,"Washington Redskins",7,20,19,319,199,120,3,12,243,168,75,1,1991-10-06,-2,0,"chi",-13
"8","Thu","October 17","W","","5-2",FALSE,"Green Bay Packers",10,0,18,298,137,161,2,5,141,50,91,2,1991-10-17,0,1,"chi",10
"9","Sun","October 27","W","","6-2",FALSE,"New Orleans Saints",20,17,11,178,36,142,2,13,313,262,51,3,1991-10-27,1,1,"chi",3
"10","Sun","November 3","W","","7-2",TRUE,"Detroit Lions",20,10,16,291,187,104,1,16,275,203,72,3,1991-11-03,2,1,"chi",10
"11","Mon","November 11","W","","8-2",FALSE,"Minnesota Vikings",34,17,28,358,180,178,2,15,255,168,87,1,1991-11-11,-1,1,"chi",17
"12","Sun","November 17","W","","9-2",FALSE,"Indianapolis Colts",31,17,25,448,273,175,2,14,251,140,111,0,1991-11-17,-2,1,"chi",14
"13","Sun","November 24","L","OT","9-3",TRUE,"Miami Dolphins",13,16,23,328,204,124,1,17,275,172,103,3,1991-11-24,2,0,"chi",-3
"14","Thu","November 28","L","","9-4",FALSE,"Detroit Lions",6,16,18,319,231,88,6,11,208,108,100,2,1991-11-28,-4,0,"chi",-10
"15","Sun","December 8","W","","10-4",TRUE,"Green Bay Packers",27,13,22,296,195,101,2,17,261,199,62,2,1991-12-08,0,1,"chi",14
"16","Sat","December 14","W","","11-4",TRUE,"Tampa Bay Buccaneers",27,0,23,254,72,182,0,7,106,54,52,4,1991-12-14,4,1,"chi",27
"17","Mon","December 23","L","","11-5",FALSE,"San Francisco 49ers",14,52,21,404,309,95,3,30,486,371,115,1,1991-12-23,-2,0,"chi",-38
"WildCard","Sun","December 29","L","","11-6",TRUE,"Dallas Cowboys",13,17,26,372,222,150,3,15,288,180,108,0,1991-12-29,-3,0,"chi",-4
"1","Sun","September 6","W","","1-0",TRUE,"Detroit Lions",27,24,21,367,227,140,0,17,353,232,121,1,1992-09-06,1,1,"chi",3
"2","Sun","September 13","L","","1-1",FALSE,"New Orleans Saints",6,28,19,381,240,141,3,15,345,251,94,2,1992-09-13,-1,0,"chi",-22
"3","Mon","September 21","L","","1-2",TRUE,"New York Giants",14,27,16,274,175,99,2,26,386,212,174,1,1992-09-21,-1,0,"chi",-13
"4","Sun","September 27","W","","2-2",TRUE,"Atlanta Falcons",41,31,23,489,272,217,0,19,348,324,24,1,1992-09-27,1,1,"chi",10
"5","Sun","October 4","L","","2-3",FALSE,"Minnesota Vikings",20,21,19,275,189,86,2,18,332,205,127,4,1992-10-04,2,0,"chi",-1
"7","Sun","October 18","W","","3-3",TRUE,"Tampa Bay Buccaneers",31,14,18,391,298,93,1,18,298,172,126,3,1992-10-18,2,1,"chi",17
"8","Sun","October 25","W","","4-3",FALSE,"Green Bay Packers",30,10,26,356,226,130,0,14,248,188,60,2,1992-10-25,2,1,"chi",20
"9","Mon","November 2","L","","4-4",TRUE,"Minnesota Vikings",10,38,16,293,165,128,4,18,312,148,164,1,1992-11-02,-3,0,"chi",-28
"10","Sun","November 8","L","OT","4-5",TRUE,"Cincinnati Bengals",28,31,15,301,149,152,4,17,287,140,147,1,1992-11-08,-3,0,"chi",-3
"11","Sun","November 15","L","","4-6",FALSE,"Tampa Bay Buccaneers",17,20,19,315,202,113,1,14,299,172,127,1,1992-11-15,0,0,"chi",-3
"12","Sun","November 22","L","","4-7",TRUE,"Green Bay Packers",3,17,15,305,251,54,2,18,334,204,130,1,1992-11-22,-1,0,"chi",-14
"13","Sun","November 29","L","","4-8",FALSE,"Cleveland Browns",14,27,16,320,247,73,4,12,178,47,131,0,1992-11-29,-4,0,"chi",-13
"14","Mon","December 7","L","","4-9",FALSE,"Houston Oilers",7,24,14,257,158,99,3,21,339,164,175,0,1992-12-07,-3,0,"chi",-17
"15","Sun","December 13","W","","5-9",TRUE,"Pittsburgh Steelers",30,6,20,283,71,212,0,10,140,105,35,4,1992-12-13,4,1,"chi",24
"16","Sun","December 20","L","","5-10",FALSE,"Detroit Lions",3,16,16,242,136,106,4,15,399,265,134,4,1992-12-20,0,0,"chi",-13
"17","Sun","December 27","L","","5-11",FALSE,"Dallas Cowboys",14,27,9,92,64,28,4,22,354,175,179,4,1992-12-27,0,0,"chi",-13
"1","Sun","September 5","L","","0-1",TRUE,"New York Giants",20,26,17,269,166,103,2,21,361,256,105,0,1993-09-05,-2,0,"chi",-6
"2","Sun","September 12","L","","0-2",FALSE,"Minnesota Vikings",7,10,7,140,52,88,1,15,276,155,121,1,1993-09-12,0,0,"chi",-3
"4","Sun","September 26","W","","1-2",TRUE,"Tampa Bay Buccaneers",47,17,18,332,206,126,1,17,328,292,36,7,1993-09-26,6,1,"chi",30
"5","Sun","October 3","W","","2-2",TRUE,"Atlanta Falcons",6,0,14,220,114,106,0,16,271,184,87,3,1993-10-03,3,1,"chi",6
"6","Sun","October 10","W","","3-2",FALSE,"Philadelphia Eagles",17,6,15,261,159,102,2,14,276,166,110,4,1993-10-10,2,1,"chi",11
"8","Mon","October 25","L","","3-3",TRUE,"Minnesota Vikings",12,19,12,250,159,91,3,14,252,87,165,1,1993-10-25,-2,0,"chi",-7
"9","Sun","October 31","L","","3-4",FALSE,"Green Bay Packers",3,17,15,230,112,118,3,16,261,126,135,1,1993-10-31,-2,0,"chi",-14
"10","Sun","November 7","L","","3-5",TRUE,"Los Angeles Raiders",14,16,19,261,137,124,1,20,274,95,179,0,1993-11-07,-1,0,"chi",-2
"11","Sun","November 14","W","","4-5",FALSE,"San Diego Chargers",16,13,14,224,140,84,2,19,256,152,104,0,1993-11-14,-2,1,"chi",3
"12","Sun","November 21","W","","5-5",FALSE,"Kansas City Chiefs",19,17,18,281,96,185,2,19,252,119,133,1,1993-11-21,-1,1,"chi",2
"13","Thu","November 25","W","","6-5",FALSE,"Detroit Lions",10,6,11,225,113,112,2,14,230,146,84,4,1993-11-25,2,1,"chi",4
"14","Sun","December 5","W","","7-5",TRUE,"Green Bay Packers",30,17,10,210,141,69,2,29,466,387,79,5,1993-12-05,3,1,"chi",13
"15","Sun","December 12","L","","7-6",FALSE,"Tampa Bay Buccaneers",10,13,18,286,167,119,2,13,215,112,103,1,1993-12-12,-1,0,"chi",-3
"16","Sat","December 18","L","","7-7",TRUE,"Denver Broncos",3,13,14,185,101,84,5,15,234,105,129,1,1993-12-18,-4,0,"chi",-10
"17","Sun","December 26","L","","7-8",TRUE,"Detroit Lions",14,20,14,180,103,77,1,20,307,223,84,1,1993-12-26,0,0,"chi",-6
"18","Sun","January 2","L","","7-9",FALSE,"Los Angeles Rams",6,20,10,163,74,89,1,27,394,213,181,0,1994-01-02,-1,0,"chi",-14
"1","Sun","September 4","W","","1-0",TRUE,"Tampa Bay Buccaneers",21,9,17,270,204,66,0,17,304,181,123,0,1994-09-04,0,1,"chi",12
"2","Mon","September 12","L","","1-1",FALSE,"Philadelphia Eagles",22,30,13,312,275,37,1,24,416,311,105,0,1994-09-12,-1,0,"chi",-8
"3","Sun","September 18","L","","1-2",TRUE,"Minnesota Vikings",14,42,19,304,244,60,2,28,464,252,212,2,1994-09-18,0,0,"chi",-28
"4","Sun","September 25","W","","2-2",FALSE,"New York Jets",19,7,17,226,122,104,0,17,325,161,164,3,1994-09-25,3,1,"chi",12
"5","Sun","October 2","W","","3-2",TRUE,"Buffalo Bills",20,13,17,261,150,111,1,13,204,99,105,3,1994-10-02,2,1,"chi",7
"6","Sun","October 9","W","","4-2",TRUE,"New Orleans Saints",17,7,16,305,174,131,1,17,316,209,107,2,1994-10-09,1,1,"chi",10
"8","Sun","October 23","L","","4-3",FALSE,"Detroit Lions",16,21,22,402,285,117,4,8,232,49,183,3,1994-10-23,-1,0,"chi",-5
"9","Mon","October 31","L","","4-4",TRUE,"Green Bay Packers",6,33,12,253,159,94,5,17,305,82,223,0,1994-10-31,-5,0,"chi",-27
"10","Sun","November 6","W","","5-4",FALSE,"Tampa Bay Buccaneers",20,6,23,383,205,178,1,9,188,150,38,1,1994-11-06,0,1,"chi",14
"11","Sun","November 13","W","","6-4",FALSE,"Miami Dolphins",17,14,18,273,211,62,2,18,344,275,69,2,1994-11-13,0,1,"chi",3
"12","Sun","November 20","W","","7-4",TRUE,"Detroit Lions",20,10,23,338,177,161,1,11,180,128,52,0,1994-11-20,-1,1,"chi",10
"13","Sun","November 27","W","OT","8-4",FALSE,"Arizona Cardinals",19,16,20,318,186,132,2,15,244,177,67,1,1994-11-27,-1,1,"chi",3
"14","Thu","December 1","L","OT","8-5",FALSE,"Minnesota Vikings",27,33,15,312,232,80,3,21,385,285,100,2,1994-12-01,-1,0,"chi",-6
"15","Sun","December 11","L","","8-6",FALSE,"Green Bay Packers",3,40,9,176,149,27,2,28,516,259,257,1,1994-12-11,-1,0,"chi",-37
"16","Sun","December 18","W","","9-6",TRUE,"Los Angeles Rams",27,13,19,298,135,163,0,13,243,206,37,1,1994-12-18,1,1,"chi",14
"17","Sat","December 24","L","","9-7",TRUE,"New England Patriots",3,13,14,248,183,65,1,19,343,263,80,1,1994-12-24,0,0,"chi",-10
"WildCard","Sun","January 1","W","","10-7",FALSE,"Minnesota Vikings",35,18,18,308,214,94,2,22,391,342,49,4,1995-01-01,2,1,"chi",17
"Division","Sat","January 7","L","","10-8",FALSE,"San Francisco 49ers",15,44,20,247,208,39,2,27,330,185,145,1,1995-01-07,-1,0,"chi",-29
"1","Sun","September 3","W","","1-0",TRUE,"Minnesota Vikings",31,14,20,397,254,143,1,21,348,230,118,1,1995-09-03,0,1,"chi",17
"2","Mon","September 11","L","","1-1",TRUE,"Green Bay Packers",24,27,17,243,151,92,2,23,431,306,125,1,1995-09-11,-1,0,"chi",-3
"3","Sun","September 17","W","","2-1",FALSE,"Tampa Bay Buccaneers",25,6,20,335,207,128,2,15,239,165,74,7,1995-09-17,5,1,"chi",19
"4","Sun","September 24","L","","2-2",FALSE,"St. Louis Rams",28,34,20,364,317,47,2,22,339,233,106,0,1995-09-24,-2,0,"chi",-6
"6","Sun","October 8","W","","3-2",TRUE,"Carolina Panthers",31,27,27,390,249,141,1,10,297,228,69,1,1995-10-08,0,1,"chi",4
"7","Sun","October 15","W","","4-2",FALSE,"Jacksonville Jaguars",30,27,23,380,245,135,0,26,409,288,121,1,1995-10-15,1,1,"chi",3
"8","Sun","October 22","W","","5-2",TRUE,"Houston Oilers",35,32,26,480,349,131,3,15,327,281,46,3,1995-10-22,0,1,"chi",3
"9","Mon","October 30","W","","6-2",FALSE,"Minnesota Vikings",14,6,19,311,231,80,1,19,297,227,70,1,1995-10-30,0,1,"chi",8
"10","Sun","November 5","L","OT","6-3",TRUE,"Pittsburgh Steelers",34,37,20,343,223,120,5,27,383,298,85,4,1995-11-05,-1,0,"chi",-3
"11","Sun","November 12","L","","6-4",FALSE,"Green Bay Packers",28,35,26,444,304,140,1,18,356,313,43,0,1995-11-12,-1,0,"chi",-7
"12","Sun","November 19","L","","6-5",TRUE,"Detroit Lions",17,24,20,311,231,80,1,24,422,279,143,3,1995-11-19,2,0,"chi",-7
"13","Sun","November 26","W","","7-5",FALSE,"New York Giants",27,24,26,409,266,143,1,23,338,217,121,0,1995-11-26,-1,1,"chi",3
"14","Mon","December 4","L","","7-6",FALSE,"Detroit Lions",7,27,13,185,108,77,0,27,419,310,109,0,1995-12-04,0,0,"chi",-20
"15","Sun","December 10","L","","7-7",FALSE,"Cincinnati Bengals",10,16,17,302,183,119,1,19,337,246,91,0,1995-12-10,-1,0,"chi",-6
"16","Sun","December 17","W","","8-7",TRUE,"Tampa Bay Buccaneers",31,10,23,429,256,173,1,15,289,213,76,4,1995-12-17,3,1,"chi",21
"17","Sun","December 24","W","","9-7",TRUE,"Philadelphia Eagles",20,14,23,350,169,181,4,12,211,167,44,3,1995-12-24,-1,1,"chi",6
"1","Mon","September 2","W","","1-0",TRUE,"Dallas Cowboys",22,6,14,304,213,91,2,18,256,173,83,4,1996-09-02,2,1,"chi",16
"2","Sun","September 8","L","","1-1",FALSE,"Washington Redskins",3,10,19,304,156,148,2,13,249,168,81,1,1996-09-08,-1,0,"chi",-7
"3","Sun","September 15","L","","1-2",TRUE,"Minnesota Vikings",14,20,17,299,191,108,3,21,377,239,138,1,1996-09-15,-2,0,"chi",-6
"4","Sun","September 22","L","","1-3",FALSE,"Detroit Lions",16,35,19,318,248,70,2,19,394,309,85,1,1996-09-22,-1,0,"chi",-19
"5","Sun","September 29","W","","2-3",TRUE,"Oakland Raiders",19,17,15,296,188,108,0,17,283,166,117,4,1996-09-29,4,1,"chi",2
"6","Sun","October 6","L","","2-4",TRUE,"Green Bay Packers",6,37,15,243,190,53,3,21,343,243,100,1,1996-10-06,-2,0,"chi",-31
"7","Sun","October 13","L","","2-5",FALSE,"New Orleans Saints",24,27,18,327,222,105,1,23,423,218,205,4,1996-10-13,3,0,"chi",-3
"9","Mon","October 28","W","","3-5",FALSE,"Minnesota Vikings",15,13,18,276,180,96,2,16,279,268,11,2,1996-10-28,0,1,"chi",2
"10","Sun","November 3","W","","4-5",TRUE,"Tampa Bay Buccaneers",13,10,18,269,84,185,1,14,245,178,67,2,1996-11-03,1,1,"chi",3
"11","Sun","November 10","L","","4-6",FALSE,"Denver Broncos",12,17,24,346,172,174,3,17,284,192,92,0,1996-11-10,-3,0,"chi",-5
"12","Sun","November 17","L","","4-7",FALSE,"Kansas City Chiefs",10,14,14,256,221,35,2,20,300,151,149,2,1996-11-17,0,0,"chi",-4
"13","Sun","November 24","W","","5-7",TRUE,"Detroit Lions",31,14,22,358,219,139,2,27,322,208,114,3,1996-11-24,1,1,"chi",17
"14","Sun","December 1","L","","5-8",FALSE,"Green Bay Packers",17,28,21,292,204,88,1,20,342,216,126,0,1996-12-01,-1,0,"chi",-11
"15","Sun","December 8","W","","6-8",TRUE,"St. Louis Rams",35,9,22,384,222,162,1,17,323,229,94,2,1996-12-08,1,1,"chi",26
"16","Sat","December 14","W","","7-8",TRUE,"San Diego Chargers",27,14,19,294,203,91,0,17,283,217,66,1,1996-12-14,1,1,"chi",13
"17","Sun","December 22","L","","7-9",FALSE,"Tampa Bay Buccaneers",19,34,25,339,272,67,2,15,181,92,89,0,1996-12-22,-2,0,"chi",-15
"1","Mon","September 1","L","","0-1",FALSE,"Green Bay Packers",24,38,19,336,172,164,3,18,315,208,107,2,1997-09-01,-1,0,"chi",-14
"2","Sun","September 7","L","","0-2",TRUE,"Minnesota Vikings",24,27,16,305,158,147,2,23,378,261,117,1,1997-09-07,-1,0,"chi",-3
"3","Sun","September 14","L","","0-3",TRUE,"Detroit Lions",7,32,19,284,190,94,2,27,404,202,202,1,1997-09-14,-1,0,"chi",-25
"4","Sun","September 21","L","","0-4",FALSE,"New England Patriots",3,31,9,199,120,79,3,23,402,315,87,3,1997-09-21,0,0,"chi",-28
"5","Sun","September 28","L","","0-5",FALSE,"Dallas Cowboys",3,27,17,243,102,141,2,13,180,124,56,1,1997-09-28,-1,0,"chi",-24
"6","Sun","October 5","L","","0-6",TRUE,"New Orleans Saints",17,20,19,266,165,101,0,11,322,185,137,3,1997-10-05,3,0,"chi",-3
"7","Sun","October 12","L","","0-7",TRUE,"Green Bay Packers",23,24,26,353,232,121,2,22,277,177,100,1,1997-10-12,-1,0,"chi",-1
"9","Mon","October 27","W","OT","1-7",FALSE,"Miami Dolphins",36,33,26,464,336,128,2,18,365,246,119,3,1997-10-27,1,1,"chi",3
"10","Sun","November 2","L","","1-8",TRUE,"Washington Redskins",8,31,23,336,274,62,4,24,388,185,203,1,1997-11-02,-3,0,"chi",-23
"11","Sun","November 9","L","","1-9",FALSE,"Minnesota Vikings",22,29,20,341,251,90,2,19,302,193,109,2,1997-11-09,0,0,"chi",-7
"12","Sun","November 16","L","","1-10",TRUE,"New York Jets",15,23,27,356,307,49,5,11,193,116,77,1,1997-11-16,-4,0,"chi",-8
"13","Sun","November 23","W","","2-10",TRUE,"Tampa Bay Buccaneers",13,7,17,279,110,169,0,14,272,237,35,3,1997-11-23,3,1,"chi",6
"14","Thu","November 27","L","","2-11",FALSE,"Detroit Lions",20,55,16,333,262,71,4,25,496,274,222,1,1997-11-27,-3,0,"chi",-35
"15","Sun","December 7","W","","3-11",TRUE,"Buffalo Bills",20,3,23,392,272,120,2,10,160,105,55,1,1997-12-07,-1,1,"chi",17
"16","Sun","December 14","W","","4-11",FALSE,"St. Louis Rams",13,10,13,309,189,120,5,11,165,116,49,5,1997-12-14,0,1,"chi",3
"17","Sun","December 21","L","","4-12",FALSE,"Tampa Bay Buccaneers",15,31,15,194,104,90,3,12,269,86,183,1,1997-12-21,-2,0,"chi",-16
"1","Sun","September 6","L","","0-1",TRUE,"Jacksonville Jaguars",23,24,16,321,189,132,2,21,367,207,160,3,1998-09-06,1,0,"chi",-1
"2","Sun","September 13","L","","0-2",FALSE,"Pittsburgh Steelers",12,17,19,320,190,130,2,17,251,109,142,1,1998-09-13,-1,0,"chi",-5
"3","Sun","September 20","L","","0-3",FALSE,"Tampa Bay Buccaneers",15,27,13,254,169,85,2,20,364,144,220,2,1998-09-20,0,0,"chi",-12
"4","Sun","September 27","L","","0-4",TRUE,"Minnesota Vikings",28,31,23,452,361,91,1,17,351,258,93,0,1998-09-27,-1,0,"chi",-3
"5","Sun","October 4","W","","1-4",TRUE,"Detroit Lions",31,27,23,405,280,125,5,15,340,246,94,0,1998-10-04,-5,1,"chi",4
"6","Sun","October 11","L","","1-5",FALSE,"Arizona Cardinals",7,20,12,289,223,66,8,21,288,150,138,5,1998-10-11,-3,0,"chi",-13
"7","Sun","October 18","W","","2-5",TRUE,"Dallas Cowboys",13,12,18,299,220,79,2,13,236,128,108,1,1998-10-18,-1,1,"chi",1
"8","Sun","October 25","W","","3-5",FALSE,"Tennessee Oilers",23,20,20,286,138,148,1,25,356,176,180,4,1998-10-25,3,1,"chi",3
"10","Sun","November 8","L","","3-6",TRUE,"St. Louis Rams",12,20,15,251,122,129,1,20,266,202,64,1,1998-11-08,0,0,"chi",-8
"11","Sun","November 15","L","","3-7",FALSE,"Detroit Lions",3,26,14,252,147,105,0,24,391,246,145,0,1998-11-15,0,0,"chi",-23
"12","Sun","November 22","L","","3-8",FALSE,"Atlanta Falcons",13,20,10,210,104,106,3,21,358,263,95,2,1998-11-22,-1,0,"chi",-7
"13","Sun","November 29","L","","3-9",TRUE,"Tampa Bay Buccaneers",17,31,13,224,155,69,2,13,267,153,114,2,1998-11-29,0,0,"chi",-14
"14","Sun","December 6","L","","3-10",FALSE,"Minnesota Vikings",22,48,19,339,272,67,2,23,458,349,109,1,1998-12-06,-1,0,"chi",-26
"15","Sun","December 13","L","","3-11",FALSE,"Green Bay Packers",20,26,12,192,98,94,0,24,393,274,119,2,1998-12-13,2,0,"chi",-6
"16","Sun","December 20","W","","4-11",TRUE,"Baltimore Ravens",24,3,20,391,202,189,0,12,178,154,24,1,1998-12-20,1,1,"chi",21
"17","Sun","December 27","L","","4-12",TRUE,"Green Bay Packers",13,16,17,281,183,98,3,14,239,169,70,3,1998-12-27,0,0,"chi",-3
"1","Sun","September 12","W","","1-0",TRUE,"Kansas City Chiefs",20,17,22,388,307,81,2,17,349,278,71,1,1999-09-12,-1,1,"chi",3
"2","Sun","September 19","L","","1-1",TRUE,"Seattle Seahawks",13,14,20,311,196,115,1,19,349,249,100,3,1999-09-19,2,0,"chi",-1
"3","Sun","September 26","L","","1-2",FALSE,"Oakland Raiders",17,24,11,232,198,34,3,22,392,283,109,5,1999-09-26,2,0,"chi",-7
"4","Sun","October 3","W","","2-2",TRUE,"New Orleans Saints",14,10,20,324,212,112,5,17,269,132,137,1,1999-10-03,-4,1,"chi",4
"5","Sun","October 10","W","","3-2",FALSE,"Minnesota Vikings",24,22,23,379,278,101,0,26,445,279,166,5,1999-10-10,5,1,"chi",2
"6","Sun","October 17","L","","3-3",TRUE,"Philadelphia Eagles",16,20,17,352,239,113,2,19,316,217,99,2,1999-10-17,0,0,"chi",-4
"7","Sun","October 24","L","","3-4",FALSE,"Tampa Bay Buccaneers",3,6,15,275,189,86,2,11,225,101,124,0,1999-10-24,-2,0,"chi",-3
"8","Sun","October 31","L","","3-5",FALSE,"Washington Redskins",22,48,22,445,371,74,5,18,376,212,164,1,1999-10-31,-4,0,"chi",-26
"9","Sun","November 7","W","","4-5",FALSE,"Green Bay Packers",14,13,19,311,151,160,4,21,339,254,85,1,1999-11-07,-3,1,"chi",1
"10","Sun","November 14","L","OT","4-6",TRUE,"Minnesota Vikings",24,27,21,456,407,49,2,23,459,349,110,3,1999-11-14,1,0,"chi",-3
"11","Sun","November 21","W","OT","5-6",FALSE,"San Diego Chargers",23,20,19,430,355,75,1,20,348,264,84,1,1999-11-21,0,1,"chi",3
"12","Thu","November 25","L","","5-7",FALSE,"Detroit Lions",17,21,12,236,184,52,1,20,377,293,84,1,1999-11-25,0,0,"chi",-4
"13","Sun","December 5","L","","5-8",TRUE,"Green Bay Packers",19,35,17,297,206,91,2,19,327,139,188,3,1999-12-05,1,0,"chi",-16
"15","Sun","December 19","W","","6-8",TRUE,"Detroit Lions",28,10,27,396,292,104,2,19,339,236,103,4,1999-12-19,2,1,"chi",18
"16","Sun","December 26","L","","6-9",FALSE,"St. Louis Rams",12,34,24,434,365,69,3,23,476,361,115,2,1999-12-26,-1,0,"chi",-22
"17","Sun","January 2","L","","6-10",TRUE,"Tampa Bay Buccaneers",6,20,13,257,186,71,2,16,318,175,143,0,2000-01-02,-2,0,"chi",-14
"1","Sun","September 3","L","","0-1",FALSE,"Minnesota Vikings",27,30,23,425,272,153,1,17,374,188,186,1,2000-09-03,0,0,"chi",-3
"2","Sun","September 10","L","","0-2",FALSE,"Tampa Bay Buccaneers",0,41,9,165,49,116,4,21,327,171,156,0,2000-09-10,-4,0,"chi",-41
"3","Sun","September 17","L","","0-3",TRUE,"New York Giants",7,14,13,228,180,48,1,23,409,237,172,1,2000-09-17,0,0,"chi",-7
"4","Sun","September 24","L","","0-4",TRUE,"Detroit Lions",14,21,16,401,254,147,5,15,274,194,80,1,2000-09-24,-4,0,"chi",-7
"5","Sun","October 1","W","","1-4",FALSE,"Green Bay Packers",27,24,13,370,192,178,0,22,364,320,44,3,2000-10-01,3,1,"chi",3
"6","Sun","October 8","L","","1-5",TRUE,"New Orleans Saints",10,31,13,245,173,72,3,24,403,217,186,1,2000-10-08,-2,0,"chi",-21
"7","Sun","October 15","L","","1-6",TRUE,"Minnesota Vikings",16,28,17,294,196,98,0,17,368,177,191,1,2000-10-15,1,0,"chi",-12
"8","Sun","October 22","L","","1-7",FALSE,"Philadelphia Eagles",9,13,14,274,160,114,1,17,298,201,97,2,2000-10-22,1,0,"chi",-4
"10","Sun","November 5","W","","2-7",TRUE,"Indianapolis Colts",27,24,20,370,227,143,0,20,371,281,90,2,2000-11-05,2,1,"chi",3
"11","Sun","November 12","L","","2-8",FALSE,"Buffalo Bills",3,20,12,234,135,99,4,14,299,194,105,1,2000-11-12,-3,0,"chi",-17
"12","Sun","November 19","W","","3-8",TRUE,"Tampa Bay Buccaneers",13,10,15,243,160,83,1,14,225,60,165,3,2000-11-19,2,1,"chi",3
"13","Sun","November 26","L","","3-9",FALSE,"New York Jets",10,17,13,233,98,135,3,17,277,218,59,1,2000-11-26,-2,0,"chi",-7
"14","Sun","December 3","L","","3-10",TRUE,"Green Bay Packers",6,28,17,330,226,104,2,17,304,223,81,0,2000-12-03,-2,0,"chi",-22
"15","Sun","December 10","W","","4-10",TRUE,"New England Patriots",24,17,21,339,237,102,1,15,245,207,38,0,2000-12-10,-1,1,"chi",7
"16","Sun","December 17","L","","4-11",FALSE,"San Francisco 49ers",0,17,8,104,65,39,1,26,456,379,77,1,2000-12-17,0,0,"chi",-17
"17","Sun","December 24","W","","5-11",FALSE,"Detroit Lions",23,20,15,286,181,105,2,18,240,140,100,2,2000-12-24,0,1,"chi",3
"1","Sun","September 9","L","","0-1",FALSE,"Baltimore Ravens",6,17,16,189,133,56,2,19,316,262,54,2,2001-09-09,0,0,"chi",-11
"2","Sun","September 23","W","","1-1",TRUE,"Minnesota Vikings",17,10,15,284,237,47,1,19,319,215,104,2,2001-09-23,1,1,"chi",7
"4","Sun","October 7","W","","2-1",FALSE,"Atlanta Falcons",31,3,15,300,221,79,2,19,335,232,103,5,2001-10-07,3,1,"chi",28
"5","Sun","October 14","W","","3-1",TRUE,"Arizona Cardinals",20,13,13,253,116,137,3,16,288,206,82,1,2001-10-14,-2,1,"chi",7
"6","Sun","October 21","W","","4-1",FALSE,"Cincinnati Bengals",24,0,21,435,232,203,1,16,264,229,35,1,2001-10-21,0,1,"chi",24
"7","Sun","October 28","W","OT","5-1",TRUE,"San Francisco 49ers",37,31,29,364,229,135,3,20,350,267,83,2,2001-10-28,-1,1,"chi",6
"8","Sun","November 4","W","OT","6-1",TRUE,"Cleveland Browns",27,21,29,413,314,99,4,12,261,191,70,1,2001-11-04,-3,1,"chi",6
"9","Sun","November 11","L","","6-2",TRUE,"Green Bay Packers",12,20,17,262,215,47,1,17,368,268,100,2,2001-11-11,1,0,"chi",-8
"10","Sun","November 18","W","","7-2",FALSE,"Tampa Bay Buccaneers",27,24,13,274,206,68,1,26,414,395,19,4,2001-11-18,3,1,"chi",3
"11","Sun","November 25","W","","8-2",FALSE,"Minnesota Vikings",13,6,11,235,93,142,1,15,316,192,124,1,2001-11-25,0,1,"chi",7
"12","Sun","December 2","W","","9-2",TRUE,"Detroit Lions",13,10,18,232,124,108,1,17,295,228,67,1,2001-12-02,0,1,"chi",3
"13","Sun","December 9","L","","9-3",FALSE,"Green Bay Packers",7,17,11,189,139,50,1,17,352,185,167,1,2001-12-09,0,0,"chi",-10
"14","Sun","December 16","W","","10-3",TRUE,"Tampa Bay Buccaneers",27,3,21,379,172,207,1,10,238,177,61,4,2001-12-16,3,1,"chi",24
"15","Sun","December 23","W","","11-3",FALSE,"Washington Redskins",20,15,14,237,125,112,1,18,293,204,89,2,2001-12-23,1,1,"chi",5
"16","Sun","December 30","W","","12-3",FALSE,"Detroit Lions",24,0,15,326,243,83,0,19,332,268,64,5,2001-12-30,5,1,"chi",24
"17","Sun","January 6","W","","13-3",TRUE,"Jacksonville Jaguars",33,13,19,322,153,169,1,17,237,146,91,3,2002-01-06,2,1,"chi",20
"Division","Sat","January 19","L","","13-4",TRUE,"Philadelphia Eagles",19,33,10,184,73,111,4,19,336,249,87,1,2002-01-19,-3,0,"chi",-14
"1","Sun","September 8","W","","1-0",TRUE,"Minnesota Vikings",27,23,20,368,288,80,2,19,368,228,140,3,2002-09-08,1,1,"chi",4
"2","Sun","September 15","W","","2-0",FALSE,"Atlanta Falcons",14,13,13,242,136,106,2,19,257,135,122,3,2002-09-15,1,1,"chi",1
"3","Sun","September 22","L","","2-1",TRUE,"New Orleans Saints",23,29,21,353,228,125,2,18,302,229,73,3,2002-09-22,1,0,"chi",-6
"4","Sun","September 29","L","OT","2-2",FALSE,"Buffalo Bills",27,33,15,240,188,52,0,26,410,307,103,1,2002-09-29,1,0,"chi",-6
"5","Mon","October 7","L","","2-3",TRUE,"Green Bay Packers",21,34,20,380,335,45,4,20,457,333,124,1,2002-10-07,-3,0,"chi",-13
"7","Sun","October 20","L","OT","2-4",FALSE,"Detroit Lions",20,23,17,224,135,89,3,23,362,170,192,1,2002-10-20,-2,0,"chi",-3
"8","Sun","October 27","L","","2-5",FALSE,"Minnesota Vikings",7,25,12,218,174,44,3,24,364,216,148,1,2002-10-27,-2,0,"chi",-18
"9","Sun","November 3","L","","2-6",TRUE,"Philadelphia Eagles",13,19,18,260,186,74,1,23,309,192,117,1,2002-11-03,0,0,"chi",-6
"10","Sun","November 10","L","","2-7",TRUE,"New England Patriots",30,33,14,299,174,125,1,19,397,315,82,2,2002-11-10,1,0,"chi",-3
"11","Mon","November 18","L","","2-8",FALSE,"St. Louis Rams",16,21,16,220,117,103,0,21,388,327,61,2,2002-11-18,2,0,"chi",-5
"12","Sun","November 24","W","OT","3-8",TRUE,"Detroit Lions",20,17,21,422,347,75,1,19,301,199,102,2,2002-11-24,1,1,"chi",3
"13","Sun","December 1","L","","3-9",FALSE,"Green Bay Packers",20,30,19,304,230,74,4,26,396,215,181,2,2002-12-01,-2,0,"chi",-10
"14","Mon","December 9","L","","3-10",FALSE,"Miami Dolphins",9,27,12,195,88,107,4,22,436,188,248,3,2002-12-09,-1,0,"chi",-18
"15","Sun","December 15","W","","4-10",TRUE,"New York Jets",20,13,20,266,161,105,0,19,334,200,134,1,2002-12-15,1,1,"chi",7
"16","Sun","December 22","L","","4-11",FALSE,"Carolina Panthers",14,24,8,186,131,55,4,15,253,165,88,2,2002-12-22,-2,0,"chi",-10
"17","Sun","December 29","L","","4-12",TRUE,"Tampa Bay Buccaneers",0,15,14,218,133,85,4,15,272,111,161,0,2002-12-29,-4,0,"chi",-15
"1","Sun","September 7","L","","0-1",FALSE,"San Francisco 49ers",7,49,8,127,72,55,5,23,391,229,162,2,2003-09-07,-3,0,"chi",-42
"2","Sun","September 14","L","","0-2",FALSE,"Minnesota Vikings",13,24,10,208,128,80,1,25,400,198,202,1,2003-09-14,0,0,"chi",-11
"4","Mon","September 29","L","","0-3",TRUE,"Green Bay Packers",23,38,23,361,180,181,2,20,380,193,187,1,2003-09-29,-1,0,"chi",-15
"5","Sun","October 5","W","","1-3",TRUE,"Oakland Raiders",24,21,18,344,144,200,3,18,301,182,119,2,2003-10-05,-1,1,"chi",3
"6","Sun","October 12","L","","1-4",FALSE,"New Orleans Saints",13,20,16,271,131,140,2,18,283,153,130,0,2003-10-12,-2,0,"chi",-7
"7","Sun","October 19","L","","1-5",FALSE,"Seattle Seahawks",17,24,19,211,124,87,2,22,335,211,124,2,2003-10-19,0,0,"chi",-7
"8","Sun","October 26","W","","2-5",TRUE,"Detroit Lions",24,16,14,261,193,68,0,16,260,180,80,2,2003-10-26,2,1,"chi",8
"9","Sun","November 2","W","","3-5",TRUE,"San Diego Chargers",20,7,19,341,216,125,1,11,199,119,80,1,2003-11-02,0,1,"chi",13
"10","Sun","November 9","L","","3-6",FALSE,"Detroit Lions",10,12,11,199,133,66,1,10,248,231,17,0,2003-11-09,-1,0,"chi",-2
"11","Sun","November 16","L","","3-7",TRUE,"St. Louis Rams",21,23,13,241,146,95,2,22,320,208,112,3,2003-11-16,1,0,"chi",-2
"12","Sun","November 23","W","","4-7",FALSE,"Denver Broncos",19,10,19,217,111,106,0,18,365,165,200,0,2003-11-23,0,1,"chi",9
"13","Sun","November 30","W","","5-7",TRUE,"Arizona Cardinals",28,3,25,422,268,154,1,9,197,151,46,3,2003-11-30,2,1,"chi",25
"14","Sun","December 7","L","","5-8",FALSE,"Green Bay Packers",21,34,13,275,231,44,5,17,307,210,97,1,2003-12-07,-4,0,"chi",-13
"15","Sun","December 14","W","","6-8",TRUE,"Minnesota Vikings",13,10,15,232,145,87,0,22,393,215,178,1,2003-12-14,1,1,"chi",3
"16","Sun","December 21","W","","7-8",TRUE,"Washington Redskins",27,24,25,429,238,191,2,15,286,242,44,0,2003-12-21,-2,1,"chi",3
"17","Sun","December 28","L","","7-9",FALSE,"Kansas City Chiefs",3,31,16,241,157,84,2,23,282,195,87,1,2003-12-28,-1,0,"chi",-28
"1","Sun","September 12","L","","0-1",TRUE,"Detroit Lions",16,20,18,342,214,128,4,13,262,185,77,1,2004-09-12,-3,0,"chi",-4
"2","Sun","September 19","W","","1-1",FALSE,"Green Bay Packers",21,10,18,307,125,182,2,23,404,252,152,3,2004-09-19,1,1,"chi",11
"3","Sun","September 26","L","","1-2",FALSE,"Minnesota Vikings",22,27,24,385,239,146,1,24,443,350,93,2,2004-09-26,1,0,"chi",-5
"4","Sun","October 3","L","","1-3",TRUE,"Philadelphia Eagles",9,19,14,224,192,32,1,24,376,218,158,1,2004-10-03,0,0,"chi",-10
"6","Sun","October 17","L","","1-4",TRUE,"Washington Redskins",10,13,9,160,34,126,1,18,311,93,218,1,2004-10-17,0,0,"chi",-3
"7","Sun","October 24","L","","1-5",FALSE,"Tampa Bay Buccaneers",7,19,11,167,91,76,2,17,293,155,138,2,2004-10-24,0,0,"chi",-12
"8","Sun","October 31","W","","2-5",TRUE,"San Francisco 49ers",23,13,14,254,134,120,3,10,162,100,62,2,2004-10-31,-1,1,"chi",10
"9","Sun","November 7","W","","3-5",FALSE,"New York Giants",28,21,13,231,109,122,2,15,258,167,91,5,2004-11-07,3,1,"chi",7
"10","Sun","November 14","W","OT","4-5",FALSE,"Tennessee Titans",19,17,10,176,75,101,3,14,390,318,72,3,2004-11-14,0,1,"chi",2
"11","Sun","November 21","L","","4-6",TRUE,"Indianapolis Colts",10,41,14,224,145,79,5,31,486,211,275,1,2004-11-21,-4,0,"chi",-31
"12","Thu","November 25","L","","4-7",FALSE,"Dallas Cowboys",7,21,10,140,91,49,4,18,267,113,154,2,2004-11-25,-2,0,"chi",-14
"13","Sun","December 5","W","","5-7",TRUE,"Minnesota Vikings",24,14,21,318,174,144,1,24,391,245,146,4,2004-12-05,3,1,"chi",10
"14","Sun","December 12","L","","5-8",FALSE,"Jacksonville Jaguars",3,22,10,210,179,31,2,22,332,242,90,1,2004-12-12,-1,0,"chi",-19
"15","Sun","December 19","L","","5-9",TRUE,"Houston Texans",5,24,11,203,149,54,4,15,314,208,106,0,2004-12-19,-4,0,"chi",-19
"16","Sun","December 26","L","","5-10",FALSE,"Detroit Lions",13,19,16,229,105,124,1,17,314,156,158,1,2004-12-26,0,0,"chi",-6
"17","Sun","January 2","L","","5-11",TRUE,"Green Bay Packers",14,31,17,246,136,110,1,17,387,327,60,0,2005-01-02,-1,0,"chi",-17
"1","Sun","September 11","L","","0-1",FALSE,"Washington Redskins",7,9,11,166,125,41,2,18,323,159,164,3,2005-09-11,1,0,"chi",-2
"2","Sun","September 18","W","","1-1",TRUE,"Detroit Lions",38,6,18,336,149,187,0,14,234,205,29,5,2005-09-18,5,1,"chi",32
"3","Sun","September 25","L","","1-2",TRUE,"Cincinnati Bengals",7,24,16,255,149,106,6,11,244,161,83,1,2005-09-25,-5,0,"chi",-17
"5","Sun","October 9","L","","1-3",FALSE,"Cleveland Browns",10,20,16,266,90,176,3,15,278,202,76,2,2005-10-09,-1,0,"chi",-10
"6","Sun","October 16","W","","2-3",TRUE,"Minnesota Vikings",28,3,16,192,97,95,3,16,283,203,80,2,2005-10-16,-1,1,"chi",25
"7","Sun","October 23","W","","3-3",TRUE,"Baltimore Ravens",10,6,17,276,133,143,0,12,199,133,66,0,2005-10-23,0,1,"chi",4
"8","Sun","October 30","W","OT","4-3",FALSE,"Detroit Lions",19,13,14,333,218,115,1,17,278,185,93,1,2005-10-30,0,1,"chi",6
"9","Sun","November 6","W","","5-3",FALSE,"New Orleans Saints",20,17,15,314,131,183,3,15,283,150,133,4,2005-11-06,1,1,"chi",3
"10","Sun","November 13","W","","6-3",TRUE,"San Francisco 49ers",17,9,12,239,67,172,4,9,161,28,133,2,2005-11-13,-2,1,"chi",8
"11","Sun","November 20","W","","7-3",TRUE,"Carolina Panthers",13,3,15,258,136,122,1,13,238,183,55,2,2005-11-20,1,1,"chi",10
"12","Sun","November 27","W","","8-3",FALSE,"Tampa Bay Buccaneers",13,10,15,239,121,118,1,15,275,168,107,1,2005-11-27,0,1,"chi",3
"13","Sun","December 4","W","","9-3",TRUE,"Green Bay Packers",19,7,10,190,49,141,2,26,358,258,100,4,2005-12-04,2,1,"chi",12
"14","Sun","December 11","L","","9-4",FALSE,"Pittsburgh Steelers",9,21,15,268,185,83,0,20,363,173,190,0,2005-12-11,0,0,"chi",-12
"15","Sun","December 18","W","","10-4",TRUE,"Atlanta Falcons",16,3,14,226,98,128,1,12,231,117,114,3,2005-12-18,2,1,"chi",13
"16","Sun","December 25","W","","11-4",FALSE,"Green Bay Packers",24,17,16,292,157,135,1,24,365,300,65,4,2005-12-25,3,1,"chi",7
"17","Sun","January 1","L","","11-5",FALSE,"Minnesota Vikings",10,34,13,251,97,154,0,22,396,247,149,0,2006-01-01,0,0,"chi",-24
"Division","Sun","January 15","L","","11-6",TRUE,"Carolina Panthers",21,29,23,282,185,97,1,21,434,311,123,1,2006-01-15,0,0,"chi",-8
"1","Sun","September 10","W","","1-0",FALSE,"Green Bay Packers",26,0,18,361,252,109,1,14,267,164,103,3,2006-09-10,2,1,"chi",26
"2","Sun","September 17","W","","2-0",TRUE,"Detroit Lions",34,7,22,383,294,89,1,15,245,199,46,3,2006-09-17,2,1,"chi",27
"3","Sun","September 24","W","","3-0",FALSE,"Minnesota Vikings",19,16,19,325,274,51,2,11,286,189,97,2,2006-09-24,0,1,"chi",3
"4","Sun","October 1","W","","4-0",TRUE,"Seattle Seahawks",37,6,21,362,219,143,0,14,230,153,77,2,2006-10-01,2,1,"chi",31
"5","Sun","October 8","W","","5-0",TRUE,"Buffalo Bills",40,7,23,351,195,156,1,10,145,87,58,5,2006-10-08,4,1,"chi",33
"6","Mon","October 16","W","","6-0",FALSE,"Arizona Cardinals",24,23,9,168,130,38,6,17,286,220,66,2,2006-10-16,-4,1,"chi",1
"8","Sun","October 29","W","","7-0",TRUE,"San Francisco 49ers",41,10,24,402,257,145,0,12,248,121,127,5,2006-10-29,5,1,"chi",31
"9","Sun","November 5","L","","7-1",TRUE,"Miami Dolphins",13,31,20,292,189,103,6,17,298,137,161,2,2006-11-05,-4,0,"chi",-18
"10","Sun","November 12","W","","8-1",FALSE,"New York Giants",38,20,21,352,234,118,3,15,249,99,150,3,2006-11-12,0,1,"chi",18
"11","Sun","November 19","W","","9-1",FALSE,"New York Jets",10,0,12,284,111,173,0,15,264,156,108,2,2006-11-19,2,1,"chi",10
"12","Sun","November 26","L","","9-2",FALSE,"New England Patriots",13,17,21,324,171,153,4,20,352,267,85,5,2006-11-26,1,0,"chi",-4
"13","Sun","December 3","W","","10-2",TRUE,"Minnesota Vikings",23,13,6,107,24,83,5,21,346,156,190,5,2006-12-03,0,1,"chi",10
"14","Mon","December 11","W","","11-2",FALSE,"St. Louis Rams",42,27,22,372,200,172,0,28,433,332,101,1,2006-12-11,1,1,"chi",15
"15","Sun","December 17","W","OT","12-2",TRUE,"Tampa Bay Buccaneers",34,31,27,446,312,134,1,11,357,300,57,2,2006-12-17,1,1,"chi",3
"16","Sun","December 24","W","","13-2",FALSE,"Detroit Lions",26,21,22,354,238,116,0,18,327,260,67,1,2006-12-24,1,1,"chi",5
"17","Sun","December 31","L","","13-3",TRUE,"Green Bay Packers",7,26,13,316,181,135,6,20,373,276,97,1,2006-12-31,-5,0,"chi",-19
"Division","Sun","January 14","W","OT","14-3",TRUE,"Seattle Seahawks",27,24,21,371,251,120,2,18,306,179,127,1,2007-01-14,-1,1,"chi",3
"ConfChamp","Sun","January 21","W","","15-3",TRUE,"New Orleans Saints",39,14,18,340,144,196,0,15,375,319,56,4,2007-01-21,4,1,"chi",25
"SuperBowl","Sun","February 4","L","","15-4",TRUE,"Indianapolis Colts",17,29,11,265,154,111,5,24,430,239,191,3,2007-02-04,-2,0,"chi",-12
"1","Sun","September 9","L","","0-1",FALSE,"San Diego Chargers",3,14,11,202,122,80,4,19,263,186,77,2,2007-09-09,-2,0,"chi",-11
"2","Sun","September 16","W","","1-1",TRUE,"Kansas City Chiefs",20,10,18,239,132,107,3,13,281,211,70,2,2007-09-16,-1,1,"chi",10
"3","Sun","September 23","L","","1-2",TRUE,"Dallas Cowboys",10,34,16,239,164,75,4,21,431,300,131,1,2007-09-23,-3,0,"chi",-24
"4","Sun","September 30","L","","1-3",FALSE,"Detroit Lions",27,37,22,303,234,69,3,19,310,215,95,2,2007-09-30,-1,0,"chi",-10
"5","Sun","October 7","W","","2-3",FALSE,"Green Bay Packers",27,20,16,285,203,82,1,18,439,318,121,5,2007-10-07,4,1,"chi",7
"6","Sun","October 14","L","","2-4",TRUE,"Minnesota Vikings",31,34,20,458,375,83,4,16,444,133,311,0,2007-10-14,-4,0,"chi",-3
"7","Sun","October 21","W","","3-4",FALSE,"Philadelphia Eagles",19,16,19,386,314,72,0,21,334,211,123,0,2007-10-21,0,1,"chi",3
"8","Sun","October 28","L","","3-5",TRUE,"Detroit Lions",7,16,16,255,192,63,4,22,365,246,119,1,2007-10-28,-3,0,"chi",-9
"10","Sun","November 11","W","","4-5",FALSE,"Oakland Raiders",17,6,16,295,217,78,0,12,193,86,107,3,2007-11-11,3,1,"chi",11
"11","Sun","November 18","L","","4-6",FALSE,"Seattle Seahawks",23,30,16,345,238,107,1,21,425,322,103,1,2007-11-18,0,0,"chi",-7
"12","Sun","November 25","W","OT","5-6",TRUE,"Denver Broncos",37,34,18,293,171,122,4,22,430,292,138,2,2007-11-25,-2,1,"chi",3
"13","Sun","December 2","L","","5-7",TRUE,"New York Giants",16,21,18,312,244,68,0,24,356,181,175,4,2007-12-02,4,0,"chi",-5
"14","Thu","December 6","L","","5-8",FALSE,"Washington Redskins",16,24,22,356,296,60,2,15,345,314,31,1,2007-12-06,-1,0,"chi",-8
"15","Mon","December 17","L","","5-9",FALSE,"Minnesota Vikings",13,20,11,209,177,32,1,21,372,236,136,4,2007-12-17,3,0,"chi",-7
"16","Sun","December 23","W","","6-9",TRUE,"Green Bay Packers",35,7,14,240,104,136,0,13,274,149,125,2,2007-12-23,2,1,"chi",28
"17","Sun","December 30","W","","7-9",TRUE,"New Orleans Saints",33,25,13,275,179,96,3,28,413,308,105,3,2007-12-30,0,1,"chi",8
"1","Sun","September 7","W","","1-0",FALSE,"Indianapolis Colts",29,13,17,319,136,183,0,23,293,240,53,1,2008-09-07,1,1,"chi",16
"2","Sun","September 14","L","","1-1",FALSE,"Carolina Panthers",17,20,12,256,141,115,2,12,216,102,114,1,2008-09-14,-1,0,"chi",-3
"3","Sun","September 21","L","OT","1-2",TRUE,"Tampa Bay Buccaneers",24,27,21,405,247,158,2,28,454,407,47,4,2008-09-21,2,0,"chi",-3
"4","Sun","September 28","W","","2-2",TRUE,"Philadelphia Eagles",24,20,13,256,178,78,4,18,340,237,103,2,2008-09-28,-2,1,"chi",4
"5","Sun","October 5","W","","3-2",FALSE,"Detroit Lions",34,7,21,425,328,97,1,12,185,131,54,2,2008-10-05,1,1,"chi",27
"6","Sun","October 12","L","","3-3",FALSE,"Atlanta Falcons",20,22,22,361,282,79,1,18,376,301,75,1,2008-10-12,0,0,"chi",-2
"7","Sun","October 19","W","","4-3",TRUE,"Minnesota Vikings",48,41,20,327,274,53,1,28,439,284,155,5,2008-10-19,4,1,"chi",7
"9","Sun","November 2","W","","5-3",TRUE,"Detroit Lions",27,23,18,320,166,154,2,21,333,280,53,3,2008-11-02,1,1,"chi",4
"10","Sun","November 9","L","","5-4",TRUE,"Tennessee Titans",14,21,15,243,165,78,1,19,304,284,20,1,2008-11-09,0,0,"chi",-7
"11","Sun","November 16","L","","5-5",FALSE,"Green Bay Packers",3,37,9,234,151,83,1,24,427,227,200,1,2008-11-16,0,0,"chi",-34
"12","Sun","November 23","W","","6-5",FALSE,"St. Louis Rams",27,3,18,334,126,208,2,13,207,193,14,4,2008-11-23,2,1,"chi",24
"13","Sun","November 30","L","","6-6",FALSE,"Minnesota Vikings",14,34,10,228,125,103,3,17,378,200,178,1,2008-11-30,-2,0,"chi",-20
"14","Sun","December 7","W","","7-6",TRUE,"Jacksonville Jaguars",23,10,16,296,210,86,1,14,278,159,119,1,2008-12-07,0,1,"chi",13
"15","Thu","December 11","W","OT","8-6",TRUE,"New Orleans Saints",27,24,16,226,171,55,3,22,345,226,119,2,2008-12-11,-1,1,"chi",3
"16","Mon","December 22","W","OT","9-6",TRUE,"Green Bay Packers",20,17,15,210,136,74,2,20,325,260,65,2,2008-12-22,0,1,"chi",3
"17","Sun","December 28","L","","9-7",FALSE,"Houston Texans",24,31,21,294,225,69,1,25,455,328,127,1,2008-12-28,0,0,"chi",-7
"1","Sun","September 13","L","","0-1",FALSE,"Green Bay Packers",15,21,18,352,266,86,4,12,226,150,76,0,2009-09-13,-4,0,"chi",-6
"2","Sun","September 20","W","","1-1",TRUE,"Pittsburgh Steelers",17,14,17,275,231,44,0,21,308,203,105,2,2009-09-20,2,1,"chi",3
"3","Sun","September 27","W","","2-1",FALSE,"Seattle Seahawks",25,19,14,318,233,85,2,19,346,243,103,2,2009-09-27,0,1,"chi",6
"4","Sun","October 4","W","","3-1",TRUE,"Detroit Lions",48,24,14,276,125,151,0,25,398,308,90,2,2009-10-04,2,1,"chi",24
"6","Sun","October 18","L","","3-2",FALSE,"Atlanta Falcons",14,21,21,373,290,83,3,16,253,185,68,2,2009-10-18,-1,0,"chi",-7
"7","Sun","October 25","L","","3-3",FALSE,"Cincinnati Bengals",10,45,15,279,244,35,4,30,448,233,215,0,2009-10-25,-4,0,"chi",-35
"8","Sun","November 1","W","","4-3",TRUE,"Cleveland Browns",30,6,20,369,199,170,1,9,191,74,117,5,2009-11-01,4,1,"chi",24
"9","Sun","November 8","L","","4-4",TRUE,"Arizona Cardinals",21,41,20,417,347,70,1,27,438,256,182,1,2009-11-08,0,0,"chi",-20
"10","Thu","November 12","L","","4-5",FALSE,"San Francisco 49ers",6,10,19,350,307,43,5,12,216,106,110,1,2009-11-12,-4,0,"chi",-4
"11","Sun","November 22","L","","4-6",TRUE,"Philadelphia Eagles",20,24,14,284,158,126,1,18,377,220,157,3,2009-11-22,2,0,"chi",-4
"12","Sun","November 29","L","","4-7",FALSE,"Minnesota Vikings",10,36,8,169,126,43,3,31,537,378,159,1,2009-11-29,-2,0,"chi",-26
"13","Sun","December 6","W","","5-7",TRUE,"St. Louis Rams",17,9,14,248,128,120,1,14,233,98,135,2,2009-12-06,1,1,"chi",8
"14","Sun","December 13","L","","5-8",TRUE,"Green Bay Packers",14,21,14,254,195,59,2,16,315,157,158,2,2009-12-13,0,0,"chi",-7
"15","Sun","December 20","L","","5-9",FALSE,"Baltimore Ravens",7,31,13,220,98,122,6,18,346,222,124,1,2009-12-20,-5,0,"chi",-24
"16","Mon","December 28","W","OT","6-9",TRUE,"Minnesota Vikings",36,30,19,363,258,105,1,26,423,300,123,2,2009-12-28,1,1,"chi",6
"17","Sun","January 3","W","","7-9",FALSE,"Detroit Lions",37,23,22,418,268,150,0,18,349,249,100,2,2010-01-03,2,1,"chi",14
"1","Sun","September 12","W","","1-0",TRUE,"Detroit Lions",19,14,23,463,362,101,4,13,168,148,20,3,2010-09-12,-1,1,"chi",5
"2","Sun","September 19","W","","2-0",FALSE,"Dallas Cowboys",27,20,14,308,270,38,0,23,410,374,36,3,2010-09-19,3,1,"chi",7
"3","Mon","September 27","W","","3-0",TRUE,"Green Bay Packers",20,17,18,276,199,77,1,21,379,316,63,2,2010-09-27,1,1,"chi",3
"4","Sun","October 3","L","","3-1",FALSE,"New York Giants",3,17,6,110,51,59,3,18,372,183,189,3,2010-10-03,0,0,"chi",-14
"5","Sun","October 10","W","","4-1",FALSE,"Carolina Panthers",23,6,13,247,29,218,4,8,147,62,85,3,2010-10-10,-1,1,"chi",17
"6","Sun","October 17","L","","4-2",TRUE,"Seattle Seahawks",20,23,15,307,246,61,0,20,353,242,111,0,2010-10-17,0,0,"chi",-3
"7","Sun","October 24","L","","4-3",TRUE,"Washington Redskins",14,17,19,322,256,66,6,13,308,187,121,3,2010-10-24,-3,0,"chi",-3
"9","Sun","November 7","W","","5-3",FALSE,"Buffalo Bills",22,19,19,283,178,105,1,22,340,294,46,3,2010-11-07,2,1,"chi",3
"10","Sun","November 14","W","","6-3",TRUE,"Minnesota Vikings",27,13,18,360,230,130,2,15,240,170,70,4,2010-11-14,2,1,"chi",14
"11","Thu","November 18","W","","7-3",FALSE,"Miami Dolphins",16,0,19,268,133,135,1,10,187,148,39,1,2010-11-18,0,1,"chi",16
"12","Sun","November 28","W","","8-3",TRUE,"Philadelphia Eagles",31,26,18,349,218,131,0,24,398,293,105,1,2010-11-28,1,1,"chi",5
"13","Sun","December 5","W","","9-3",FALSE,"Detroit Lions",24,20,23,311,197,114,1,14,302,168,134,0,2010-12-05,-1,1,"chi",4
"14","Sun","December 12","L","","9-4",TRUE,"New England Patriots",7,36,12,185,138,47,4,27,475,351,124,0,2010-12-12,-4,0,"chi",-29
"15","Mon","December 20","W","","10-4",FALSE,"Minnesota Vikings",40,14,17,293,189,104,1,16,273,159,114,5,2010-12-20,4,1,"chi",26
"16","Sun","December 26","W","","11-4",TRUE,"New York Jets",38,34,16,322,202,120,1,24,393,269,124,2,2010-12-26,1,1,"chi",4
"17","Sun","January 2","L","","11-5",FALSE,"Green Bay Packers",3,10,13,227,117,110,2,14,284,224,60,2,2011-01-02,0,0,"chi",-7
"Division","Sun","January 16","W","","12-5",TRUE,"Seattle Seahawks",35,24,21,437,261,176,1,18,276,242,34,0,2011-01-16,-1,1,"chi",11
"ConfChamp","Sun","January 23","L","","12-6",TRUE,"Green Bay Packers",14,21,17,301,218,83,3,23,356,236,120,2,2011-01-23,-1,0,"chi",-7
"1","Sun","September 11","W","","1-0",TRUE,"Atlanta Falcons",30,12,17,377,289,88,1,25,386,276,110,3,2011-09-11,2,1,"chi",18
"2","Sun","September 18","L","","1-1",FALSE,"New Orleans Saints",13,30,18,246,186,60,1,16,382,264,118,1,2011-09-18,0,0,"chi",-17
"3","Sun","September 25","L","","1-2",TRUE,"Green Bay Packers",17,27,12,291,278,13,2,24,392,292,100,2,2011-09-25,0,0,"chi",-10
"4","Sun","October 2","W","","2-2",TRUE,"Carolina Panthers",34,29,15,317,93,224,1,24,543,374,169,1,2011-10-02,0,1,"chi",5
"5","Mon","October 10","L","","2-3",FALSE,"Detroit Lions",13,24,23,359,237,122,0,16,395,214,181,1,2011-10-10,1,0,"chi",-11
"6","Sun","October 16","W","","3-3",TRUE,"Minnesota Vikings",39,10,22,377,258,119,1,15,286,233,53,0,2011-10-16,-1,1,"chi",29
"7","Sun","October 23","W","","4-3",FALSE,"Tampa Bay Buccaneers",24,18,19,395,218,177,2,16,280,250,30,4,2011-10-23,2,1,"chi",6
"9","Mon","November 7","W","","5-3",FALSE,"Philadelphia Eagles",30,24,22,372,208,164,2,20,330,211,119,2,2011-11-07,0,1,"chi",6
"10","Sun","November 13","W","","6-3",TRUE,"Detroit Lions",37,13,12,216,107,109,1,22,393,313,80,6,2011-11-13,5,1,"chi",24
"11","Sun","November 20","W","","7-3",TRUE,"San Diego Chargers",31,20,23,378,286,92,1,15,332,280,52,3,2011-11-20,2,1,"chi",11
"12","Sun","November 27","L","","7-4",FALSE,"Oakland Raiders",20,25,18,401,229,172,3,17,341,268,73,1,2011-11-27,-2,0,"chi",-5
"13","Sun","December 4","L","","7-5",TRUE,"Kansas City Chiefs",3,10,11,181,88,93,3,13,252,139,113,1,2011-12-04,-2,0,"chi",-7
"14","Sun","December 11","L","OT","7-6",FALSE,"Denver Broncos",10,13,12,245,86,159,1,22,345,221,124,2,2011-12-11,1,0,"chi",-3
"15","Sun","December 18","L","","7-7",TRUE,"Seattle Seahawks",14,38,13,221,89,132,5,18,286,226,60,1,2011-12-18,-4,0,"chi",-24
"16","Sun","December 25","L","","7-8",FALSE,"Green Bay Packers",21,35,24,441,242,199,2,19,363,282,81,0,2011-12-25,-2,0,"chi",-14
"17","Sun","January 1","W","","8-8",FALSE,"Minnesota Vikings",17,13,10,209,117,92,3,16,301,222,79,3,2012-01-01,0,1,"chi",4
"1","Sun","September 8","W","","1-0",TRUE,"San Francisco 49ers",28,21,15,268,182,86,1,29,489,272,217,7,1985-09-08,6,1,"min",7
"2","Sun","September 15","W","","2-0",FALSE,"Tampa Bay Buccaneers",31,16,18,262,183,79,2,22,349,234,115,5,1985-09-15,3,1,"min",15
"3","Thu","September 19","L","","2-1",TRUE,"Chicago Bears",24,33,23,445,411,34,5,21,480,353,127,1,1985-09-19,-4,0,"min",-9
"4","Sun","September 29","W","","3-1",FALSE,"Buffalo Bills",27,20,19,338,167,171,1,20,277,162,115,2,1985-09-29,1,1,"min",7
"5","Sun","October 6","L","","3-2",FALSE,"Los Angeles Rams",10,13,25,306,172,134,1,14,188,130,58,1,1985-10-06,0,0,"min",-3
"6","Sun","October 13","L","","3-3",FALSE,"Green Bay Packers",17,20,18,285,223,62,3,18,280,145,135,3,1985-10-13,0,0,"min",-3
"7","Sun","October 20","W","","4-3",TRUE,"San Diego Chargers",21,17,27,360,298,62,3,23,295,163,132,4,1985-10-20,1,1,"min",4
"8","Sun","October 27","L","","4-4",FALSE,"Chicago Bears",9,27,16,236,206,30,5,24,413,211,202,2,1985-10-27,-3,0,"min",-18
"9","Sun","November 3","W","","5-4",TRUE,"Detroit Lions",16,13,20,301,138,163,2,11,153,84,69,0,1985-11-03,-2,1,"min",3
"10","Sun","November 10","L","","5-5",TRUE,"Green Bay Packers",17,27,19,311,134,177,3,20,370,195,175,1,1985-11-10,-2,0,"min",-10
"11","Sun","November 17","L","","5-6",FALSE,"Detroit Lions",21,41,16,311,248,63,5,24,365,217,148,2,1985-11-17,-3,0,"min",-20
"12","Sun","November 24","L","","5-7",TRUE,"New Orleans Saints",23,30,17,284,225,59,3,19,371,137,234,3,1985-11-24,0,0,"min",-7
"13","Sun","December 1","W","","6-7",FALSE,"Philadelphia Eagles",28,23,13,239,172,67,0,24,443,306,137,3,1985-12-01,3,1,"min",5
"14","Sun","December 8","W","","7-7",TRUE,"Tampa Bay Buccaneers",26,7,23,474,309,165,5,17,327,176,151,6,1985-12-08,1,1,"min",19
"15","Sun","December 15","L","","7-8",FALSE,"Atlanta Falcons",13,14,23,377,286,91,5,15,274,190,84,1,1985-12-15,-4,0,"min",-1
"16","Sun","December 22","L","","7-9",TRUE,"Philadelphia Eagles",35,37,25,354,281,73,3,23,390,266,124,3,1985-12-22,0,0,"min",-2
"1","Sun","September 7","L","","0-1",TRUE,"Detroit Lions",10,13,14,275,213,62,2,19,303,79,224,1,1986-09-07,-1,0,"min",-3
"2","Sun","September 14","W","","1-1",FALSE,"Tampa Bay Buccaneers",23,10,17,242,120,122,0,21,239,156,83,3,1986-09-14,3,1,"min",13
"3","Sun","September 21","W","","2-1",TRUE,"Pittsburgh Steelers",31,7,22,412,250,162,1,13,235,154,81,3,1986-09-21,2,1,"min",24
"4","Sun","September 28","W","","3-1",TRUE,"Green Bay Packers",42,7,25,383,297,86,1,15,220,138,82,4,1986-09-28,3,1,"min",35
"5","Sun","October 5","L","","3-2",FALSE,"Chicago Bears",0,23,11,159,114,45,3,18,370,199,171,3,1986-10-05,0,0,"min",-23
"6","Sun","October 12","W","OT","4-2",FALSE,"San Francisco 49ers",27,24,21,351,317,34,3,21,413,348,65,2,1986-10-12,-1,1,"min",3
"7","Sun","October 19","W","","5-2",TRUE,"Chicago Bears",23,7,19,376,219,157,1,10,190,137,53,2,1986-10-19,1,1,"min",16
"8","Sun","October 26","L","","5-3",TRUE,"Cleveland Browns",20,23,20,396,238,158,2,14,199,50,149,2,1986-10-26,0,0,"min",-3
"9","Sun","November 2","L","OT","5-4",FALSE,"Washington Redskins",38,44,21,526,471,55,3,20,487,378,109,1,1986-11-02,-2,0,"min",-6
"10","Sun","November 9","W","","6-4",FALSE,"Detroit Lions",24,10,22,432,270,162,3,15,282,201,81,4,1986-11-09,1,1,"min",14
"11","Sun","November 16","L","","6-5",TRUE,"New York Giants",20,22,21,353,244,109,1,23,383,293,90,2,1986-11-16,1,0,"min",-2
"12","Sun","November 23","L","","6-6",FALSE,"Cincinnati Bengals",20,24,22,284,164,120,1,24,413,248,165,2,1986-11-23,1,0,"min",-4
"13","Sun","November 30","W","","7-6",TRUE,"Tampa Bay Buccaneers",45,13,25,463,342,121,0,20,267,166,101,3,1986-11-30,3,1,"min",32
"14","Sun","December 7","W","","8-6",FALSE,"Green Bay Packers",32,6,20,303,146,157,1,19,367,223,144,3,1986-12-07,2,1,"min",26
"15","Sun","December 14","L","","8-7",FALSE,"Houston Oilers",10,23,18,301,191,110,6,18,377,259,118,1,1986-12-14,-5,0,"min",-13
"16","Sun","December 21","W","","9-7",TRUE,"New Orleans Saints",33,17,23,395,317,78,1,16,267,187,80,6,1986-12-21,5,1,"min",16
"1","Sun","September 13","W","","1-0",TRUE,"Detroit Lions",34,19,21,353,240,113,3,17,272,189,83,2,1987-09-13,-1,1,"min",15
"2","Sun","September 20","W","","2-0",FALSE,"Los Angeles Rams",21,16,17,353,257,96,2,15,210,88,122,2,1987-09-20,0,1,"min",5
"3","Sun","October 4","L","","2-1",TRUE,"Green Bay Packers",16,23,17,315,219,96,2,16,300,153,147,0,1987-10-04,-2,0,"min",-7
"4","Sun","October 11","L","","2-2",FALSE,"Chicago Bears",7,27,15,151,108,43,2,26,344,159,185,1,1987-10-11,-1,0,"min",-20
"5","Sun","October 18","L","","2-3",FALSE,"Tampa Bay Buccaneers",10,20,16,175,152,23,6,15,268,193,75,2,1987-10-18,-4,0,"min",-10
"6","Mon","October 26","W","","3-3",TRUE,"Denver Broncos",34,27,27,393,196,197,5,21,329,206,123,1,1987-10-26,-4,1,"min",7
"7","Sun","November 1","L","","3-4",FALSE,"Seattle Seahawks",17,28,23,395,252,143,2,19,318,195,123,1,1987-11-01,-1,0,"min",-11
"8","Sun","November 8","W","","4-4",TRUE,"Los Angeles Raiders",31,20,13,200,84,116,1,19,376,219,157,5,1987-11-08,4,1,"min",11
"9","Sun","November 15","W","","5-4",TRUE,"Tampa Bay Buccaneers",23,17,23,330,106,224,1,14,259,244,15,4,1987-11-15,3,1,"min",6
"10","Sun","November 22","W","","6-4",TRUE,"Atlanta Falcons",24,13,18,302,169,133,1,16,290,194,96,1,1987-11-22,0,1,"min",11
"11","Thu","November 26","W","OT","7-4",FALSE,"Dallas Cowboys",44,38,27,476,288,188,2,23,403,291,112,5,1987-11-26,3,1,"min",6
"12","Sun","December 6","L","","7-5",TRUE,"Chicago Bears",24,30,18,356,281,75,1,26,423,264,159,3,1987-12-06,2,0,"min",-6
"13","Sun","December 13","L","","7-6",FALSE,"Green Bay Packers",10,16,14,289,162,127,2,19,300,179,121,1,1987-12-13,-1,0,"min",-6
"14","Sun","December 20","W","","8-6",FALSE,"Detroit Lions",17,14,20,340,135,205,0,17,364,235,129,5,1987-12-20,5,1,"min",3
"15","Sat","December 26","L","OT","8-7",TRUE,"Washington Redskins",24,27,24,381,177,204,3,18,368,291,77,4,1987-12-26,1,0,"min",-3
"WildCard","Sun","January 3","W","","9-7",FALSE,"New Orleans Saints",44,10,28,417,207,210,2,9,149,96,53,6,1988-01-03,4,1,"min",34
"Division","Sat","January 9","W","","10-7",FALSE,"San Francisco 49ers",36,24,22,397,280,117,1,17,358,243,115,2,1988-01-09,1,1,"min",12
"ConfChamp","Sun","January 17","L","","10-8",FALSE,"Washington Redskins",10,17,16,259,183,76,1,11,280,119,161,0,1988-01-17,-1,0,"min",-7
"1","Sun","September 4","L","","0-1",FALSE,"Buffalo Bills",10,13,21,300,170,130,2,18,310,196,114,1,1988-09-04,-1,0,"min",-3
"2","Sun","September 11","W","","1-1",TRUE,"New England Patriots",36,6,24,415,265,150,2,12,214,111,103,5,1988-09-11,3,1,"min",30
"3","Sun","September 18","W","","2-1",FALSE,"Chicago Bears",31,7,20,376,249,127,1,14,235,165,70,5,1988-09-18,4,1,"min",24
"4","Sun","September 25","W","","3-1",TRUE,"Philadelphia Eagles",23,21,21,392,287,105,3,12,205,135,70,2,1988-09-25,-1,1,"min",2
"5","Sun","October 2","L","","3-2",FALSE,"Miami Dolphins",7,24,17,353,295,58,4,20,342,264,78,3,1988-10-02,-1,0,"min",-17
"6","Sun","October 9","W","","4-2",TRUE,"Tampa Bay Buccaneers",14,13,15,276,207,69,2,18,331,154,177,3,1988-10-09,1,1,"min",1
"7","Sun","October 16","L","","4-3",TRUE,"Green Bay Packers",14,34,20,324,257,67,5,22,355,230,125,2,1988-10-16,-3,0,"min",-20
"8","Sun","October 23","W","","5-3",FALSE,"Tampa Bay Buccaneers",49,20,25,433,305,128,1,18,243,215,28,7,1988-10-23,6,1,"min",29
"9","Sun","October 30","L","","5-4",FALSE,"San Francisco 49ers",21,24,15,321,229,92,3,16,339,209,130,2,1988-10-30,-1,0,"min",-3
"10","Sun","November 6","W","","6-4",TRUE,"Detroit Lions",44,17,33,553,355,198,1,8,89,21,68,2,1988-11-06,1,1,"min",27
"11","Sun","November 13","W","","7-4",FALSE,"Dallas Cowboys",43,3,18,325,222,103,1,12,159,49,110,7,1988-11-13,6,1,"min",40
"12","Sun","November 20","W","","8-4",TRUE,"Indianapolis Colts",12,3,13,275,192,83,0,17,213,110,103,2,1988-11-20,2,1,"min",9
"13","Thu","November 24","W","","9-4",FALSE,"Detroit Lions",23,0,24,353,172,181,0,3,60,42,18,2,1988-11-24,2,1,"min",23
"14","Sun","December 4","W","","10-4",TRUE,"New Orleans Saints",45,3,20,426,217,209,1,13,233,107,126,3,1988-12-04,2,1,"min",42
"15","Sun","December 11","L","","10-5",FALSE,"Green Bay Packers",6,18,15,255,211,44,2,19,298,201,97,4,1988-12-11,2,0,"min",-12
"16","Mon","December 19","W","","11-5",TRUE,"Chicago Bears",28,27,17,218,156,62,2,21,465,280,185,3,1988-12-19,1,1,"min",1
"WildCard","Mon","December 26","W","","12-5",TRUE,"Los Angeles Rams",28,17,11,310,207,103,0,19,342,235,107,3,1988-12-26,3,1,"min",11
"Division","Sun","January 1","L","","12-6",FALSE,"San Francisco 49ers",9,34,20,262,208,54,3,20,372,171,201,2,1989-01-01,-1,0,"min",-25
"1","Sun","September 10","W","","1-0",TRUE,"Houston Oilers",38,7,29,343,188,155,0,11,104,34,70,3,1989-09-10,3,1,"min",31
"2","Sun","September 17","L","","1-1",FALSE,"Chicago Bears",7,38,18,320,253,67,4,20,306,142,164,1,1989-09-17,-3,0,"min",-31
"3","Sun","September 24","L","","1-2",FALSE,"Pittsburgh Steelers",14,27,17,258,146,112,2,23,278,119,159,1,1989-09-24,-1,0,"min",-13
"4","Sun","October 1","W","","2-2",TRUE,"Tampa Bay Buccaneers",17,3,23,365,203,162,3,7,158,64,94,1,1989-10-01,-2,1,"min",14
"5","Sun","October 8","W","","3-2",TRUE,"Detroit Lions",24,17,14,229,138,91,3,20,237,84,153,4,1989-10-08,1,1,"min",7
"6","Sun","October 15","W","","4-2",TRUE,"Green Bay Packers",26,14,21,398,160,238,2,11,219,151,68,3,1989-10-15,1,1,"min",12
"7","Sun","October 22","W","","5-2",FALSE,"Detroit Lions",20,7,13,264,147,117,1,21,282,198,84,5,1989-10-22,4,1,"min",13
"8","Mon","October 30","L","","5-3",FALSE,"New York Giants",14,24,20,250,140,110,4,13,174,55,119,0,1989-10-30,-4,0,"min",-10
"9","Sun","November 5","W","OT","6-3",TRUE,"Los Angeles Rams",23,21,23,376,276,100,1,14,304,185,119,2,1989-11-05,1,1,"min",2
"10","Sun","November 12","W","","7-3",FALSE,"Tampa Bay Buccaneers",24,10,18,303,145,158,1,13,201,111,90,2,1989-11-12,1,1,"min",14
"11","Sun","November 19","L","","7-4",FALSE,"Philadelphia Eagles",9,10,18,219,136,83,5,22,270,179,91,1,1989-11-19,-4,0,"min",-1
"12","Sun","November 26","L","","7-5",FALSE,"Green Bay Packers",19,20,22,377,301,76,2,16,332,248,84,1,1989-11-26,-1,0,"min",-1
"13","Sun","December 3","W","","8-5",TRUE,"Chicago Bears",27,16,24,387,251,136,2,18,315,178,137,2,1989-12-03,0,1,"min",11
"14","Sun","December 10","W","","9-5",TRUE,"Atlanta Falcons",43,17,23,457,237,220,1,15,255,188,67,3,1989-12-10,2,1,"min",26
"15","Sun","December 17","L","OT","9-6",FALSE,"Cleveland Browns",17,23,19,316,194,122,1,16,320,256,64,2,1989-12-17,1,0,"min",-6
"16","Mon","December 25","W","","10-6",TRUE,"Cincinnati Bengals",29,21,24,393,274,119,1,26,429,309,120,5,1989-12-25,4,1,"min",8
"Division","Sat","January 6","L","","10-7",FALSE,"San Francisco 49ers",13,41,25,385,299,86,5,22,403,241,162,1,1990-01-06,-4,0,"min",-28
"1","Sun","September 9","L","","0-1",FALSE,"Kansas City Chiefs",21,24,20,354,224,130,3,18,304,190,114,1,1990-09-09,-2,0,"min",-3
"2","Sun","September 16","W","","1-1",TRUE,"New Orleans Saints",32,3,17,310,191,119,0,11,253,135,118,5,1990-09-16,5,1,"min",29
"3","Sun","September 23","L","","1-2",FALSE,"Chicago Bears",16,19,15,285,152,133,2,15,255,40,215,1,1990-09-23,-1,0,"min",-3
"4","Sun","September 30","L","OT","1-3",TRUE,"Tampa Bay Buccaneers",20,23,24,414,244,170,2,15,336,150,186,1,1990-09-30,-1,0,"min",-3
"5","Sun","October 7","L","","1-4",TRUE,"Detroit Lions",27,34,22,340,199,141,2,24,383,279,104,2,1990-10-07,0,0,"min",-7
"6","Mon","October 15","L","","1-5",FALSE,"Philadelphia Eagles",24,32,12,273,239,34,6,16,347,219,128,2,1990-10-15,-4,0,"min",-8
"8","Sun","October 28","L","","1-6",FALSE,"Green Bay Packers",10,24,16,316,219,97,6,14,292,166,126,1,1990-10-28,-5,0,"min",-14
"9","Sun","November 4","W","","2-6",TRUE,"Denver Broncos",27,22,15,256,111,145,1,19,287,141,146,3,1990-11-04,2,1,"min",5
"10","Sun","November 11","W","","3-6",FALSE,"Detroit Lions",17,7,15,270,126,144,1,14,237,127,110,5,1990-11-11,4,1,"min",10
"11","Sun","November 18","W","","4-6",FALSE,"Seattle Seahawks",24,21,14,302,161,141,1,17,233,132,101,1,1990-11-18,0,1,"min",3
"12","Sun","November 25","W","","5-6",TRUE,"Chicago Bears",41,13,20,246,145,101,0,19,266,159,107,3,1990-11-25,3,1,"min",28
"13","Sun","December 2","W","","6-6",TRUE,"Green Bay Packers",23,7,16,286,149,137,0,11,190,131,59,5,1990-12-02,5,1,"min",16
"14","Sun","December 9","L","","6-7",FALSE,"New York Giants",15,23,18,269,135,134,3,14,228,113,115,0,1990-12-09,-3,0,"min",-8
"15","Sun","December 16","L","","6-8",FALSE,"Tampa Bay Buccaneers",13,26,20,433,377,56,8,13,345,146,199,2,1990-12-16,-6,0,"min",-13
"16","Sat","December 22","L","","6-9",TRUE,"Los Angeles Raiders",24,28,25,401,314,87,1,15,359,234,125,0,1990-12-22,-1,0,"min",-4
"17","Sun","December 30","L","","6-10",TRUE,"San Francisco 49ers",17,20,19,279,181,98,1,22,402,281,121,1,1990-12-30,0,0,"min",-3
"1","Sun","September 1","L","","0-1",FALSE,"Chicago Bears",6,10,14,331,245,86,3,17,276,186,90,0,1991-09-01,-3,0,"min",-4
"2","Sun","September 8","W","","1-1",FALSE,"Atlanta Falcons",20,19,17,290,157,133,2,23,439,280,159,2,1991-09-08,0,1,"min",1
"3","Sun","September 15","W","","2-1",TRUE,"San Francisco 49ers",17,14,17,299,179,120,1,20,355,265,90,2,1991-09-15,1,1,"min",3
"4","Sun","September 22","L","","2-2",FALSE,"New Orleans Saints",0,26,6,151,108,43,3,16,343,147,196,2,1991-09-22,-1,0,"min",-26
"5","Sun","September 29","L","","2-3",TRUE,"Denver Broncos",6,13,15,324,121,203,3,17,242,63,179,1,1991-09-29,-2,0,"min",-7
"6","Sun","October 6","L","","2-4",FALSE,"Detroit Lions",20,24,15,202,105,97,0,25,400,276,124,1,1991-10-06,1,0,"min",-4
"7","Sun","October 13","W","","3-4",TRUE,"Phoenix Cardinals",34,7,25,385,254,131,0,17,254,204,50,1,1991-10-13,1,1,"min",27
"8","Sun","October 20","L","OT","3-5",FALSE,"New England Patriots",23,26,29,444,303,141,2,20,399,302,97,2,1991-10-20,0,0,"min",-3
"9","Sun","October 27","W","","4-5",FALSE,"Phoenix Cardinals",28,0,23,354,142,212,1,7,158,122,36,3,1991-10-27,2,1,"min",28
"10","Sun","November 3","W","","5-5",TRUE,"Tampa Bay Buccaneers",28,13,18,315,153,162,0,16,231,105,126,5,1991-11-03,5,1,"min",15
"11","Mon","November 11","L","","5-6",TRUE,"Chicago Bears",17,34,15,255,168,87,1,28,358,180,178,2,1991-11-11,1,0,"min",-17
"12","Sun","November 17","W","","6-6",FALSE,"Green Bay Packers",35,21,32,443,212,231,1,18,300,271,29,2,1991-11-17,1,1,"min",14
"13","Sun","November 24","L","","6-7",TRUE,"Detroit Lions",14,34,20,320,230,90,6,20,383,116,267,0,1991-11-24,-6,0,"min",-20
"15","Sun","December 8","W","","7-7",FALSE,"Tampa Bay Buccaneers",26,24,22,436,140,296,0,20,373,328,45,0,1991-12-08,0,1,"min",2
"16","Sun","December 15","W","","8-7",TRUE,"Los Angeles Rams",20,14,20,263,141,122,0,21,317,254,63,5,1991-12-15,5,1,"min",6
"17","Sat","December 21","L","","8-8",TRUE,"Green Bay Packers",7,27,12,272,225,47,3,16,188,80,108,0,1991-12-21,-3,0,"min",-20
"1","Sun","September 6","W","OT","1-0",FALSE,"Green Bay Packers",23,20,18,425,248,177,3,18,271,155,116,3,1992-09-06,0,1,"min",3
"2","Sun","September 13","L","","1-1",FALSE,"Detroit Lions",17,31,20,270,175,95,4,12,169,96,73,1,1992-09-13,-3,0,"min",-14
"3","Sun","September 20","W","","2-1",TRUE,"Tampa Bay Buccaneers",26,20,20,319,190,129,1,18,333,231,102,2,1992-09-20,1,1,"min",6
"4","Sun","September 27","W","","3-1",FALSE,"Cincinnati Bengals",42,7,28,423,317,106,0,14,178,65,113,4,1992-09-27,4,1,"min",35
"5","Sun","October 4","W","","4-1",TRUE,"Chicago Bears",21,20,18,332,205,127,4,19,275,189,86,2,1992-10-04,-2,1,"min",1
"7","Thu","October 15","W","","5-1",TRUE,"Detroit Lions",31,14,23,393,291,102,0,17,293,226,67,2,1992-10-15,2,1,"min",17
"8","Sun","October 25","L","","5-2",TRUE,"Washington Redskins",13,15,12,218,143,75,3,15,252,136,116,2,1992-10-25,-1,0,"min",-2
"9","Mon","November 2","W","","6-2",FALSE,"Chicago Bears",38,10,18,312,148,164,1,16,293,165,128,4,1992-11-02,3,1,"min",28
"10","Sun","November 8","W","","7-2",FALSE,"Tampa Bay Buccaneers",35,7,22,296,171,125,3,24,351,278,73,3,1992-11-08,0,1,"min",28
"11","Sun","November 15","L","","7-3",TRUE,"Houston Oilers",13,17,10,170,96,74,1,27,342,215,127,4,1992-11-15,3,0,"min",-4
"12","Sun","November 22","W","","8-3",TRUE,"Cleveland Browns",17,13,10,141,52,89,3,14,275,180,95,4,1992-11-22,1,1,"min",4
"13","Sun","November 29","W","","9-3",FALSE,"Los Angeles Rams",31,17,24,408,274,134,3,22,337,247,90,4,1992-11-29,1,1,"min",14
"14","Sun","December 6","L","","9-4",FALSE,"Philadelphia Eagles",17,28,15,219,81,138,1,26,360,135,225,2,1992-12-06,1,0,"min",-11
"15","Sun","December 13","L","","9-5",TRUE,"San Francisco 49ers",17,20,10,185,71,114,1,21,287,152,135,1,1992-12-13,0,0,"min",-3
"16","Sun","December 20","W","","10-5",FALSE,"Pittsburgh Steelers",6,3,18,341,125,216,3,17,288,130,158,1,1992-12-20,-2,1,"min",3
"17","Sun","December 27","W","","11-5",TRUE,"Green Bay Packers",27,7,22,447,282,165,1,13,211,182,29,3,1992-12-27,2,1,"min",20
"WildCard","Sat","January 2","L","","11-6",TRUE,"Washington Redskins",7,24,9,148,75,73,2,24,358,162,196,1,1993-01-02,-1,0,"min",-17
"1","Sun","September 5","L","","0-1",FALSE,"Los Angeles Raiders",7,24,18,205,147,58,3,19,312,214,98,1,1993-09-05,-2,0,"min",-17
"2","Sun","September 12","W","","1-1",TRUE,"Chicago Bears",10,7,15,276,155,121,1,7,140,52,88,1,1993-09-12,0,1,"min",3
"4","Sun","September 26","W","","2-1",TRUE,"Green Bay Packers",15,13,17,317,210,107,1,15,256,150,106,2,1993-09-26,1,1,"min",2
"5","Sun","October 3","L","","2-2",FALSE,"San Francisco 49ers",19,38,15,271,219,52,1,17,254,204,50,1,1993-10-03,0,0,"min",-19
"6","Sun","October 10","W","","3-2",TRUE,"Tampa Bay Buccaneers",15,0,18,268,144,124,1,11,169,110,59,5,1993-10-10,4,1,"min",15
"8","Mon","October 25","W","","4-2",FALSE,"Chicago Bears",19,12,14,252,87,165,1,12,250,159,91,3,1993-10-25,2,1,"min",7
"9","Sun","October 31","L","","4-3",TRUE,"Detroit Lions",27,30,25,378,262,116,3,13,338,260,78,2,1993-10-31,-1,0,"min",-3
"10","Sun","November 7","L","","4-4",TRUE,"San Diego Chargers",17,30,21,346,326,20,3,24,411,263,148,1,1993-11-07,-2,0,"min",-13
"11","Sun","November 14","W","","5-4",FALSE,"Denver Broncos",26,23,18,427,357,70,3,25,342,250,92,4,1993-11-14,1,1,"min",3
"12","Sun","November 21","L","","5-5",FALSE,"Tampa Bay Buccaneers",10,23,12,235,153,82,2,18,300,200,100,0,1993-11-21,-2,0,"min",-13
"13","Sun","November 28","L","","5-6",TRUE,"New Orleans Saints",14,17,16,288,182,106,1,15,254,100,154,3,1993-11-28,2,0,"min",-3
"14","Sun","December 5","W","","6-6",FALSE,"Detroit Lions",13,0,14,234,133,101,1,16,219,111,108,5,1993-12-05,4,1,"min",13
"15","Sun","December 12","L","","6-7",TRUE,"Dallas Cowboys",20,37,20,270,173,97,1,25,356,208,148,0,1993-12-12,-1,0,"min",-17
"16","Sun","December 19","W","","7-7",FALSE,"Green Bay Packers",21,17,21,361,207,154,0,16,320,253,67,2,1993-12-19,2,1,"min",4
"17","Sun","December 26","W","","8-7",TRUE,"Kansas City Chiefs",30,10,23,424,219,205,1,12,220,183,37,3,1993-12-26,2,1,"min",20
"18","Fri","December 31","W","","9-7",FALSE,"Washington Redskins",14,9,16,272,226,46,1,14,265,153,112,1,1993-12-31,0,1,"min",5
"WildCard","Sun","January 9","L","","9-8",FALSE,"New York Giants",10,17,11,260,181,79,1,17,270,94,176,0,1994-01-09,-1,0,"min",-7
"1","Sun","September 4","L","","0-1",FALSE,"Green Bay Packers",10,16,12,194,146,48,3,15,264,170,94,1,1994-09-04,-2,0,"min",-6
"2","Sun","September 11","W","","1-1",TRUE,"Detroit Lions",10,3,14,289,203,86,3,13,212,175,37,3,1994-09-11,0,1,"min",7
"3","Sun","September 18","W","","2-1",FALSE,"Chicago Bears",42,14,28,464,252,212,2,19,304,244,60,2,1994-09-18,0,1,"min",28
"4","Sun","September 25","W","","3-1",TRUE,"Miami Dolphins",38,35,24,458,311,147,0,27,473,426,47,4,1994-09-25,4,1,"min",3
"5","Sun","October 2","L","","3-2",FALSE,"Arizona Cardinals",7,17,19,358,340,18,4,21,309,200,109,2,1994-10-02,-2,0,"min",-10
"6","Mon","October 10","W","","4-2",FALSE,"New York Giants",27,10,25,395,292,103,2,16,240,203,37,3,1994-10-10,1,1,"min",17
"8","Thu","October 20","W","OT","5-2",TRUE,"Green Bay Packers",13,10,16,252,230,22,2,12,158,87,71,2,1994-10-20,0,1,"min",3
"9","Sun","October 30","W","","6-2",FALSE,"Tampa Bay Buccaneers",36,13,19,361,212,149,2,14,234,185,49,5,1994-10-30,3,1,"min",23
"10","Sun","November 6","W","","7-2",TRUE,"New Orleans Saints",21,20,28,494,410,84,3,17,313,241,72,1,1994-11-06,-2,1,"min",1
"11","Sun","November 13","L","OT","7-3",FALSE,"New England Patriots",20,26,22,440,339,101,1,27,468,426,42,0,1994-11-13,-1,0,"min",-6
"12","Sun","November 20","L","","7-4",TRUE,"New York Jets",21,31,26,461,374,87,4,17,282,220,62,1,1994-11-20,-3,0,"min",-10
"13","Sun","November 27","L","OT","7-5",TRUE,"Tampa Bay Buccaneers",17,20,19,331,246,85,2,20,326,254,72,1,1994-11-27,-1,0,"min",-3
"14","Thu","December 1","W","OT","8-5",TRUE,"Chicago Bears",33,27,21,385,285,100,2,15,312,232,80,3,1994-12-01,1,1,"min",6
"15","Sun","December 11","W","","9-5",FALSE,"Buffalo Bills",21,17,20,377,261,116,1,19,268,183,85,1,1994-12-11,0,1,"min",4
"16","Sat","December 17","L","","9-6",FALSE,"Detroit Lions",19,41,18,337,273,64,1,17,284,160,124,1,1994-12-17,0,0,"min",-22
"17","Mon","December 26","W","","10-6",TRUE,"San Francisco 49ers",21,14,14,252,150,102,2,18,295,246,49,4,1994-12-26,2,1,"min",7
"WildCard","Sun","January 1","L","","10-7",TRUE,"Chicago Bears",18,35,22,391,342,49,4,18,308,214,94,2,1995-01-01,-2,0,"min",-17
"1","Sun","September 3","L","","0-1",FALSE,"Chicago Bears",14,31,21,348,230,118,1,20,397,254,143,1,1995-09-03,0,0,"min",-17
"2","Sun","September 10","W","","1-1",TRUE,"Detroit Lions",20,10,19,380,225,155,1,19,326,272,54,1,1995-09-10,0,1,"min",10
"3","Sun","September 17","L","OT","1-2",TRUE,"Dallas Cowboys",17,23,17,252,160,92,1,20,387,233,154,2,1995-09-17,1,0,"min",-6
"4","Sun","September 24","W","","2-2",FALSE,"Pittsburgh Steelers",44,24,20,378,244,134,4,22,405,335,70,7,1995-09-24,3,1,"min",20
"6","Sun","October 8","W","OT","3-2",TRUE,"Houston Oilers",23,17,21,388,281,107,3,15,203,128,75,2,1995-10-08,-1,1,"min",6
"7","Sun","October 15","L","OT","3-3",FALSE,"Tampa Bay Buccaneers",17,20,23,394,332,62,4,19,263,219,44,2,1995-10-15,-2,0,"min",-3
"8","Sun","October 22","L","","3-4",FALSE,"Green Bay Packers",21,38,17,263,170,93,4,22,346,277,69,1,1995-10-22,-3,0,"min",-17
"9","Mon","October 30","L","","3-5",TRUE,"Chicago Bears",6,14,19,297,227,70,1,19,311,231,80,1,1995-10-30,0,0,"min",-8
"10","Sun","November 5","W","","4-5",TRUE,"Green Bay Packers",27,24,17,319,225,94,1,23,344,261,83,6,1995-11-05,5,1,"min",3
"11","Sun","November 12","W","OT","5-5",FALSE,"Arizona Cardinals",30,24,22,391,302,89,1,20,322,204,118,2,1995-11-12,1,1,"min",6
"12","Sun","November 19","W","","6-5",TRUE,"New Orleans Saints",43,24,32,544,398,146,0,20,387,319,68,0,1995-11-19,0,1,"min",19
"13","Thu","November 23","L","","6-6",FALSE,"Detroit Lions",38,44,22,385,351,34,3,27,534,395,139,3,1995-11-23,0,0,"min",-6
"14","Sun","December 3","W","","7-6",TRUE,"Tampa Bay Buccaneers",31,17,22,451,261,190,2,17,256,166,90,2,1995-12-03,0,1,"min",14
"15","Sat","December 9","W","","8-6",TRUE,"Cleveland Browns",27,11,26,436,325,111,2,10,201,172,29,4,1995-12-09,2,1,"min",16
"16","Mon","December 18","L","","8-7",FALSE,"San Francisco 49ers",30,37,17,264,189,75,0,21,467,425,42,4,1995-12-18,4,0,"min",-7
"17","Sun","December 24","L","","8-8",FALSE,"Cincinnati Bengals",24,27,27,448,285,163,1,18,302,231,71,2,1995-12-24,1,0,"min",-3
"1","Sun","September 1","W","","1-0",TRUE,"Detroit Lions",17,13,16,311,183,128,0,27,435,244,191,5,1996-09-01,5,1,"min",4
"2","Sun","September 8","W","","2-0",FALSE,"Atlanta Falcons",23,17,18,365,266,99,2,21,324,245,79,2,1996-09-08,0,1,"min",6
"3","Sun","September 15","W","","3-0",FALSE,"Chicago Bears",20,14,21,377,239,138,1,17,299,191,108,3,1996-09-15,2,1,"min",6
"4","Sun","September 22","W","","4-0",TRUE,"Green Bay Packers",30,21,18,351,263,88,4,8,217,157,60,4,1996-09-22,0,1,"min",9
"5","Sun","September 29","L","","4-1",FALSE,"New York Giants",10,15,10,228,140,88,2,21,291,146,145,0,1996-09-29,-2,0,"min",-5
"6","Sun","October 6","W","","5-1",TRUE,"Carolina Panthers",14,12,16,293,192,101,2,15,256,155,101,6,1996-10-06,4,1,"min",2
"7","Sun","October 13","L","","5-2",FALSE,"Tampa Bay Buccaneers",13,24,17,394,255,139,3,20,284,208,76,0,1996-10-13,-3,0,"min",-11
"9","Mon","October 28","L","","5-3",TRUE,"Chicago Bears",13,15,16,279,268,11,2,18,276,180,96,2,1996-10-28,0,0,"min",-2
"10","Sun","November 3","L","","5-4",TRUE,"Kansas City Chiefs",6,21,13,258,210,48,2,23,359,157,202,1,1996-11-03,-1,0,"min",-15
"11","Sun","November 10","L","","5-5",FALSE,"Seattle Seahawks",23,42,16,315,300,15,4,26,452,253,199,1,1996-11-10,-3,0,"min",-19
"12","Sun","November 17","W","OT","6-5",FALSE,"Oakland Raiders",16,13,20,445,263,182,2,13,237,112,125,1,1996-11-17,-1,1,"min",3
"13","Sun","November 24","L","","6-6",TRUE,"Denver Broncos",17,21,20,296,246,50,2,22,388,309,79,3,1996-11-24,1,0,"min",-4
"14","Sun","December 1","W","","7-6",TRUE,"Arizona Cardinals",41,17,29,412,263,149,0,18,280,245,35,3,1996-12-01,3,1,"min",24
"15","Sun","December 8","W","","8-6",FALSE,"Detroit Lions",24,22,21,289,173,116,0,23,380,235,145,0,1996-12-08,0,1,"min",2
"16","Sun","December 15","W","","9-6",TRUE,"Tampa Bay Buccaneers",21,10,21,339,194,145,4,8,169,77,92,2,1996-12-15,-2,1,"min",11
"17","Sun","December 22","L","","9-7",FALSE,"Green Bay Packers",10,38,12,252,203,49,2,29,440,207,233,2,1996-12-22,0,0,"min",-28
"WildCard","Sat","December 28","L","","9-8",FALSE,"Dallas Cowboys",15,40,12,268,205,63,6,27,438,183,255,2,1996-12-28,-4,0,"min",-25
"1","Sun","August 31","W","","1-0",FALSE,"Buffalo Bills",34,13,17,385,200,185,1,22,426,279,147,4,1997-08-31,3,1,"min",21
"2","Sun","September 7","W","","2-0",FALSE,"Chicago Bears",27,24,23,378,261,117,1,16,305,158,147,2,1997-09-07,1,1,"min",3
"3","Sun","September 14","L","","2-1",TRUE,"Tampa Bay Buccaneers",14,28,20,382,310,72,2,17,376,185,191,0,1997-09-14,-2,0,"min",-14
"4","Sun","September 21","L","","2-2",FALSE,"Green Bay Packers",32,38,22,393,208,185,2,24,350,257,93,3,1997-09-21,1,0,"min",-6
"5","Sun","September 28","W","","3-2",TRUE,"Philadelphia Eagles",28,19,17,365,221,144,1,25,372,272,100,3,1997-09-28,2,1,"min",9
"6","Sun","October 5","W","","4-2",FALSE,"Arizona Cardinals",20,19,20,353,272,81,3,22,385,277,108,1,1997-10-05,-2,1,"min",1
"7","Sun","October 12","W","","5-2",TRUE,"Carolina Panthers",21,14,17,361,203,158,1,15,277,197,80,2,1997-10-12,1,1,"min",7
"9","Sun","October 26","W","","6-2",FALSE,"Tampa Bay Buccaneers",10,6,16,308,214,94,0,11,229,177,52,0,1997-10-26,0,1,"min",4
"10","Sun","November 2","W","","7-2",TRUE,"New England Patriots",23,18,18,288,222,66,0,21,410,293,117,1,1997-11-02,1,1,"min",5
"11","Sun","November 9","W","","8-2",TRUE,"Chicago Bears",29,22,19,302,193,109,2,20,341,251,90,2,1997-11-09,0,1,"min",7
"12","Sun","November 16","L","","8-3",FALSE,"Detroit Lions",15,38,18,300,174,126,1,27,477,266,211,0,1997-11-16,-1,0,"min",-23
"13","Sun","November 23","L","","8-4",FALSE,"New York Jets",21,23,19,386,312,74,1,22,357,227,130,3,1997-11-23,2,0,"min",-2
"14","Mon","December 1","L","","8-5",TRUE,"Green Bay Packers",11,27,17,253,154,99,2,17,326,187,139,0,1997-12-01,-2,0,"min",-16
"15","Sun","December 7","L","","8-6",FALSE,"San Francisco 49ers",17,28,20,298,161,137,2,24,368,270,98,0,1997-12-07,-2,0,"min",-11
"16","Sun","December 14","L","","8-7",TRUE,"Detroit Lions",13,14,13,257,43,214,0,21,390,242,148,1,1997-12-14,1,0,"min",-1
"17","Sun","December 21","W","","9-7",TRUE,"Indianapolis Colts",39,28,17,345,165,180,3,21,298,166,132,5,1997-12-21,2,1,"min",11
"WildCard","Sat","December 27","W","","10-7",FALSE,"New York Giants",23,22,16,293,187,106,3,13,266,190,76,2,1997-12-27,-1,1,"min",1
"Division","Sat","January 3","L","","10-8",FALSE,"San Francisco 49ers",22,38,16,378,321,57,1,31,394,219,175,0,1998-01-03,-1,0,"min",-16
"1","Sun","September 6","W","","1-0",TRUE,"Tampa Bay Buccaneers",31,7,19,298,181,117,1,17,319,251,68,2,1998-09-06,1,1,"min",24
"2","Sun","September 13","W","","2-0",FALSE,"St. Louis Rams",38,31,23,421,227,194,3,22,410,275,135,4,1998-09-13,1,1,"min",7
"3","Sun","September 20","W","","3-0",TRUE,"Detroit Lions",29,6,17,287,211,76,0,19,279,142,137,4,1998-09-20,4,1,"min",23
"4","Sun","September 27","W","","4-0",FALSE,"Chicago Bears",31,28,17,351,258,93,0,23,452,361,91,1,1998-09-27,1,1,"min",3
"5","Mon","October 5","W","","5-0",FALSE,"Green Bay Packers",37,24,22,545,442,103,1,21,306,204,102,3,1998-10-05,2,1,"min",13
"7","Sun","October 18","W","","6-0",TRUE,"Washington Redskins",41,7,25,435,288,147,1,9,177,95,82,1,1998-10-18,0,1,"min",34
"8","Sun","October 25","W","","7-0",FALSE,"Detroit Lions",34,13,23,329,170,159,3,17,351,214,137,1,1998-10-25,-2,1,"min",21
"9","Sun","November 1","L","","7-1",FALSE,"Tampa Bay Buccaneers",24,27,18,340,270,70,1,22,378,132,246,0,1998-11-01,-1,0,"min",-3
"10","Sun","November 8","W","","8-1",TRUE,"New Orleans Saints",31,24,23,465,303,162,2,11,190,138,52,1,1998-11-08,-1,1,"min",7
"11","Sun","November 15","W","","9-1",TRUE,"Cincinnati Bengals",24,3,16,349,224,125,3,15,194,91,103,2,1998-11-15,-1,1,"min",21
"12","Sun","November 22","W","","10-1",TRUE,"Green Bay Packers",28,14,15,340,248,92,1,22,330,277,53,3,1998-11-22,2,1,"min",14
"13","Thu","November 26","W","","11-1",FALSE,"Dallas Cowboys",46,36,21,471,353,118,1,32,513,455,58,0,1998-11-26,-1,1,"min",10
"14","Sun","December 6","W","","12-1",TRUE,"Chicago Bears",48,22,23,458,349,109,1,19,339,272,67,2,1998-12-06,1,1,"min",26
"15","Sun","December 13","W","","13-1",FALSE,"Baltimore Ravens",38,28,26,420,332,88,1,16,267,212,55,6,1998-12-13,5,1,"min",10
"16","Sun","December 20","W","","14-1",TRUE,"Jacksonville Jaguars",50,10,25,417,237,180,0,15,207,69,138,4,1998-12-20,4,1,"min",40
"17","Sat","December 26","W","","15-1",FALSE,"Tennessee Oilers",26,16,22,338,235,103,1,20,354,264,90,0,1998-12-26,-1,1,"min",10
"Division","Sun","January 10","W","","16-1",TRUE,"Arizona Cardinals",41,21,26,416,228,188,1,23,316,242,74,3,1999-01-10,2,1,"min",20
"ConfChamp","Sun","January 17","L","OT","16-2",TRUE,"Atlanta Falcons",27,30,26,356,254,102,2,25,427,317,110,2,1999-01-17,0,0,"min",-3
"1","Sun","September 12","W","","1-0",FALSE,"Atlanta Falcons",17,14,19,299,184,115,0,22,359,278,81,3,1999-09-12,3,1,"min",3
"2","Sun","September 19","L","","1-1",TRUE,"Oakland Raiders",17,22,19,354,320,34,3,22,402,240,162,1,1999-09-19,-2,0,"min",-5
"3","Sun","September 26","L","","1-2",FALSE,"Green Bay Packers",20,23,21,328,231,97,2,20,360,289,71,0,1999-09-26,-2,0,"min",-3
"4","Sun","October 3","W","","2-2",TRUE,"Tampa Bay Buccaneers",21,14,20,364,296,68,1,22,370,286,84,2,1999-10-03,1,1,"min",7
"5","Sun","October 10","L","","2-3",TRUE,"Chicago Bears",22,24,26,445,279,166,5,23,379,278,101,0,1999-10-10,-5,0,"min",-2
"6","Sun","October 17","L","","2-4",FALSE,"Detroit Lions",23,25,17,327,267,60,5,19,299,189,110,1,1999-10-17,-4,0,"min",-2
"7","Sun","October 24","W","","3-4",TRUE,"San Francisco 49ers",40,16,25,395,240,155,2,14,260,178,82,2,1999-10-24,0,1,"min",24
"8","Sun","October 31","W","","4-4",FALSE,"Denver Broncos",23,20,15,302,205,97,0,24,391,256,135,3,1999-10-31,3,1,"min",3
"9","Mon","November 8","W","","5-4",TRUE,"Dallas Cowboys",27,17,17,308,190,118,2,14,328,123,205,2,1999-11-08,0,1,"min",10
"10","Sun","November 14","W","OT","6-4",FALSE,"Chicago Bears",27,24,23,459,349,110,3,21,456,407,49,2,1999-11-14,-1,1,"min",3
"12","Sun","November 28","W","","7-4",TRUE,"San Diego Chargers",35,27,27,485,356,129,2,19,458,396,62,3,1999-11-28,1,1,"min",8
"13","Mon","December 6","L","","7-5",FALSE,"Tampa Bay Buccaneers",17,24,21,339,246,93,4,13,190,87,103,3,1999-12-06,-1,0,"min",-7
"14","Sun","December 12","L","","7-6",FALSE,"Kansas City Chiefs",28,31,21,326,151,175,4,22,380,207,173,2,1999-12-12,-2,0,"min",-3
"15","Mon","December 20","W","","8-6",TRUE,"Green Bay Packers",24,20,15,305,229,76,2,20,319,212,107,3,1999-12-20,1,1,"min",4
"16","Sun","December 26","W","","9-6",FALSE,"New York Giants",34,17,18,378,204,174,2,25,344,268,76,1,1999-12-26,-1,1,"min",17
"17","Sun","January 2","W","","10-6",TRUE,"Detroit Lions",24,17,20,379,242,137,3,20,302,286,16,2,2000-01-02,-1,1,"min",7
"WildCard","Sun","January 9","W","","11-6",TRUE,"Dallas Cowboys",27,10,20,374,199,175,0,18,389,278,111,3,2000-01-09,3,1,"min",17
"Division","Sun","January 16","L","","11-7",FALSE,"St. Louis Rams",37,49,27,475,388,87,3,23,405,374,31,3,2000-01-16,0,0,"min",-12
"1","Sun","September 3","W","","1-0",TRUE,"Chicago Bears",30,27,17,374,188,186,1,23,425,272,153,1,2000-09-03,0,1,"min",3
"2","Sun","September 10","W","","2-0",TRUE,"Miami Dolphins",13,7,24,468,343,125,4,10,209,160,49,1,2000-09-10,-3,1,"min",6
"3","Sun","September 17","W","","3-0",FALSE,"New England Patriots",21,13,23,315,161,154,2,18,267,164,103,1,2000-09-17,-1,1,"min",8
"5","Sun","October 1","W","","4-0",FALSE,"Detroit Lions",31,24,19,439,261,178,0,27,355,226,129,1,2000-10-01,1,1,"min",7
"6","Mon","October 9","W","","5-0",TRUE,"Tampa Bay Buccaneers",30,23,17,322,207,115,2,22,346,283,63,3,2000-10-09,1,1,"min",7
"7","Sun","October 15","W","","6-0",FALSE,"Chicago Bears",28,16,17,368,177,191,1,17,294,196,98,0,2000-10-15,-1,1,"min",12
"8","Sun","October 22","W","","7-0",TRUE,"Buffalo Bills",31,27,17,348,251,97,1,21,406,286,120,1,2000-10-22,0,1,"min",4
"9","Sun","October 29","L","","7-1",FALSE,"Tampa Bay Buccaneers",13,41,25,401,302,99,3,23,413,261,152,0,2000-10-29,-3,0,"min",-28
"10","Mon","November 6","L","OT","7-2",FALSE,"Green Bay Packers",20,26,22,407,250,157,5,19,298,217,81,0,2000-11-06,-5,0,"min",-6
"11","Sun","November 12","W","","8-2",TRUE,"Arizona Cardinals",31,14,29,460,302,158,2,14,249,198,51,2,2000-11-12,0,1,"min",17
"12","Sun","November 19","W","","9-2",TRUE,"Carolina Panthers",31,17,19,446,329,117,2,23,330,252,78,3,2000-11-19,1,1,"min",14
"13","Thu","November 23","W","","10-2",FALSE,"Dallas Cowboys",27,15,18,360,192,168,0,22,404,276,128,2,2000-11-23,2,1,"min",12
"14","Thu","November 30","W","","11-2",TRUE,"Detroit Lions",24,17,19,305,160,145,2,20,352,213,139,2,2000-11-30,0,1,"min",7
"15","Sun","December 10","L","","11-3",FALSE,"St. Louis Rams",29,40,23,312,208,104,0,32,508,346,162,0,2000-12-10,0,0,"min",-11
"16","Sun","December 17","L","","11-4",TRUE,"Green Bay Packers",28,33,19,400,332,68,2,28,434,280,154,0,2000-12-17,-2,0,"min",-5
"17","Sun","December 24","L","","11-5",FALSE,"Indianapolis Colts",10,31,11,236,169,67,1,25,411,283,128,1,2000-12-24,0,0,"min",-21
"Division","Sat","January 6","W","","12-5",TRUE,"New Orleans Saints",34,16,18,429,302,127,0,19,355,286,69,2,2001-01-06,2,1,"min",18
"ConfChamp","Sun","January 14","L","","12-6",FALSE,"New York Giants",0,41,9,114,60,54,5,31,518,380,138,2,2001-01-14,-3,0,"min",-41
"1","Sun","September 9","L","","0-1",TRUE,"Carolina Panthers",13,24,19,343,234,109,5,15,291,200,91,2,2001-09-09,-3,0,"min",-11
"2","Sun","September 23","L","","0-2",FALSE,"Chicago Bears",10,17,19,319,215,104,2,15,284,237,47,1,2001-09-23,-1,0,"min",-7
"3","Sun","September 30","W","","1-2",TRUE,"Tampa Bay Buccaneers",20,16,25,402,312,90,2,20,331,223,108,1,2001-09-30,-1,1,"min",4
"4","Sun","October 7","L","","1-3",FALSE,"New Orleans Saints",15,28,16,340,306,34,3,20,370,210,160,1,2001-10-07,-2,0,"min",-13
"5","Sun","October 14","W","","2-3",TRUE,"Detroit Lions",31,26,23,343,198,145,1,28,457,328,129,1,2001-10-14,0,1,"min",5
"6","Sun","October 21","W","","3-3",TRUE,"Green Bay Packers",35,13,23,377,177,200,2,10,234,160,74,1,2001-10-21,-1,1,"min",22
"7","Sun","October 28","L","","3-4",FALSE,"Tampa Bay Buccaneers",14,41,11,195,130,65,1,26,446,269,177,1,2001-10-28,0,0,"min",-27
"9","Sun","November 11","L","","3-5",FALSE,"Philadelphia Eagles",17,48,16,301,245,56,4,33,487,215,272,1,2001-11-11,-3,0,"min",-31
"10","Mon","November 19","W","","4-5",TRUE,"New York Giants",28,16,24,359,263,96,3,18,358,297,61,2,2001-11-19,-1,1,"min",12
"11","Sun","November 25","L","","4-6",TRUE,"Chicago Bears",6,13,15,316,192,124,1,11,235,93,142,1,2001-11-25,0,0,"min",-7
"12","Sun","December 2","L","","4-7",FALSE,"Pittsburgh Steelers",16,21,12,385,340,45,3,21,364,157,207,2,2001-12-02,-1,0,"min",-5
"13","Sun","December 9","W","","5-7",TRUE,"Tennessee Titans",42,24,24,496,348,148,1,24,453,271,182,2,2001-12-09,1,1,"min",18
"14","Sun","December 16","L","","5-8",FALSE,"Detroit Lions",24,27,16,314,234,80,2,19,369,202,167,1,2001-12-16,-1,0,"min",-3
"15","Sun","December 23","L","","5-9",TRUE,"Jacksonville Jaguars",3,33,16,214,186,28,2,23,423,209,214,0,2001-12-23,-2,0,"min",-30
"16","Sun","December 30","L","","5-10",FALSE,"Green Bay Packers",13,24,19,302,103,199,3,13,213,157,56,1,2001-12-30,-2,0,"min",-11
"17","Mon","January 7","L","","5-11",FALSE,"Baltimore Ravens",3,19,10,179,93,86,4,16,351,139,212,0,2002-01-07,-4,0,"min",-16
"1","Sun","September 8","L","","0-1",FALSE,"Chicago Bears",23,27,19,368,228,140,3,20,368,288,80,2,2002-09-08,-1,0,"min",-4
"2","Sun","September 15","L","OT","0-2",TRUE,"Buffalo Bills",39,45,31,449,236,213,3,26,468,437,31,0,2002-09-15,-3,0,"min",-6
"3","Sun","September 22","L","","0-3",TRUE,"Carolina Panthers",14,21,13,250,177,73,5,20,370,206,164,2,2002-09-22,-3,0,"min",-7
"4","Sun","September 29","L","","0-4",FALSE,"Seattle Seahawks",23,48,28,443,249,194,4,18,381,222,159,1,2002-09-29,-3,0,"min",-25
"6","Sun","October 13","W","","1-4",TRUE,"Detroit Lions",31,24,22,402,291,111,1,17,354,301,53,1,2002-10-13,0,1,"min",7
"7","Sun","October 20","L","","1-5",FALSE,"New York Jets",7,20,21,389,288,101,4,21,407,316,91,0,2002-10-20,-4,0,"min",-13
"8","Sun","October 27","W","","2-5",TRUE,"Chicago Bears",25,7,24,364,216,148,1,12,218,174,44,3,2002-10-27,2,1,"min",18
"9","Sun","November 3","L","","2-6",FALSE,"Tampa Bay Buccaneers",24,38,22,387,214,173,3,27,446,313,133,0,2002-11-03,-3,0,"min",-14
"10","Sun","November 10","L","","2-7",TRUE,"New York Giants",20,27,17,356,132,224,2,26,460,291,169,1,2002-11-10,-1,0,"min",-7
"11","Sun","November 17","W","","3-7",TRUE,"Green Bay Packers",31,21,24,425,207,218,3,18,367,296,71,3,2002-11-17,0,1,"min",10
"12","Sun","November 24","L","","3-8",FALSE,"New England Patriots",17,24,26,417,264,153,3,20,299,219,80,0,2002-11-24,-3,0,"min",-7
"13","Sun","December 1","L","OT","3-9",TRUE,"Atlanta Falcons",24,30,21,369,230,139,3,19,379,152,227,3,2002-12-01,0,0,"min",-6
"14","Sun","December 8","L","","3-10",FALSE,"Green Bay Packers",22,26,15,316,125,191,1,20,328,204,124,2,2002-12-08,1,0,"min",-4
"15","Sun","December 15","W","","4-10",FALSE,"New Orleans Saints",32,31,22,439,293,146,0,18,299,221,78,0,2002-12-15,0,1,"min",1
"16","Sat","December 21","W","","5-10",TRUE,"Miami Dolphins",20,17,21,368,239,129,3,13,239,170,69,2,2002-12-21,-1,1,"min",3
"17","Sun","December 29","W","","6-10",FALSE,"Detroit Lions",38,36,24,450,296,154,2,20,386,293,93,3,2002-12-29,1,1,"min",2
"1","Sun","September 7","W","","1-0",FALSE,"Green Bay Packers",30,25,21,337,183,154,2,22,304,242,62,5,2003-09-07,3,1,"min",5
"2","Sun","September 14","W","","2-0",TRUE,"Chicago Bears",24,13,25,400,198,202,1,10,208,128,80,1,2003-09-14,0,1,"min",11
"3","Sun","September 21","W","","3-0",FALSE,"Detroit Lions",23,13,14,414,287,127,1,22,302,225,77,3,2003-09-21,2,1,"min",10
"4","Sun","September 28","W","","4-0",TRUE,"San Francisco 49ers",35,7,19,354,252,102,0,18,372,227,145,3,2003-09-28,3,1,"min",28
"5","Sun","October 5","W","","5-0",FALSE,"Atlanta Falcons",39,26,16,399,233,166,1,21,440,336,104,3,2003-10-05,2,1,"min",13
"7","Sun","October 19","W","","6-0",TRUE,"Denver Broncos",28,20,14,340,268,72,0,27,321,183,138,3,2003-10-19,3,1,"min",8
"8","Sun","October 26","L","","6-1",TRUE,"New York Giants",17,29,22,359,222,137,2,26,450,367,83,1,2003-10-26,-1,0,"min",-12
"9","Sun","November 2","L","","6-2",TRUE,"Green Bay Packers",27,30,20,323,198,125,0,24,451,190,261,1,2003-11-02,1,0,"min",-3
"10","Sun","November 9","L","","6-3",FALSE,"San Diego Chargers",28,42,27,460,350,110,2,26,458,247,211,0,2003-11-09,-2,0,"min",-14
"11","Sun","November 16","L","","6-4",FALSE,"Oakland Raiders",18,28,24,467,373,94,6,19,375,184,191,2,2003-11-16,-4,0,"min",-10
"12","Sun","November 23","W","","7-4",TRUE,"Detroit Lions",24,14,18,307,186,121,2,16,241,167,74,4,2003-11-23,2,1,"min",10
"13","Sun","November 30","L","","7-5",FALSE,"St. Louis Rams",17,48,25,465,276,189,3,21,396,255,141,1,2003-11-30,-2,0,"min",-31
"14","Sun","December 7","W","","8-5",TRUE,"Seattle Seahawks",34,7,22,465,272,193,0,13,258,202,56,3,2003-12-07,3,1,"min",27
"15","Sun","December 14","L","","8-6",FALSE,"Chicago Bears",10,13,22,393,215,178,1,15,232,145,87,0,2003-12-14,-1,0,"min",-3
"16","Sat","December 20","W","","9-6",TRUE,"Kansas City Chiefs",45,20,27,469,246,223,1,21,329,224,105,4,2003-12-20,3,1,"min",25
"17","Sun","December 28","L","","9-7",FALSE,"Arizona Cardinals",17,18,20,342,192,150,2,15,219,155,64,1,2003-12-28,-1,0,"min",-1
"1","Sun","September 12","W","","1-0",TRUE,"Dallas Cowboys",35,17,23,415,279,136,0,27,423,352,71,2,2004-09-12,2,1,"min",18
"2","Mon","September 20","L","","1-1",FALSE,"Philadelphia Eagles",16,27,25,410,332,78,2,19,317,226,91,1,2004-09-20,-1,0,"min",-11
"3","Sun","September 26","W","","2-1",TRUE,"Chicago Bears",27,22,24,443,350,93,2,24,385,239,146,1,2004-09-26,-1,1,"min",5
"5","Sun","October 10","W","OT","3-1",FALSE,"Houston Texans",34,28,27,510,388,122,0,19,410,358,52,0,2004-10-10,0,1,"min",6
"6","Sun","October 17","W","","4-1",FALSE,"New Orleans Saints",38,31,29,605,417,188,3,25,385,226,159,1,2004-10-17,-2,1,"min",7
"7","Sun","October 24","W","","5-1",TRUE,"Tennessee Titans",20,3,20,313,161,152,0,16,243,188,55,4,2004-10-24,4,1,"min",17
"8","Sun","October 31","L","","5-2",TRUE,"New York Giants",13,34,15,324,231,93,3,22,283,115,168,0,2004-10-31,-3,0,"min",-21
"9","Mon","November 8","L","","5-3",FALSE,"Indianapolis Colts",28,31,15,292,154,138,1,26,408,264,144,0,2004-11-08,-1,0,"min",-3
"10","Sun","November 14","L","","5-4",FALSE,"Green Bay Packers",31,34,22,416,345,71,0,24,442,236,206,1,2004-11-14,1,0,"min",-3
"11","Sun","November 21","W","","6-4",TRUE,"Detroit Lions",22,19,22,319,212,107,1,13,213,67,146,1,2004-11-21,0,1,"min",3
"12","Sun","November 28","W","","7-4",TRUE,"Jacksonville Jaguars",27,16,24,330,218,112,2,18,379,225,154,2,2004-11-28,0,1,"min",11
"13","Sun","December 5","L","","7-5",FALSE,"Chicago Bears",14,24,24,391,245,146,4,21,318,174,144,1,2004-12-05,-3,0,"min",-10
"14","Sun","December 12","L","","7-6",TRUE,"Seattle Seahawks",23,27,22,374,261,113,2,26,455,317,138,2,2004-12-12,0,0,"min",-4
"15","Sun","December 19","W","","8-6",FALSE,"Detroit Lions",28,27,21,461,370,91,1,24,463,350,113,3,2004-12-19,2,1,"min",1
"16","Fri","December 24","L","","8-7",TRUE,"Green Bay Packers",31,34,17,416,285,131,0,26,460,358,102,1,2004-12-24,1,0,"min",-3
"17","Sun","January 2","L","","8-8",FALSE,"Washington Redskins",18,21,21,320,268,52,0,20,318,201,117,2,2005-01-02,2,0,"min",-3
"WildCard","Sun","January 9","W","","9-8",FALSE,"Green Bay Packers",31,17,18,384,261,123,0,24,306,201,105,4,2005-01-09,4,1,"min",14
"Division","Sun","January 16","L","","9-9",FALSE,"Philadelphia Eagles",14,27,21,385,288,97,2,23,395,286,109,1,2005-01-16,-1,0,"min",-13
"1","Sun","September 11","L","","0-1",TRUE,"Tampa Bay Buccaneers",13,24,15,248,215,33,5,12,345,199,146,2,2005-09-11,-3,0,"min",-11
"2","Sun","September 18","L","","0-2",FALSE,"Cincinnati Bengals",8,37,21,304,227,77,7,26,504,337,167,1,2005-09-18,-6,0,"min",-29
"3","Sun","September 25","W","","1-2",TRUE,"New Orleans Saints",33,16,21,420,274,146,0,15,296,182,114,4,2005-09-25,4,1,"min",17
"4","Sun","October 2","L","","1-3",FALSE,"Atlanta Falcons",10,30,17,261,198,63,3,22,368,83,285,0,2005-10-02,-3,0,"min",-20
"6","Sun","October 16","L","","1-4",FALSE,"Chicago Bears",3,28,16,283,203,80,2,16,192,97,95,3,2005-10-16,1,0,"min",-25
"7","Sun","October 23","W","","2-4",TRUE,"Green Bay Packers",23,20,24,363,255,108,1,19,374,329,45,0,2005-10-23,-1,1,"min",3
"8","Sun","October 30","L","","2-5",FALSE,"Carolina Panthers",13,38,14,253,171,82,0,27,449,338,111,0,2005-10-30,0,0,"min",-25
"9","Sun","November 6","W","","3-5",TRUE,"Detroit Lions",27,14,19,285,121,164,1,20,289,231,58,3,2005-11-06,2,1,"min",13
"10","Sun","November 13","W","","4-5",FALSE,"New York Giants",24,21,11,137,125,12,1,25,405,281,124,5,2005-11-13,4,1,"min",3
"11","Mon","November 21","W","","5-5",FALSE,"Green Bay Packers",20,17,22,331,171,160,2,13,236,215,21,2,2005-11-21,0,1,"min",3
"12","Sun","November 27","W","","6-5",TRUE,"Cleveland Browns",24,12,18,281,200,81,2,20,262,184,78,5,2005-11-27,3,1,"min",12
"13","Sun","December 4","W","","7-5",FALSE,"Detroit Lions",21,16,20,345,242,103,0,19,223,118,105,1,2005-12-04,1,1,"min",5
"14","Sun","December 11","W","","8-5",TRUE,"St. Louis Rams",27,13,16,259,146,113,2,20,337,229,108,6,2005-12-11,4,1,"min",14
"15","Sun","December 18","L","","8-6",TRUE,"Pittsburgh Steelers",3,18,11,185,131,54,3,14,275,133,142,1,2005-12-18,-2,0,"min",-15
"16","Sun","December 25","L","","8-7",FALSE,"Baltimore Ravens",23,30,18,262,220,42,1,23,367,279,88,2,2005-12-25,1,0,"min",-7
"17","Sun","January 1","W","","9-7",TRUE,"Chicago Bears",34,10,22,396,247,149,0,13,251,97,154,0,2006-01-01,0,1,"min",24
"1","Mon","September 11","W","","1-0",FALSE,"Washington Redskins",19,16,18,309,223,86,0,15,266,163,103,0,2006-09-11,0,1,"min",3
"2","Sun","September 17","W","OT","2-0",TRUE,"Carolina Panthers",16,13,17,365,225,140,1,14,271,164,107,1,2006-09-17,0,1,"min",3
"3","Sun","September 24","L","","2-1",TRUE,"Chicago Bears",16,19,11,286,189,97,2,19,325,274,51,2,2006-09-24,0,0,"min",-3
"4","Sun","October 1","L","","2-2",FALSE,"Buffalo Bills",12,17,14,330,267,63,2,20,298,203,95,0,2006-10-01,-2,0,"min",-5
"5","Sun","October 8","W","","3-2",TRUE,"Detroit Lions",26,17,18,336,201,135,3,13,217,201,16,4,2006-10-08,1,1,"min",9
"7","Sun","October 22","W","","4-2",FALSE,"Seattle Seahawks",31,13,14,332,157,175,0,16,290,237,53,3,2006-10-22,3,1,"min",18
"8","Mon","October 30","L","","4-3",TRUE,"New England Patriots",7,31,17,284,239,45,4,25,430,345,85,2,2006-10-30,-2,0,"min",-24
"9","Sun","November 5","L","","4-4",FALSE,"San Francisco 49ers",3,9,17,238,103,135,3,8,133,91,42,1,2006-11-05,-2,0,"min",-6
"10","Sun","November 12","L","","4-5",TRUE,"Green Bay Packers",17,23,14,312,222,90,2,16,394,347,47,0,2006-11-12,-2,0,"min",-6
"11","Sun","November 19","L","","4-6",FALSE,"Miami Dolphins",20,24,25,361,247,114,3,15,254,247,7,2,2006-11-19,-1,0,"min",-4
"12","Sun","November 26","W","","5-6",TRUE,"Arizona Cardinals",31,26,30,412,255,157,1,22,412,395,17,5,2006-11-26,4,1,"min",5
"13","Sun","December 3","L","","5-7",FALSE,"Chicago Bears",13,23,21,346,156,190,5,6,107,24,83,5,2006-12-03,0,0,"min",-10
"14","Sun","December 10","W","","6-7",FALSE,"Detroit Lions",30,20,21,328,156,172,2,20,280,283,-3,6,2006-12-10,4,1,"min",10
"15","Sun","December 17","L","","6-8",TRUE,"New York Jets",13,26,15,307,245,62,1,21,391,323,68,2,2006-12-17,1,0,"min",-13
"16","Thu","December 21","L","","6-9",FALSE,"Green Bay Packers",7,9,3,104,27,77,1,19,319,273,46,3,2006-12-21,2,0,"min",-2
"17","Sun","December 31","L","","6-10",TRUE,"St. Louis Rams",21,41,17,293,211,82,2,23,416,248,168,0,2006-12-31,-2,0,"min",-20
"1","Sun","September 9","W","","1-0",TRUE,"Atlanta Falcons",24,3,15,302,163,139,1,17,265,169,96,2,2007-09-09,1,1,"min",21
"2","Sun","September 16","L","OT","1-1",FALSE,"Detroit Lions",17,20,17,313,190,123,5,29,415,359,56,5,2007-09-16,0,0,"min",-3
"3","Sun","September 23","L","","1-2",FALSE,"Kansas City Chiefs",10,13,18,256,133,123,1,14,251,201,50,1,2007-09-23,0,0,"min",-3
"4","Sun","September 30","L","","1-3",TRUE,"Green Bay Packers",16,23,20,382,227,155,2,20,384,338,46,2,2007-09-30,0,0,"min",-7
"6","Sun","October 14","W","","2-3",FALSE,"Chicago Bears",34,31,16,444,133,311,0,20,458,375,83,4,2007-10-14,4,1,"min",3
"7","Sun","October 21","L","","2-4",FALSE,"Dallas Cowboys",14,24,11,196,65,131,1,22,381,253,128,2,2007-10-21,1,0,"min",-10
"8","Sun","October 28","L","","2-5",TRUE,"Philadelphia Eagles",16,23,20,256,151,105,0,22,385,323,62,0,2007-10-28,0,0,"min",-7
"9","Sun","November 4","W","","3-5",TRUE,"San Diego Chargers",35,17,26,528,150,378,2,14,229,187,42,2,2007-11-04,0,1,"min",18
"10","Sun","November 11","L","","3-6",FALSE,"Green Bay Packers",0,34,11,247,161,86,1,29,488,368,120,0,2007-11-11,-1,0,"min",-34
"11","Sun","November 18","W","","4-6",TRUE,"Oakland Raiders",29,22,25,478,250,228,5,18,372,307,65,2,2007-11-18,-3,1,"min",7
"12","Sun","November 25","W","","5-6",FALSE,"New York Giants",41,17,15,251,124,127,0,18,309,234,75,4,2007-11-25,4,1,"min",24
"13","Sun","December 2","W","","6-6",TRUE,"Detroit Lions",42,10,29,443,227,216,1,14,253,230,23,1,2007-12-02,0,1,"min",32
"14","Sun","December 9","W","","7-6",FALSE,"San Francisco 49ers",27,7,11,280,163,117,1,17,282,209,73,5,2007-12-09,4,1,"min",20
"15","Mon","December 17","W","","8-6",TRUE,"Chicago Bears",20,13,21,372,236,136,4,11,209,177,32,1,2007-12-17,-3,1,"min",7
"16","Sun","December 23","L","","8-7",TRUE,"Washington Redskins",21,32,23,299,212,87,3,19,367,261,106,0,2007-12-23,-3,0,"min",-11
"17","Sun","December 30","L","OT","8-8",FALSE,"Denver Broncos",19,22,16,332,160,172,3,21,362,234,128,0,2007-12-30,-3,0,"min",-3
"1","Mon","September 8","L","","0-1",FALSE,"Green Bay Packers",19,24,21,355,168,187,1,15,317,178,139,0,2008-09-08,-1,0,"min",-5
"2","Sun","September 14","L","","0-2",TRUE,"Indianapolis Colts",15,18,16,299,120,179,1,17,321,296,25,2,2008-09-14,1,0,"min",-3
"3","Sun","September 21","W","","1-2",TRUE,"Carolina Panthers",20,10,17,305,186,119,1,14,204,157,47,2,2008-09-21,1,1,"min",10
"4","Sun","September 28","L","","1-3",FALSE,"Tennessee Titans",17,30,18,333,253,80,4,16,275,199,76,1,2008-09-28,-3,0,"min",-13
"5","Mon","October 6","W","","2-3",FALSE,"New Orleans Saints",30,27,16,270,226,44,0,17,375,320,55,4,2008-10-06,4,1,"min",3
"6","Sun","October 12","W","","3-3",TRUE,"Detroit Lions",12,10,23,392,257,135,3,8,212,112,100,1,2008-10-12,-2,1,"min",2
"7","Sun","October 19","L","","3-4",FALSE,"Chicago Bears",41,48,28,439,284,155,5,20,327,274,53,1,2008-10-19,-4,0,"min",-7
"9","Sun","November 2","W","","4-4",TRUE,"Houston Texans",28,21,15,345,168,177,1,20,389,327,62,3,2008-11-02,2,1,"min",7
"10","Sun","November 9","W","","5-4",TRUE,"Green Bay Packers",28,27,18,361,141,220,3,12,184,110,74,0,2008-11-09,-3,1,"min",1
"11","Sun","November 16","L","","5-5",FALSE,"Tampa Bay Buccaneers",13,19,14,210,111,99,2,21,363,255,108,1,2008-11-16,-1,0,"min",-6
"12","Sun","November 23","W","","6-5",FALSE,"Jacksonville Jaguars",30,12,15,226,104,122,1,17,321,286,35,5,2008-11-23,4,1,"min",18
"13","Sun","November 30","W","","7-5",TRUE,"Chicago Bears",34,14,17,378,200,178,1,10,228,125,103,3,2008-11-30,2,1,"min",20
"14","Sun","December 7","W","","8-5",FALSE,"Detroit Lions",20,16,20,301,168,133,2,15,268,191,77,0,2008-12-07,-2,1,"min",4
"15","Sun","December 14","W","","9-5",FALSE,"Arizona Cardinals",35,14,20,396,157,239,1,16,316,273,43,2,2008-12-14,1,1,"min",21
"16","Sun","December 21","L","","9-6",TRUE,"Atlanta Falcons",17,24,24,350,195,155,4,18,222,124,98,0,2008-12-21,-4,0,"min",-7
"17","Sun","December 28","W","","10-6",TRUE,"New York Giants",20,19,15,328,218,110,1,19,357,222,135,0,2008-12-28,-1,1,"min",1
"WildCard","Sun","January 4","L","","10-7",TRUE,"Philadelphia Eagles",14,26,16,301,153,148,2,15,350,283,67,2,2009-01-04,0,0,"min",-12
"1","Sun","September 13","W","","1-0",FALSE,"Cleveland Browns",34,20,19,310,85,225,0,17,268,179,89,2,2009-09-13,2,1,"min",14
"2","Sun","September 20","W","","2-0",FALSE,"Detroit Lions",27,13,18,265,153,112,1,17,265,136,129,3,2009-09-20,2,1,"min",14
"3","Sun","September 27","W","","3-0",TRUE,"San Francisco 49ers",27,24,19,377,283,94,1,13,246,188,58,1,2009-09-27,0,1,"min",3
"4","Mon","October 5","W","","4-0",TRUE,"Green Bay Packers",30,23,22,334,271,63,1,19,424,342,82,2,2009-10-05,1,1,"min",7
"5","Sun","October 11","W","","5-0",FALSE,"St. Louis Rams",38,10,21,377,288,89,1,27,400,278,122,4,2009-10-11,3,1,"min",28
"6","Sun","October 18","W","","6-0",TRUE,"Baltimore Ravens",33,31,19,426,259,167,0,20,448,367,81,0,2009-10-18,0,1,"min",2
"7","Sun","October 25","L","","6-1",FALSE,"Pittsburgh Steelers",17,27,21,386,297,89,2,14,259,152,107,1,2009-10-25,-1,0,"min",-10
"8","Sun","November 1","W","","7-1",FALSE,"Green Bay Packers",38,26,19,355,244,111,2,21,351,261,90,0,2009-11-01,-2,1,"min",12
"10","Sun","November 15","W","","8-1",TRUE,"Detroit Lions",27,10,19,492,340,152,2,19,297,204,93,1,2009-11-15,-1,1,"min",17
"11","Sun","November 22","W","","9-1",TRUE,"Seattle Seahawks",35,9,28,431,271,160,0,10,212,208,4,2,2009-11-22,2,1,"min",26
"12","Sun","November 29","W","","10-1",TRUE,"Chicago Bears",36,10,31,537,378,159,1,8,169,126,43,3,2009-11-29,2,1,"min",26
"13","Sun","December 6","L","","10-2",FALSE,"Arizona Cardinals",17,30,22,315,253,62,2,20,398,285,113,1,2009-12-06,-1,0,"min",-13
"14","Sun","December 13","W","","11-2",TRUE,"Cincinnati Bengals",30,10,21,322,180,142,1,13,210,91,119,1,2009-12-13,0,1,"min",20
"15","Sun","December 20","L","","11-3",FALSE,"Carolina Panthers",7,26,10,237,196,41,2,23,397,273,124,0,2009-12-20,-2,0,"min",-19
"16","Mon","December 28","L","OT","11-4",FALSE,"Chicago Bears",30,36,26,423,300,123,2,19,363,258,105,1,2009-12-28,-1,0,"min",-6
"17","Sun","January 3","W","","12-4",TRUE,"New York Giants",44,7,28,487,358,129,0,11,181,146,35,2,2010-01-03,2,1,"min",37
"Division","Sun","January 17","W","","13-4",TRUE,"Dallas Cowboys",34,3,16,323,214,109,0,16,248,156,92,3,2010-01-17,3,1,"min",31
"ConfChamp","Sun","January 24","L","OT","13-5",FALSE,"New Orleans Saints",28,31,31,475,310,165,5,15,257,189,68,1,2010-01-24,-4,0,"min",-3
"1","Thu","September 9","L","","0-1",FALSE,"New Orleans Saints",9,14,12,253,162,91,1,18,308,229,79,0,2010-09-09,-1,0,"min",-5
"2","Sun","September 19","L","","0-2",TRUE,"Miami Dolphins",10,14,22,364,208,156,4,12,226,106,120,2,2010-09-19,-2,0,"min",-4
"3","Sun","September 26","W","","1-2",TRUE,"Detroit Lions",24,10,21,368,185,183,3,17,295,232,63,3,2010-09-26,0,1,"min",14
"5","Mon","October 11","L","","1-3",FALSE,"New York Jets",20,29,16,336,240,96,3,20,328,173,155,0,2010-10-11,-3,0,"min",-9
"6","Sun","October 17","W","","2-3",TRUE,"Dallas Cowboys",24,21,14,188,93,95,1,16,314,220,94,2,2010-10-17,1,1,"min",3
"7","Sun","October 24","L","","2-4",FALSE,"Green Bay Packers",24,28,21,402,206,196,3,20,379,295,84,2,2010-10-24,-1,0,"min",-4
"8","Sun","October 31","L","","2-5",FALSE,"New England Patriots",18,28,23,410,285,125,1,18,362,240,122,0,2010-10-31,-1,0,"min",-10
"9","Sun","November 7","W","OT","3-5",TRUE,"Arizona Cardinals",27,24,28,507,427,80,3,13,225,172,53,1,2010-11-07,-2,1,"min",3
"10","Sun","November 14","L","","3-6",FALSE,"Chicago Bears",13,27,15,240,170,70,4,18,360,230,130,2,2010-11-14,-2,0,"min",-14
"11","Sun","November 21","L","","3-7",TRUE,"Green Bay Packers",3,31,15,300,207,93,2,20,374,283,91,0,2010-11-21,-2,0,"min",-28
"12","Sun","November 28","W","","4-7",FALSE,"Washington Redskins",17,13,17,299,162,137,0,10,216,187,29,1,2010-11-28,1,1,"min",4
"13","Sun","December 5","W","","5-7",TRUE,"Buffalo Bills",38,14,22,387,177,210,4,10,239,155,84,5,2010-12-05,1,1,"min",24
"14","Mon","December 13","L","","5-8",TRUE,"New York Giants",3,21,10,164,103,61,1,21,395,182,213,2,2010-12-13,1,0,"min",-18
"15","Mon","December 20","L","","5-9",TRUE,"Chicago Bears",14,40,16,273,159,114,5,17,293,189,104,1,2010-12-20,-4,0,"min",-26
"16","Tue","December 28","W","","6-9",FALSE,"Philadelphia Eagles",24,14,21,337,176,161,1,24,331,224,107,3,2010-12-28,2,1,"min",10
"17","Sun","January 2","L","","6-10",FALSE,"Detroit Lions",13,20,16,211,137,74,1,22,357,250,107,2,2011-01-02,1,0,"min",-7
"1","Sun","September 11","L","","0-1",FALSE,"San Diego Chargers",17,24,10,187,28,159,1,31,407,330,77,2,2011-09-11,1,0,"min",-7
"2","Sun","September 18","L","","0-2",TRUE,"Tampa Bay Buccaneers",20,24,25,398,212,186,1,19,335,230,105,1,2011-09-18,0,0,"min",-4
"3","Sun","September 25","L","OT","0-3",TRUE,"Detroit Lions",23,26,16,321,189,132,0,19,358,338,20,0,2011-09-25,0,0,"min",-3
"4","Sun","October 2","L","","0-4",FALSE,"Kansas City Chiefs",17,22,17,341,190,151,1,15,350,247,103,0,2011-10-02,-1,0,"min",-5
"5","Sun","October 9","W","","1-4",TRUE,"Arizona Cardinals",34,10,20,332,160,172,1,18,291,214,77,4,2011-10-09,3,1,"min",24
"6","Sun","October 16","L","","1-5",FALSE,"Chicago Bears",10,39,15,286,233,53,0,22,377,258,119,1,2011-10-16,1,0,"min",-29
"7","Sun","October 23","L","","1-6",TRUE,"Green Bay Packers",27,33,22,435,217,218,2,25,421,307,114,1,2011-10-23,-1,0,"min",-6
"8","Sun","October 30","W","","2-6",FALSE,"Carolina Panthers",24,21,22,361,229,132,1,21,405,265,140,2,2011-10-30,1,1,"min",3
"10","Mon","November 14","L","","2-7",FALSE,"Green Bay Packers",7,45,14,266,162,104,1,23,356,266,90,1,2011-11-14,0,0,"min",-38
"11","Sun","November 20","L","","2-8",TRUE,"Oakland Raiders",21,27,20,311,187,124,5,22,301,139,162,1,2011-11-20,-4,0,"min",-6
"12","Sun","November 27","L","","2-9",FALSE,"Atlanta Falcons",14,24,12,226,162,64,0,22,335,246,89,1,2011-11-27,1,0,"min",-10
"13","Sun","December 4","L","","2-10",TRUE,"Denver Broncos",32,35,27,489,360,129,3,13,336,186,150,2,2011-12-04,-1,0,"min",-3
"14","Sun","December 11","L","","2-11",FALSE,"Detroit Lions",28,34,29,425,156,269,6,13,280,208,72,0,2011-12-11,-6,0,"min",-6
"15","Sun","December 18","L","","2-12",TRUE,"New Orleans Saints",20,42,12,207,102,105,1,36,573,412,161,2,2011-12-18,1,0,"min",-22
"16","Sat","December 24","W","","3-12",FALSE,"Washington Redskins",33,26,20,389,148,241,0,23,397,256,141,2,2011-12-24,2,1,"min",7
"17","Sun","January 1","L","","3-13",TRUE,"Chicago Bears",13,17,16,301,222,79,3,10,209,117,92,3,2012-01-01,0,0,"min",-4
"1","Sun","September 8","W","","1-0",FALSE,"Atlanta Falcons",28,27,16,286,156,130,2,21,300,140,160,1,1985-09-08,-1,1,"det",1
"2","Sun","September 15","W","","2-0",TRUE,"Dallas Cowboys",26,21,13,200,128,72,1,33,554,452,102,5,1985-09-15,4,1,"det",5
"3","Sun","September 22","L","","2-1",FALSE,"Indianapolis Colts",6,14,10,204,99,105,2,24,355,127,228,3,1985-09-22,1,0,"det",-8
"4","Sun","September 29","W","","3-1",TRUE,"Tampa Bay Buccaneers",30,9,18,315,221,94,1,19,277,158,119,4,1985-09-29,3,1,"det",21
"5","Sun","October 6","L","","3-2",FALSE,"Green Bay Packers",10,43,19,373,317,56,6,30,512,227,285,1,1985-10-06,-5,0,"det",-33
"6","Sun","October 13","L","","3-3",FALSE,"Washington Redskins",3,24,8,226,198,28,4,23,291,123,168,0,1985-10-13,-4,0,"det",-21
"7","Sun","October 20","W","","4-3",TRUE,"San Francisco 49ers",23,21,15,292,130,162,1,21,304,96,208,1,1985-10-20,0,1,"det",2
"8","Sun","October 27","W","","5-3",TRUE,"Miami Dolphins",31,21,21,355,203,152,1,20,341,239,102,3,1985-10-27,2,1,"det",10
"9","Sun","November 3","L","","5-4",FALSE,"Minnesota Vikings",13,16,11,153,84,69,0,20,301,138,163,2,1985-11-03,2,0,"det",-3
"10","Sun","November 10","L","","5-5",FALSE,"Chicago Bears",3,24,8,106,38,68,4,26,360,110,250,2,1985-11-10,-2,0,"det",-21
"11","Sun","November 17","W","","6-5",TRUE,"Minnesota Vikings",41,21,24,365,217,148,2,16,311,248,63,5,1985-11-17,3,1,"det",20
"12","Sun","November 24","L","OT","6-6",FALSE,"Tampa Bay Buccaneers",16,19,16,273,200,73,1,23,288,119,169,0,1985-11-24,-1,0,"det",-3
"13","Thu","November 28","W","","7-6",TRUE,"New York Jets",31,20,18,330,264,66,1,23,357,239,118,2,1985-11-28,1,1,"det",11
"14","Sun","December 8","L","","7-7",FALSE,"New England Patriots",6,23,15,246,141,105,3,23,352,136,216,1,1985-12-08,-2,0,"det",-17
"15","Sun","December 15","L","","7-8",TRUE,"Green Bay Packers",23,26,25,426,289,137,5,17,306,133,173,2,1985-12-15,-3,0,"det",-3
"16","Sun","December 22","L","","7-9",TRUE,"Chicago Bears",17,37,22,326,253,73,7,20,382,221,161,4,1985-12-22,-3,0,"det",-20
"1","Sun","September 7","W","","1-0",FALSE,"Minnesota Vikings",13,10,19,303,79,224,1,14,275,213,62,2,1986-09-07,1,1,"det",3
"2","Sun","September 14","L","","1-1",TRUE,"Dallas Cowboys",7,31,12,184,104,80,3,24,388,191,197,2,1986-09-14,-1,0,"det",-24
"3","Sun","September 21","L","","1-2",TRUE,"Tampa Bay Buccaneers",20,24,26,379,286,93,5,14,253,24,229,1,1986-09-21,-4,0,"det",-4
"4","Sun","September 28","L","","1-3",FALSE,"Cleveland Browns",21,24,25,333,228,105,0,15,254,170,84,1,1986-09-28,1,0,"det",-3
"5","Sun","October 5","W","","2-3",TRUE,"Houston Oilers",24,13,17,234,76,158,1,16,454,398,56,4,1986-10-05,3,1,"det",11
"6","Sun","October 12","W","","3-3",FALSE,"Green Bay Packers",21,14,25,338,102,236,1,16,279,235,44,2,1986-10-12,1,1,"det",7
"7","Sun","October 19","L","","3-4",FALSE,"Los Angeles Rams",10,14,21,372,303,69,3,10,200,22,178,2,1986-10-19,-1,0,"det",-4
"8","Sun","October 26","L","","3-5",FALSE,"Chicago Bears",7,13,11,214,138,76,3,19,252,128,124,3,1986-10-26,0,0,"det",-6
"9","Sun","November 2","L","","3-6",TRUE,"Cincinnati Bengals",17,24,21,365,268,97,2,26,389,167,222,2,1986-11-02,0,0,"det",-7
"10","Sun","November 9","L","","3-7",TRUE,"Minnesota Vikings",10,24,15,282,201,81,4,22,432,270,162,3,1986-11-09,-1,0,"det",-14
"11","Sun","November 16","W","","4-7",FALSE,"Philadelphia Eagles",13,11,12,186,146,40,1,20,294,68,226,4,1986-11-16,3,1,"det",2
"12","Sun","November 23","W","","5-7",FALSE,"Tampa Bay Buccaneers",38,17,22,393,264,129,2,26,380,193,187,4,1986-11-23,2,1,"det",21
"13","Thu","November 27","L","","5-8",TRUE,"Green Bay Packers",40,44,22,338,234,104,2,18,367,272,95,3,1986-11-27,1,0,"det",-4
"14","Sun","December 7","L","","5-9",FALSE,"Pittsburgh Steelers",17,27,13,281,178,103,3,23,421,218,203,3,1986-12-07,0,0,"det",-10
"15","Mon","December 15","L","","5-10",TRUE,"Chicago Bears",13,16,14,160,104,56,2,18,273,112,161,4,1986-12-15,2,0,"det",-3
"16","Sun","December 21","L","","5-11",TRUE,"Atlanta Falcons",6,20,12,193,73,120,4,17,238,119,119,1,1986-12-21,-3,0,"det",-14
"1","Sun","September 13","L","","0-1",FALSE,"Minnesota Vikings",19,34,17,272,189,83,2,21,353,240,113,3,1987-09-13,1,0,"det",-15
"2","Sun","September 20","L","","0-2",FALSE,"Los Angeles Raiders",7,27,16,291,244,47,3,25,405,234,171,1,1987-09-20,-2,0,"det",-20
"3","Sun","October 4","L","","0-3",TRUE,"Tampa Bay Buccaneers",27,31,12,262,161,101,4,12,219,106,113,1,1987-10-04,-3,0,"det",-4
"4","Sun","October 11","W","OT","1-3",FALSE,"Green Bay Packers",19,16,21,342,220,122,2,16,273,122,151,3,1987-10-11,1,1,"det",3
"5","Sun","October 18","L","","1-4",TRUE,"Seattle Seahawks",14,37,15,197,104,93,2,24,404,324,80,2,1987-10-18,0,0,"det",-23
"6","Sun","October 25","L","","1-5",TRUE,"Green Bay Packers",33,34,23,353,336,17,1,23,465,293,172,3,1987-10-25,2,0,"det",-1
"7","Sun","November 1","L","","1-6",FALSE,"Denver Broncos",0,34,14,191,128,63,2,28,460,248,212,1,1987-11-01,-1,0,"det",-34
"8","Sun","November 8","W","","2-6",TRUE,"Dallas Cowboys",27,17,20,293,217,76,4,20,290,167,123,5,1987-11-08,1,1,"det",10
"9","Sun","November 15","L","","2-7",FALSE,"Washington Redskins",13,20,23,341,238,103,4,18,309,174,135,2,1987-11-15,-2,0,"det",-7
"10","Sun","November 22","L","","2-8",FALSE,"Chicago Bears",10,30,10,179,149,30,2,29,383,205,178,1,1987-11-22,-1,0,"det",-20
"11","Thu","November 26","L","","2-9",TRUE,"Kansas City Chiefs",20,27,22,357,206,151,0,22,408,246,162,2,1987-11-26,2,0,"det",-7
"12","Sun","December 6","L","","2-10",TRUE,"Los Angeles Rams",16,37,19,328,271,57,3,22,423,313,110,2,1987-12-06,-1,0,"det",-21
"13","Sun","December 13","W","","3-10",FALSE,"Tampa Bay Buccaneers",20,10,22,298,108,190,1,20,263,216,47,1,1987-12-13,0,1,"det",10
"14","Sun","December 20","L","","3-11",TRUE,"Minnesota Vikings",14,17,17,364,235,129,5,20,340,135,205,0,1987-12-20,-5,0,"det",-3
"15","Sun","December 27","W","","4-11",FALSE,"Atlanta Falcons",30,13,19,323,150,173,2,14,278,180,98,5,1987-12-27,3,1,"det",17
"1","Sun","September 4","W","","1-0",TRUE,"Atlanta Falcons",31,17,19,230,88,142,1,26,359,187,172,4,1988-09-04,3,1,"det",14
"2","Sun","September 11","L","","1-1",FALSE,"Los Angeles Rams",10,17,16,210,134,76,3,23,315,124,191,2,1988-09-11,-1,0,"det",-7
"3","Sun","September 18","L","","1-2",TRUE,"New Orleans Saints",14,22,18,272,232,40,2,22,401,282,119,2,1988-09-18,0,0,"det",-8
"4","Sun","September 25","L","","1-3",TRUE,"New York Jets",10,17,12,183,97,86,1,19,316,230,86,1,1988-09-25,0,0,"det",-7
"5","Sun","October 2","L","","1-4",FALSE,"San Francisco 49ers",13,20,18,297,248,49,2,19,339,163,176,1,1988-10-02,-1,0,"det",-7
"6","Sun","October 9","L","","1-5",TRUE,"Chicago Bears",7,24,18,262,220,42,2,20,323,222,101,1,1988-10-09,-1,0,"det",-17
"7","Sun","October 16","L","","1-6",FALSE,"New York Giants",10,30,10,113,65,48,2,23,402,280,122,2,1988-10-16,0,0,"det",-20
"8","Sun","October 23","W","","2-6",FALSE,"Kansas City Chiefs",7,6,14,215,88,127,3,12,171,110,61,2,1988-10-23,-1,1,"det",1
"9","Sun","October 30","L","OT","2-7",TRUE,"New York Giants",10,13,11,146,98,48,2,20,272,196,76,2,1988-10-30,0,0,"det",-3
"10","Sun","November 6","L","","2-8",FALSE,"Minnesota Vikings",17,44,8,89,21,68,2,33,553,355,198,1,1988-11-06,-1,0,"det",-27
"11","Sun","November 13","L","","2-9",TRUE,"Tampa Bay Buccaneers",20,23,21,278,203,75,3,17,304,79,225,4,1988-11-13,1,0,"det",-3
"12","Sun","November 20","W","","3-9",FALSE,"Green Bay Packers",19,9,15,270,114,156,1,24,356,304,52,3,1988-11-20,2,1,"det",10
"13","Thu","November 24","L","","3-10",TRUE,"Minnesota Vikings",0,23,3,60,42,18,2,24,353,172,181,0,1988-11-24,-2,0,"det",-23
"14","Sun","December 4","W","","4-10",TRUE,"Green Bay Packers",30,14,15,220,126,94,1,21,360,268,92,6,1988-12-04,5,1,"det",16
"15","Sun","December 11","L","","4-11",FALSE,"Chicago Bears",12,13,14,310,195,115,2,14,250,168,82,1,1988-12-11,-1,0,"det",-1
"16","Sun","December 18","L","","4-12",FALSE,"Tampa Bay Buccaneers",10,21,14,250,191,59,4,17,242,139,103,4,1988-12-18,0,0,"det",-11
"1","Sun","September 10","L","","0-1",TRUE,"Phoenix Cardinals",13,16,13,258,99,159,1,19,329,264,65,1,1989-09-10,0,0,"det",-3
"2","Sun","September 17","L","","0-2",FALSE,"New York Giants",14,24,19,410,315,95,5,21,345,216,129,1,1989-09-17,-4,0,"det",-10
"3","Sun","September 24","L","","0-3",TRUE,"Chicago Bears",27,47,20,305,107,198,5,23,542,323,219,0,1989-09-24,-5,0,"det",-20
"4","Sun","October 1","L","","0-4",TRUE,"Pittsburgh Steelers",3,23,13,240,222,18,4,20,315,213,102,0,1989-10-01,-4,0,"det",-20
"5","Sun","October 8","L","","0-5",FALSE,"Minnesota Vikings",17,24,20,237,84,153,4,14,229,138,91,3,1989-10-08,-1,0,"det",-7
"6","Sun","October 15","W","","1-5",FALSE,"Tampa Bay Buccaneers",17,16,20,376,237,139,4,14,191,103,88,1,1989-10-15,-3,1,"det",1
"7","Sun","October 22","L","","1-6",TRUE,"Minnesota Vikings",7,20,21,282,198,84,5,13,264,147,117,1,1989-10-22,-4,0,"det",-13
"8","Sun","October 29","L","OT","1-7",FALSE,"Green Bay Packers",20,23,21,402,192,210,2,24,421,345,76,2,1989-10-29,0,0,"det",-3
"9","Sun","November 5","L","","1-8",FALSE,"Houston Oilers",31,35,19,351,257,94,2,30,455,345,110,4,1989-11-05,2,0,"det",-4
"10","Sun","November 12","W","","2-8",TRUE,"Green Bay Packers",31,22,8,128,54,74,2,30,432,328,104,4,1989-11-12,2,1,"det",9
"11","Sun","November 19","L","","2-9",FALSE,"Cincinnati Bengals",7,42,10,278,156,122,5,27,546,447,99,3,1989-11-19,-2,0,"det",-35
"12","Thu","November 23","W","","3-9",TRUE,"Cleveland Browns",13,10,15,271,125,146,1,14,359,289,70,2,1989-11-23,1,1,"det",3
"13","Sun","December 3","W","","4-9",TRUE,"New Orleans Saints",21,14,17,401,316,85,2,11,169,99,70,2,1989-12-03,0,1,"det",7
"14","Sun","December 10","W","","5-9",FALSE,"Chicago Bears",27,17,17,295,168,127,2,21,302,172,130,2,1989-12-10,0,1,"det",10
"15","Sun","December 17","W","","6-9",TRUE,"Tampa Bay Buccaneers",33,7,24,382,212,170,2,6,225,163,62,5,1989-12-17,3,1,"det",26
"16","Sun","December 24","W","","7-9",FALSE,"Atlanta Falcons",31,24,17,376,197,179,2,27,413,324,89,1,1989-12-24,-1,1,"det",7
"1","Sun","September 9","L","","0-1",TRUE,"Tampa Bay Buccaneers",21,38,18,258,168,90,6,20,375,237,138,2,1990-09-09,-4,0,"det",-17
"2","Sun","September 16","W","","1-1",TRUE,"Atlanta Falcons",21,14,17,264,181,83,2,14,295,173,122,1,1990-09-16,-1,1,"det",7
"3","Sun","September 23","L","","1-2",FALSE,"Tampa Bay Buccaneers",20,23,18,307,152,155,2,19,323,171,152,1,1990-09-23,-1,0,"det",-3
"4","Sun","September 30","L","","1-3",TRUE,"Green Bay Packers",21,24,21,338,194,144,0,24,412,269,143,2,1990-09-30,2,0,"det",-3
"5","Sun","October 7","W","","2-3",FALSE,"Minnesota Vikings",34,27,24,383,279,104,2,22,340,199,141,2,1990-10-07,0,1,"det",7
"6","Sun","October 14","L","","2-4",FALSE,"Kansas City Chiefs",24,43,20,328,192,136,2,25,566,256,310,1,1990-10-14,-1,0,"det",-19
"8","Sun","October 28","W","","3-4",FALSE,"New Orleans Saints",27,10,12,262,214,48,1,15,269,138,131,8,1990-10-28,7,1,"det",17
"9","Sun","November 4","L","OT","3-5",TRUE,"Washington Redskins",38,41,12,351,187,164,1,39,676,482,194,4,1990-11-04,3,0,"det",-3
"10","Sun","November 11","L","","3-6",TRUE,"Minnesota Vikings",7,17,14,237,127,110,5,15,270,126,144,1,1990-11-11,-4,0,"det",-10
"11","Sun","November 18","L","","3-7",FALSE,"New York Giants",0,20,15,208,133,75,2,15,314,170,144,0,1990-11-18,-2,0,"det",-20
"12","Thu","November 22","W","","4-7",TRUE,"Denver Broncos",40,27,22,421,248,173,1,19,284,211,73,2,1990-11-22,1,1,"det",13
"13","Sun","December 2","L","OT","4-8",FALSE,"Chicago Bears",17,23,17,296,204,92,2,21,361,197,164,0,1990-12-02,-2,0,"det",-6
"14","Mon","December 10","L","","4-9",TRUE,"Los Angeles Raiders",31,38,19,368,171,197,2,16,350,186,164,2,1990-12-10,0,0,"det",-7
"15","Sun","December 16","W","","5-9",TRUE,"Chicago Bears",38,21,20,411,310,101,3,19,225,88,137,2,1990-12-16,-1,1,"det",17
"16","Sat","December 22","W","","6-9",FALSE,"Green Bay Packers",24,17,17,352,184,168,3,24,314,234,80,4,1990-12-22,1,1,"det",7
"17","Sun","December 30","L","","6-10",FALSE,"Seattle Seahawks",10,30,12,193,106,87,2,27,360,209,151,3,1990-12-30,1,0,"det",-20
"1","Sun","September 1","L","","0-1",FALSE,"Washington Redskins",0,45,9,154,61,93,4,23,392,201,191,1,1991-09-01,-3,0,"det",-45
"2","Sun","September 8","W","","1-1",TRUE,"Green Bay Packers",23,14,21,347,271,76,0,20,253,177,76,1,1991-09-08,1,1,"det",9
"3","Sun","September 15","W","","2-1",TRUE,"Miami Dolphins",17,13,24,353,164,189,1,17,226,154,72,0,1991-09-15,-1,1,"det",4
"4","Sun","September 22","W","","3-1",FALSE,"Indianapolis Colts",33,24,25,402,194,208,3,20,328,324,4,1,1991-09-22,-2,1,"det",9
"5","Sun","September 29","W","","4-1",TRUE,"Tampa Bay Buccaneers",31,3,21,359,147,212,4,16,187,106,81,4,1991-09-29,0,1,"det",28
"6","Sun","October 6","W","","5-1",TRUE,"Minnesota Vikings",24,20,25,400,276,124,1,15,202,105,97,0,1991-10-06,-1,1,"det",4
"8","Sun","October 20","L","","5-2",FALSE,"San Francisco 49ers",3,35,10,207,183,24,2,29,505,272,233,1,1991-10-20,-1,0,"det",-32
"9","Sun","October 27","W","","6-2",TRUE,"Dallas Cowboys",34,10,13,208,136,72,0,22,415,341,74,4,1991-10-27,4,1,"det",24
"10","Sun","November 3","L","","6-3",FALSE,"Chicago Bears",10,20,16,275,203,72,3,16,291,187,104,1,1991-11-03,-2,0,"det",-10
"11","Sun","November 10","L","","6-4",FALSE,"Tampa Bay Buccaneers",21,30,18,345,226,119,4,19,346,165,181,1,1991-11-10,-3,0,"det",-9
"12","Sun","November 17","W","","7-4",TRUE,"Los Angeles Rams",21,10,16,249,181,68,0,18,334,308,26,2,1991-11-17,2,1,"det",11
"13","Sun","November 24","W","","8-4",FALSE,"Minnesota Vikings",34,14,20,383,116,267,0,20,320,230,90,6,1991-11-24,6,1,"det",20
"14","Thu","November 28","W","","9-4",TRUE,"Chicago Bears",16,6,11,208,108,100,2,18,319,231,88,6,1991-11-28,4,1,"det",10
"15","Sun","December 8","W","","10-4",TRUE,"New York Jets",34,20,15,336,235,101,1,19,286,154,132,5,1991-12-08,4,1,"det",14
"16","Sun","December 15","W","","11-4",FALSE,"Green Bay Packers",21,17,14,206,112,94,2,19,367,207,160,2,1991-12-15,0,1,"det",4
"17","Sun","December 22","W","OT","12-4",FALSE,"Buffalo Bills",17,14,22,356,245,111,3,14,275,124,151,1,1991-12-22,-2,1,"det",3
"Division","Sun","January 5","W","","13-4",TRUE,"Dallas Cowboys",38,6,23,421,337,84,0,16,276,179,97,4,1992-01-05,4,1,"det",32
"ConfChamp","Sun","January 12","L","","13-5",FALSE,"Washington Redskins",10,41,20,304,232,72,3,17,345,228,117,0,1992-01-12,-3,0,"det",-31
"1","Sun","September 6","L","","0-1",FALSE,"Chicago Bears",24,27,17,353,232,121,1,21,367,227,140,0,1992-09-06,-1,0,"det",-3
"2","Sun","September 13","W","","1-1",TRUE,"Minnesota Vikings",31,17,12,169,96,73,1,20,270,175,95,4,1992-09-13,3,1,"det",14
"3","Sun","September 20","L","","1-2",FALSE,"Washington Redskins",10,13,8,206,169,37,2,17,275,128,147,3,1992-09-20,1,0,"det",-3
"4","Sun","September 27","L","","1-3",TRUE,"Tampa Bay Buccaneers",23,27,18,368,298,70,1,21,395,248,147,3,1992-09-27,2,0,"det",-4
"5","Sun","October 4","L","","1-4",TRUE,"New Orleans Saints",7,13,12,187,145,42,1,19,285,152,133,0,1992-10-04,-1,0,"det",-6
"7","Thu","October 15","L","","1-5",FALSE,"Minnesota Vikings",14,31,17,293,226,67,2,23,393,291,102,0,1992-10-15,-2,0,"det",-17
"8","Sun","October 25","W","","2-5",FALSE,"Tampa Bay Buccaneers",38,7,21,400,236,164,1,15,236,148,88,2,1992-10-25,1,1,"det",31
"9","Sun","November 1","L","","2-6",TRUE,"Green Bay Packers",13,27,9,190,152,38,1,24,347,202,145,2,1992-11-01,1,0,"det",-14
"10","Sun","November 8","L","","2-7",TRUE,"Dallas Cowboys",3,37,10,201,77,124,4,26,398,240,158,2,1992-11-08,-2,0,"det",-34
"11","Sun","November 15","L","","2-8",FALSE,"Pittsburgh Steelers",14,17,20,376,286,90,6,18,316,164,152,2,1992-11-15,-4,0,"det",-3
"12","Sun","November 22","W","","3-8",FALSE,"Cincinnati Bengals",19,13,17,277,116,161,3,10,95,43,52,3,1992-11-22,0,1,"det",6
"13","Thu","November 26","L","","3-9",TRUE,"Houston Oilers",21,24,14,214,141,73,3,21,383,332,51,2,1992-11-26,-1,0,"det",-3
"14","Sun","December 6","L","","3-10",FALSE,"Green Bay Packers",10,38,17,304,148,156,5,21,374,208,166,2,1992-12-06,-3,0,"det",-28
"15","Sun","December 13","W","","4-10",TRUE,"Cleveland Browns",24,14,19,276,121,155,0,14,321,260,61,3,1992-12-13,3,1,"det",10
"16","Sun","December 20","W","","5-10",TRUE,"Chicago Bears",16,3,15,399,265,134,4,16,242,136,106,4,1992-12-20,0,1,"det",13
"17","Mon","December 28","L","","5-11",FALSE,"San Francisco 49ers",6,24,15,227,88,139,1,22,361,263,98,0,1992-12-28,-1,0,"det",-18
"1","Sun","September 5","W","","1-0",TRUE,"Atlanta Falcons",30,13,12,262,166,96,0,12,237,216,21,3,1993-09-05,3,1,"det",17
"2","Sun","September 12","W","OT","2-0",FALSE,"New England Patriots",19,16,21,340,154,186,4,21,292,231,61,3,1993-09-12,-1,1,"det",3
"3","Sun","September 19","L","","2-1",FALSE,"New Orleans Saints",3,14,9,170,86,84,2,16,258,86,172,1,1993-09-19,-1,0,"det",-11
"4","Sun","September 26","W","","3-1",TRUE,"Phoenix Cardinals",26,20,11,330,183,147,0,20,343,264,79,3,1993-09-26,3,1,"det",6
"5","Sun","October 3","L","","3-2",FALSE,"Tampa Bay Buccaneers",10,27,17,311,167,144,3,14,324,196,128,1,1993-10-03,-2,0,"det",-17
"7","Sun","October 17","W","","4-2",TRUE,"Seattle Seahawks",30,10,20,292,151,141,2,16,232,166,66,4,1993-10-17,2,1,"det",20
"8","Sun","October 24","W","","5-2",FALSE,"Los Angeles Rams",16,13,18,363,229,134,1,23,291,141,150,2,1993-10-24,1,1,"det",3
"9","Sun","October 31","W","","6-2",FALSE,"Minnesota Vikings",30,27,13,338,260,78,2,25,378,262,116,3,1993-10-31,1,1,"det",3
"10","Sun","November 7","W","","7-2",TRUE,"Tampa Bay Buccaneers",23,0,20,366,125,241,0,6,146,102,44,1,1993-11-07,1,1,"det",23
"12","Sun","November 21","L","","7-3",FALSE,"Green Bay Packers",17,26,12,205,89,116,2,25,404,251,153,2,1993-11-21,0,0,"det",-9
"13","Thu","November 25","L","","7-4",TRUE,"Chicago Bears",6,10,14,230,146,84,4,11,225,113,112,2,1993-11-25,-2,0,"det",-4
"14","Sun","December 5","L","","7-5",TRUE,"Minnesota Vikings",0,13,16,219,111,108,5,14,234,133,101,1,1993-12-05,-4,0,"det",-13
"15","Sun","December 12","W","","8-5",FALSE,"Phoenix Cardinals",21,14,13,340,235,105,2,19,287,191,96,3,1993-12-12,1,1,"det",7
"16","Sun","December 19","L","","8-6",TRUE,"San Francisco 49ers",17,55,16,288,207,81,3,26,565,393,172,0,1993-12-19,-3,0,"det",-38
"17","Sun","December 26","W","","9-6",FALSE,"Chicago Bears",20,14,20,307,223,84,1,14,180,103,77,1,1993-12-26,0,1,"det",6
"18","Sun","January 2","W","","10-6",TRUE,"Green Bay Packers",30,20,16,297,182,115,1,17,273,172,101,5,1994-01-02,4,1,"det",10
"WildCard","Sat","January 8","L","","10-7",TRUE,"Green Bay Packers",24,28,25,410,235,175,2,16,293,204,89,1,1994-01-08,-1,0,"det",-4
"1","Sun","September 4","W","OT","1-0",TRUE,"Atlanta Falcons",31,28,21,352,203,149,1,22,389,271,118,0,1994-09-04,-1,1,"det",3
"2","Sun","September 11","L","","1-1",FALSE,"Minnesota Vikings",3,10,13,212,175,37,3,14,289,203,86,3,1994-09-11,0,0,"det",-7
"3","Mon","September 19","W","OT","2-1",FALSE,"Dallas Cowboys",20,17,22,379,173,206,0,25,368,206,162,3,1994-09-19,3,1,"det",3
"4","Sun","September 25","L","","2-2",TRUE,"New England Patriots",17,23,15,342,183,159,2,21,353,245,108,0,1994-09-25,-2,0,"det",-6
"5","Sun","October 2","L","","2-3",FALSE,"Tampa Bay Buccaneers",14,24,17,321,125,196,1,16,234,115,119,0,1994-10-02,-1,0,"det",-10
"6","Sun","October 9","L","","2-4",TRUE,"San Francisco 49ers",21,27,21,340,242,98,2,20,233,143,90,0,1994-10-09,-2,0,"det",-6
"8","Sun","October 23","W","","3-4",TRUE,"Chicago Bears",21,16,8,232,49,183,3,22,402,285,117,4,1994-10-23,1,1,"det",5
"9","Sun","October 30","W","OT","4-4",FALSE,"New York Giants",28,25,24,329,180,149,3,23,344,149,195,1,1994-10-30,-2,1,"det",3
"10","Sun","November 6","L","","4-5",FALSE,"Green Bay Packers",30,38,20,366,317,49,5,21,347,230,117,2,1994-11-06,-3,0,"det",-8
"11","Sun","November 13","W","","5-5",TRUE,"Tampa Bay Buccaneers",14,9,16,342,99,243,0,18,343,218,125,0,1994-11-13,0,1,"det",5
"12","Sun","November 20","L","","5-6",FALSE,"Chicago Bears",10,20,11,180,128,52,0,23,338,177,161,1,1994-11-20,1,0,"det",-10
"13","Thu","November 24","W","","6-6",TRUE,"Buffalo Bills",35,21,20,388,341,47,0,25,367,246,121,2,1994-11-24,2,1,"det",14
"14","Sun","December 4","W","","7-6",TRUE,"Green Bay Packers",34,31,21,387,188,199,0,23,417,359,58,2,1994-12-04,2,1,"det",3
"15","Sat","December 10","W","","8-6",FALSE,"New York Jets",18,7,19,326,189,137,1,14,261,141,120,1,1994-12-10,0,1,"det",11
"16","Sat","December 17","W","","9-6",TRUE,"Minnesota Vikings",41,19,17,284,160,124,1,18,337,273,64,1,1994-12-17,0,1,"det",22
"17","Sun","December 25","L","","9-7",FALSE,"Miami Dolphins",20,27,15,222,170,52,2,21,383,285,98,3,1994-12-25,1,0,"det",-7
"WildCard","Sat","December 31","L","","9-8",FALSE,"Green Bay Packers",12,16,9,171,175,-4,0,18,336,255,81,0,1994-12-31,0,0,"det",-4
"1","Sun","September 3","L","","0-1",FALSE,"Pittsburgh Steelers",20,23,16,302,180,122,1,26,354,204,150,4,1995-09-03,3,0,"det",-3
"2","Sun","September 10","L","","0-2",FALSE,"Minnesota Vikings",10,20,19,326,272,54,1,19,380,225,155,1,1995-09-10,0,0,"det",-10
"3","Sun","September 17","L","","0-3",TRUE,"Arizona Cardinals",17,20,19,358,198,160,3,18,230,109,121,0,1995-09-17,-3,0,"det",-3
"4","Mon","September 25","W","","1-3",TRUE,"San Francisco 49ers",27,24,23,316,286,30,0,23,416,338,78,1,1995-09-25,1,1,"det",3
"6","Sun","October 8","W","","2-3",TRUE,"Cleveland Browns",38,20,22,429,268,161,1,15,255,196,59,1,1995-10-08,0,1,"det",18
"7","Sun","October 15","L","","2-4",FALSE,"Green Bay Packers",21,30,18,334,205,129,1,26,436,327,109,0,1995-10-15,-1,0,"det",-9
"8","Sun","October 22","L","OT","2-5",FALSE,"Washington Redskins",30,36,27,421,322,99,4,26,405,239,166,0,1995-10-22,-4,0,"det",-6
"9","Sun","October 29","W","","3-5",TRUE,"Green Bay Packers",24,16,18,407,238,169,0,28,443,298,145,4,1995-10-29,4,1,"det",8
"10","Sun","November 5","L","","3-6",FALSE,"Atlanta Falcons",22,34,19,375,314,61,2,30,434,349,85,1,1995-11-05,-1,0,"det",-12
"11","Sun","November 12","W","","4-6",TRUE,"Tampa Bay Buccaneers",27,24,23,356,254,102,1,26,411,221,190,4,1995-11-12,3,1,"det",3
"12","Sun","November 19","W","","5-6",FALSE,"Chicago Bears",24,17,24,422,279,143,3,20,311,231,80,1,1995-11-19,-2,1,"det",7
"13","Thu","November 23","W","","6-6",TRUE,"Minnesota Vikings",44,38,27,534,395,139,3,22,385,351,34,3,1995-11-23,0,1,"det",6
"14","Mon","December 4","W","","7-6",TRUE,"Chicago Bears",27,7,27,419,310,109,0,13,185,108,77,0,1995-12-04,0,1,"det",20
"15","Sun","December 10","W","","8-6",FALSE,"Houston Oilers",24,17,15,322,263,59,4,26,405,312,93,6,1995-12-10,2,1,"det",7
"16","Sun","December 17","W","","9-6",TRUE,"Jacksonville Jaguars",44,0,28,386,230,156,0,15,235,126,109,5,1995-12-17,5,1,"det",44
"17","Sat","December 23","W","","10-6",FALSE,"Tampa Bay Buccaneers",37,10,24,406,346,60,1,17,314,170,144,4,1995-12-23,3,1,"det",27
"WildCard","Sat","December 30","L","","10-7",FALSE,"Philadelphia Eagles",37,58,26,422,350,72,7,22,452,263,189,1,1995-12-30,-6,0,"det",-21
"1","Sun","September 1","L","","0-1",FALSE,"Minnesota Vikings",13,17,27,435,244,191,5,16,311,183,128,0,1996-09-01,-5,0,"det",-4
"2","Sun","September 8","W","","1-1",TRUE,"Tampa Bay Buccaneers",21,6,12,234,114,120,1,13,274,200,74,4,1996-09-08,3,1,"det",15
"3","Sun","September 15","L","","1-2",FALSE,"Philadelphia Eagles",17,24,17,233,173,60,1,25,446,271,175,0,1996-09-15,-1,0,"det",-7
"4","Sun","September 22","W","","2-2",TRUE,"Chicago Bears",35,16,19,394,309,85,1,19,318,248,70,2,1996-09-22,1,1,"det",19
"5","Sun","September 29","W","","3-2",FALSE,"Tampa Bay Buccaneers",27,0,20,350,221,129,0,13,226,156,70,4,1996-09-29,4,1,"det",27
"6","Sun","October 6","W","","4-2",TRUE,"Atlanta Falcons",28,24,23,357,262,95,1,19,281,165,116,1,1996-10-06,0,1,"det",4
"7","Sun","October 13","L","","4-3",FALSE,"Oakland Raiders",21,37,23,396,333,63,2,20,419,295,124,0,1996-10-13,-2,0,"det",-16
"9","Sun","October 27","L","","4-4",TRUE,"New York Giants",7,35,14,252,185,67,6,18,335,235,100,2,1996-10-27,-4,0,"det",-28
"10","Sun","November 3","L","","4-5",FALSE,"Green Bay Packers",18,28,18,293,127,166,0,23,355,254,101,1,1996-11-03,1,0,"det",-10
"11","Mon","November 11","L","","4-6",FALSE,"San Diego Chargers",21,27,19,222,140,82,1,27,406,279,127,0,1996-11-11,-1,0,"det",-6
"12","Sun","November 17","W","","5-6",TRUE,"Seattle Seahawks",17,16,17,285,141,144,1,24,378,194,184,1,1996-11-17,0,1,"det",1
"13","Sun","November 24","L","","5-7",FALSE,"Chicago Bears",14,31,27,322,208,114,3,22,358,219,139,2,1996-11-24,-1,0,"det",-17
"14","Thu","November 28","L","","5-8",TRUE,"Kansas City Chiefs",24,28,21,318,237,81,3,26,338,95,243,1,1996-11-28,-2,0,"det",-4
"15","Sun","December 8","L","","5-9",TRUE,"Minnesota Vikings",22,24,23,380,235,145,0,21,289,173,116,0,1996-12-08,0,0,"det",-2
"16","Sun","December 15","L","","5-10",TRUE,"Green Bay Packers",3,31,19,265,186,79,1,20,336,225,111,1,1996-12-15,0,0,"det",-28
"17","Mon","December 23","L","","5-11",FALSE,"San Francisco 49ers",14,24,18,277,88,189,0,18,281,152,129,0,1996-12-23,0,0,"det",-10
"1","Sun","August 31","W","","1-0",TRUE,"Atlanta Falcons",28,17,10,221,175,46,3,13,323,268,55,4,1997-08-31,1,1,"det",11
"2","Sun","September 7","L","","1-1",TRUE,"Tampa Bay Buccaneers",17,24,13,346,322,24,1,20,272,99,173,0,1997-09-07,-1,0,"det",-7
"3","Sun","September 14","W","","2-1",FALSE,"Chicago Bears",32,7,27,404,202,202,1,19,284,190,94,2,1997-09-14,1,1,"det",25
"4","Sun","September 21","L","","2-2",FALSE,"New Orleans Saints",17,35,22,355,237,118,4,21,385,213,172,0,1997-09-21,-4,0,"det",-18
"5","Sun","September 28","W","","3-2",TRUE,"Green Bay Packers",26,15,18,376,203,173,0,23,396,289,107,4,1997-09-28,4,1,"det",11
"6","Sun","October 5","L","","3-3",FALSE,"Buffalo Bills",13,22,17,309,189,120,1,10,266,102,164,0,1997-10-05,-1,0,"det",-9
"7","Sun","October 12","W","","4-3",FALSE,"Tampa Bay Buccaneers",27,9,17,447,188,259,1,13,289,217,72,2,1997-10-12,1,1,"det",18
"8","Sun","October 19","L","OT","4-4",TRUE,"New York Giants",20,26,20,337,226,111,2,15,331,210,121,1,1997-10-19,-1,0,"det",-6
"10","Sun","November 2","L","","4-5",FALSE,"Green Bay Packers",10,20,18,256,131,125,4,11,244,163,81,2,1997-11-02,-2,0,"det",-10
"11","Sun","November 9","L","","4-6",FALSE,"Washington Redskins",7,30,11,268,163,105,4,25,388,247,141,0,1997-11-09,-4,0,"det",-23
"12","Sun","November 16","W","","5-6",TRUE,"Minnesota Vikings",38,15,27,477,266,211,0,18,300,174,126,1,1997-11-16,1,1,"det",23
"13","Sun","November 23","W","","6-6",TRUE,"Indianapolis Colts",32,10,21,391,142,249,0,12,173,120,53,1,1997-11-23,1,1,"det",22
"14","Thu","November 27","W","","7-6",TRUE,"Chicago Bears",55,20,25,496,274,222,1,16,333,262,71,4,1997-11-27,3,1,"det",35
"15","Sun","December 7","L","","7-7",FALSE,"Miami Dolphins",30,33,24,424,279,145,5,19,391,310,81,1,1997-12-07,-4,0,"det",-3
"16","Sun","December 14","W","","8-7",FALSE,"Minnesota Vikings",14,13,21,390,242,148,1,13,257,43,214,0,1997-12-14,-1,1,"det",1
"17","Sun","December 21","W","","9-7",TRUE,"New York Jets",13,10,13,301,95,206,0,20,315,207,108,3,1997-12-21,3,1,"det",3
"WildCard","Sun","December 28","L","","9-8",FALSE,"Tampa Bay Buccaneers",10,20,18,307,198,109,1,15,316,175,141,2,1997-12-28,1,0,"det",-10
"1","Sun","September 6","L","","0-1",FALSE,"Green Bay Packers",19,38,20,321,236,85,2,21,342,267,75,0,1998-09-06,-2,0,"det",-19
"2","Sun","September 13","L","OT","0-2",TRUE,"Cincinnati Bengals",28,34,22,412,188,224,2,18,384,284,100,0,1998-09-13,-2,0,"det",-6
"3","Sun","September 20","L","","0-3",FALSE,"Minnesota Vikings",6,29,19,279,142,137,4,17,287,211,76,0,1998-09-20,-4,0,"det",-23
"4","Mon","September 28","W","","1-3",TRUE,"Tampa Bay Buccaneers",27,6,17,280,124,156,1,6,133,78,55,2,1998-09-28,1,1,"det",21
"5","Sun","October 4","L","","1-4",FALSE,"Chicago Bears",27,31,15,340,246,94,0,23,405,280,125,5,1998-10-04,5,0,"det",-4
"7","Thu","October 15","W","","2-4",TRUE,"Green Bay Packers",27,20,16,385,199,186,1,23,368,275,93,3,1998-10-15,2,1,"det",7
"8","Sun","October 25","L","","2-5",TRUE,"Minnesota Vikings",13,34,17,351,214,137,1,23,329,170,159,3,1998-10-25,2,0,"det",-21
"9","Sun","November 1","L","","2-6",TRUE,"Arizona Cardinals",15,17,18,280,167,113,6,11,209,172,37,2,1998-11-01,-4,0,"det",-2
"10","Sun","November 8","L","","2-7",FALSE,"Philadelphia Eagles",9,10,9,257,111,146,0,16,289,73,216,0,1998-11-08,0,0,"det",-1
"11","Sun","November 15","W","","3-7",TRUE,"Chicago Bears",26,3,24,391,246,145,0,14,252,147,105,0,1998-11-15,0,1,"det",23
"12","Sun","November 22","W","","4-7",FALSE,"Tampa Bay Buccaneers",28,25,19,300,188,112,0,22,428,283,145,2,1998-11-22,2,1,"det",3
"13","Thu","November 26","W","OT","5-7",TRUE,"Pittsburgh Steelers",19,16,13,283,213,70,2,22,293,208,85,2,1998-11-26,0,1,"det",3
"14","Sun","December 6","L","","5-8",FALSE,"Jacksonville Jaguars",22,37,16,332,212,120,0,24,426,221,205,0,1998-12-06,0,0,"det",-15
"15","Mon","December 14","L","","5-9",FALSE,"San Francisco 49ers",13,35,25,380,311,69,2,29,409,81,328,1,1998-12-14,-1,0,"det",-22
"16","Sun","December 20","L","","5-10",TRUE,"Atlanta Falcons",17,24,17,258,141,117,3,20,268,123,145,0,1998-12-20,-3,0,"det",-7
"17","Sun","December 27","L","","5-11",FALSE,"Baltimore Ravens",10,19,11,236,192,44,1,19,295,142,153,1,1998-12-27,0,0,"det",-9
"1","Sun","September 12","W","","1-0",FALSE,"Seattle Seahawks",28,20,19,369,202,167,1,16,205,174,31,2,1999-09-12,1,1,"det",8
"2","Sun","September 19","W","","2-0",TRUE,"Green Bay Packers",23,15,9,278,196,82,2,21,437,283,154,3,1999-09-19,1,1,"det",8
"3","Sun","September 26","L","","2-1",FALSE,"Kansas City Chiefs",21,31,18,311,193,118,2,21,383,228,155,0,1999-09-26,-2,0,"det",-10
"5","Sun","October 10","L","","2-2",TRUE,"San Diego Chargers",10,20,14,229,192,37,3,15,256,192,64,2,1999-10-10,-1,0,"det",-10
"6","Sun","October 17","W","","3-2",TRUE,"Minnesota Vikings",25,23,19,299,189,110,1,17,327,267,60,5,1999-10-17,4,1,"det",2
"7","Sun","October 24","W","","4-2",FALSE,"Carolina Panthers",24,9,20,300,210,90,2,22,320,259,61,2,1999-10-24,0,1,"det",15
"8","Sun","October 31","W","","5-2",TRUE,"Tampa Bay Buccaneers",20,3,13,256,109,147,0,18,292,220,72,2,1999-10-31,2,1,"det",17
"9","Sun","November 7","W","","6-2",TRUE,"St. Louis Rams",31,27,17,332,311,21,0,20,332,275,57,2,1999-11-07,2,1,"det",4
"10","Sun","November 14","L","","6-3",FALSE,"Arizona Cardinals",19,23,17,373,331,42,1,17,343,184,159,1,1999-11-14,0,0,"det",-4
"11","Sun","November 21","L","","6-4",FALSE,"Green Bay Packers",17,26,20,335,225,110,2,24,371,307,64,0,1999-11-21,-2,0,"det",-9
"12","Thu","November 25","W","","7-4",TRUE,"Chicago Bears",21,17,20,377,293,84,1,12,236,184,52,1,1999-11-25,0,1,"det",4
"13","Sun","December 5","W","","8-4",TRUE,"Washington Redskins",33,17,12,292,261,31,0,16,333,217,116,4,1999-12-05,4,1,"det",16
"14","Sun","December 12","L","","8-5",FALSE,"Tampa Bay Buccaneers",16,23,16,265,210,55,1,17,312,271,41,2,1999-12-12,1,0,"det",-7
"15","Sun","December 19","L","","8-6",FALSE,"Chicago Bears",10,28,19,339,236,103,4,27,396,292,104,2,1999-12-19,-2,0,"det",-18
"16","Sat","December 25","L","","8-7",TRUE,"Denver Broncos",7,17,16,274,242,32,0,22,369,165,204,1,1999-12-25,1,0,"det",-10
"17","Sun","January 2","L","","8-8",FALSE,"Minnesota Vikings",17,24,20,302,286,16,2,20,379,242,137,3,2000-01-02,1,0,"det",-7
"WildCard","Sat","January 8","L","","8-9",FALSE,"Washington Redskins",13,27,14,258,213,45,2,23,389,166,223,2,2000-01-08,0,0,"det",-14
"1","Sun","September 3","W","","1-0",FALSE,"New Orleans Saints",14,10,10,187,89,98,2,13,252,146,106,3,2000-09-03,1,1,"det",4
"2","Sun","September 10","W","","2-0",TRUE,"Washington Redskins",15,10,15,244,182,62,2,20,333,229,104,4,2000-09-10,2,1,"det",5
"3","Sun","September 17","L","","2-1",TRUE,"Tampa Bay Buccaneers",10,31,13,243,226,17,3,22,331,211,120,0,2000-09-17,-3,0,"det",-21
"4","Sun","September 24","W","","3-1",FALSE,"Chicago Bears",21,14,15,274,194,80,1,16,401,254,147,5,2000-09-24,4,1,"det",7
"5","Sun","October 1","L","","3-2",TRUE,"Minnesota Vikings",24,31,27,355,226,129,1,19,439,261,178,0,2000-10-01,-1,0,"det",-7
"6","Sun","October 8","W","","4-2",TRUE,"Green Bay Packers",31,24,11,253,179,74,1,19,339,270,69,5,2000-10-08,4,1,"det",7
"8","Thu","October 19","W","","5-2",FALSE,"Tampa Bay Buccaneers",28,14,21,277,107,170,0,12,258,149,109,4,2000-10-19,4,1,"det",14
"9","Sun","October 29","L","","5-3",FALSE,"Indianapolis Colts",18,30,18,328,174,154,4,24,420,281,139,5,2000-10-29,1,0,"det",-12
"10","Sun","November 5","L","","5-4",TRUE,"Miami Dolphins",8,23,14,253,154,99,3,15,293,104,189,0,2000-11-05,-3,0,"det",-15
"11","Sun","November 12","W","","6-4",TRUE,"Atlanta Falcons",13,10,12,222,115,107,1,17,218,104,114,2,2000-11-12,1,1,"det",3
"12","Sun","November 19","W","","7-4",FALSE,"New York Giants",31,21,22,314,219,95,2,25,373,320,53,4,2000-11-19,2,1,"det",10
"13","Thu","November 23","W","","8-4",TRUE,"New England Patriots",34,9,17,299,189,110,1,15,215,149,66,2,2000-11-23,1,1,"det",25
"14","Thu","November 30","L","","8-5",FALSE,"Minnesota Vikings",17,24,20,352,213,139,2,19,305,160,145,2,2000-11-30,0,0,"det",-7
"15","Sun","December 10","L","","8-6",FALSE,"Green Bay Packers",13,26,15,293,190,103,5,16,330,202,128,2,2000-12-10,-3,0,"det",-13
"16","Sun","December 17","W","","9-6",FALSE,"New York Jets",10,7,16,288,78,210,1,12,240,189,51,2,2000-12-17,1,1,"det",3
"17","Sun","December 24","L","","9-7",TRUE,"Chicago Bears",20,23,18,240,140,100,2,15,286,181,105,2,2000-12-24,0,0,"det",-3
"1","Sun","September 9","L","","0-1",FALSE,"Green Bay Packers",6,28,14,288,232,56,3,20,424,245,179,1,2001-09-09,-2,0,"det",-22
"2","Sun","September 23","L","","0-2",FALSE,"Cleveland Browns",14,24,18,271,189,82,7,17,257,118,139,2,2001-09-23,-5,0,"det",-10
"4","Mon","October 8","L","","0-3",TRUE,"St. Louis Rams",0,35,14,334,229,105,3,23,378,284,94,1,2001-10-08,-2,0,"det",-35
"5","Sun","October 14","L","","0-4",FALSE,"Minnesota Vikings",26,31,28,457,328,129,1,23,343,198,145,1,2001-10-14,0,0,"det",-5
"6","Sun","October 21","L","","0-5",TRUE,"Tennessee Titans",24,27,18,363,322,41,2,18,329,227,102,2,2001-10-21,0,0,"det",-3
"7","Sun","October 28","L","","0-6",TRUE,"Cincinnati Bengals",27,31,17,276,215,61,3,21,412,188,224,2,2001-10-28,-1,0,"det",-4
"8","Sun","November 4","L","","0-7",FALSE,"San Francisco 49ers",13,21,12,131,73,58,0,27,427,282,145,3,2001-11-04,3,0,"det",-8
"9","Sun","November 11","L","","0-8",TRUE,"Tampa Bay Buccaneers",17,20,19,270,218,52,3,16,274,175,99,1,2001-11-11,-2,0,"det",-3
"10","Sun","November 18","L","","0-9",FALSE,"Arizona Cardinals",38,45,30,478,429,49,3,23,417,328,89,1,2001-11-18,-2,0,"det",-7
"11","Thu","November 22","L","","0-10",TRUE,"Green Bay Packers",27,29,19,360,193,167,2,23,339,235,104,2,2001-11-22,0,0,"det",-2
"12","Sun","December 2","L","","0-11",FALSE,"Chicago Bears",10,13,17,295,228,67,1,18,232,124,108,1,2001-12-02,0,0,"det",-3
"13","Sun","December 9","L","","0-12",FALSE,"Tampa Bay Buccaneers",12,15,14,253,151,102,1,24,356,275,81,2,2001-12-09,1,0,"det",-3
"14","Sun","December 16","W","","1-12",TRUE,"Minnesota Vikings",27,24,19,369,202,167,1,16,314,234,80,2,2001-12-16,1,1,"det",3
"15","Sun","December 23","L","","1-13",FALSE,"Pittsburgh Steelers",14,47,11,151,77,74,3,25,429,214,215,0,2001-12-23,-3,0,"det",-33
"16","Sun","December 30","L","","1-14",TRUE,"Chicago Bears",0,24,19,332,268,64,5,15,326,243,83,0,2001-12-30,-5,0,"det",-24
"17","Sun","January 6","W","","2-14",TRUE,"Dallas Cowboys",15,10,20,366,242,124,0,12,264,158,106,1,2002-01-06,1,1,"det",5
"1","Sun","September 8","L","","0-1",FALSE,"Miami Dolphins",21,49,15,257,206,51,2,27,389,207,182,0,2002-09-08,-2,0,"det",-28
"2","Sun","September 15","L","","0-2",FALSE,"Carolina Panthers",7,31,12,122,49,73,3,20,385,310,75,0,2002-09-15,-3,0,"det",-24
"3","Sun","September 22","L","","0-3",TRUE,"Green Bay Packers",31,37,14,271,176,95,5,22,442,347,95,3,2002-09-22,-2,0,"det",-6
"4","Sun","September 29","W","","1-3",TRUE,"New Orleans Saints",26,21,16,352,267,85,0,24,357,247,110,3,2002-09-29,3,1,"det",5
"6","Sun","October 13","L","","1-4",FALSE,"Minnesota Vikings",24,31,17,354,301,53,1,22,402,291,111,1,2002-10-13,0,0,"det",-7
"7","Sun","October 20","W","OT","2-4",TRUE,"Chicago Bears",23,20,23,362,170,192,1,17,224,135,89,3,2002-10-20,2,1,"det",3
"8","Sun","October 27","L","","2-5",FALSE,"Buffalo Bills",17,24,16,282,199,83,1,23,343,269,74,2,2002-10-27,1,0,"det",-7
"9","Sun","November 3","W","","3-5",TRUE,"Dallas Cowboys",9,7,8,148,96,52,2,17,221,150,71,2,2002-11-03,0,1,"det",2
"10","Sun","November 10","L","","3-6",FALSE,"Green Bay Packers",14,40,13,362,236,126,2,24,503,353,150,2,2002-11-10,0,0,"det",-26
"11","Sun","November 17","L","","3-7",TRUE,"New York Jets",14,31,13,279,171,108,1,26,408,219,189,1,2002-11-17,0,0,"det",-17
"12","Sun","November 24","L","OT","3-8",FALSE,"Chicago Bears",17,20,19,301,199,102,2,21,422,347,75,1,2002-11-24,-1,0,"det",-3
"13","Thu","November 28","L","","3-9",TRUE,"New England Patriots",12,20,14,292,210,82,3,23,349,210,139,1,2002-11-28,-2,0,"det",-8
"14","Sun","December 8","L","OT","3-10",FALSE,"Arizona Cardinals",20,23,15,203,152,51,1,21,313,180,133,1,2002-12-08,0,0,"det",-3
"15","Sun","December 15","L","","3-11",TRUE,"Tampa Bay Buccaneers",20,23,15,292,148,144,1,22,376,253,123,0,2002-12-15,-1,0,"det",-3
"16","Sun","December 22","L","","3-12",FALSE,"Atlanta Falcons",15,36,12,208,121,87,3,27,533,336,197,2,2002-12-22,-1,0,"det",-21
"17","Sun","December 29","L","","3-13",TRUE,"Minnesota Vikings",36,38,20,386,293,93,3,24,450,296,154,2,2002-12-29,-1,0,"det",-2
"1","Sun","September 7","W","","1-0",TRUE,"Arizona Cardinals",42,24,16,261,195,66,0,21,434,339,95,3,2003-09-07,3,1,"det",18
"2","Sun","September 14","L","","1-1",FALSE,"Green Bay Packers",6,31,14,293,237,56,3,17,332,132,200,2,2003-09-14,-1,0,"det",-25
"3","Sun","September 21","L","","1-2",TRUE,"Minnesota Vikings",13,23,22,302,225,77,3,14,414,287,127,1,2003-09-21,-2,0,"det",-10
"4","Sun","September 28","L","","1-3",FALSE,"Denver Broncos",16,20,16,285,141,144,0,20,332,253,79,1,2003-09-28,1,0,"det",-4
"5","Sun","October 5","L","","1-4",FALSE,"San Francisco 49ers",17,24,15,305,221,84,2,20,325,183,142,1,2003-10-05,-1,0,"det",-7
"7","Sun","October 19","L","","1-5",TRUE,"Dallas Cowboys",7,38,9,157,74,83,4,25,331,197,134,1,2003-10-19,-3,0,"det",-31
"8","Sun","October 26","L","","1-6",FALSE,"Chicago Bears",16,24,16,260,180,80,2,14,261,193,68,0,2003-10-26,-2,0,"det",-8
"9","Sun","November 2","W","","2-6",TRUE,"Oakland Raiders",23,13,14,229,117,112,2,18,265,171,94,4,2003-11-02,2,1,"det",10
"10","Sun","November 9","W","","3-6",TRUE,"Chicago Bears",12,10,10,248,231,17,0,11,199,133,66,1,2003-11-09,1,1,"det",2
"11","Sun","November 16","L","","3-7",FALSE,"Seattle Seahawks",14,35,20,357,276,81,2,22,366,207,159,0,2003-11-16,-2,0,"det",-21
"12","Sun","November 23","L","","3-8",FALSE,"Minnesota Vikings",14,24,16,241,167,74,4,18,307,186,121,2,2003-11-23,-2,0,"det",-10
"13","Thu","November 27","W","","4-8",TRUE,"Green Bay Packers",22,14,17,266,172,94,1,18,320,268,52,5,2003-11-27,4,1,"det",8
"14","Sun","December 7","L","","4-9",TRUE,"San Diego Chargers",7,14,14,276,208,68,0,17,375,244,131,2,2003-12-07,2,0,"det",-7
"15","Sun","December 14","L","","4-10",FALSE,"Kansas City Chiefs",17,45,22,334,197,137,2,28,521,372,149,0,2003-12-14,-2,0,"det",-28
"16","Sun","December 21","L","","4-11",FALSE,"Carolina Panthers",14,20,8,106,53,53,1,22,384,260,124,2,2003-12-21,1,0,"det",-6
"17","Sun","December 28","W","","5-11",TRUE,"St. Louis Rams",30,20,21,342,230,112,2,13,194,153,41,3,2003-12-28,1,1,"det",10
"1","Sun","September 12","W","","1-0",FALSE,"Chicago Bears",20,16,13,262,185,77,1,18,342,214,128,4,2004-09-12,3,1,"det",4
"2","Sun","September 19","W","","2-0",TRUE,"Houston Texans",28,16,18,266,172,94,1,24,386,274,112,3,2004-09-19,2,1,"det",12
"3","Sun","September 26","L","","2-1",TRUE,"Philadelphia Eagles",13,30,15,256,179,77,1,19,402,343,59,1,2004-09-26,0,0,"det",-17
"5","Sun","October 10","W","","3-1",FALSE,"Atlanta Falcons",17,10,15,227,126,101,0,17,279,185,94,4,2004-10-10,4,1,"det",7
"6","Sun","October 17","L","","3-2",TRUE,"Green Bay Packers",10,38,5,125,92,33,1,28,434,277,157,0,2004-10-17,-1,0,"det",-28
"7","Sun","October 24","W","","4-2",FALSE,"New York Giants",28,13,22,325,210,115,0,22,325,250,75,2,2004-10-24,2,1,"det",15
"8","Sun","October 31","L","","4-3",FALSE,"Dallas Cowboys",21,31,15,284,245,39,1,22,357,230,127,3,2004-10-31,2,0,"det",-10
"9","Sun","November 7","L","","4-4",TRUE,"Washington Redskins",10,17,21,322,258,64,1,15,229,73,156,0,2004-11-07,-1,0,"det",-7
"10","Sun","November 14","L","OT","4-5",FALSE,"Jacksonville Jaguars",17,23,10,190,109,81,1,22,415,176,239,0,2004-11-14,-1,0,"det",-6
"11","Sun","November 21","L","","4-6",FALSE,"Minnesota Vikings",19,22,13,213,67,146,1,22,319,212,107,1,2004-11-21,0,0,"det",-3
"12","Thu","November 25","L","","4-7",TRUE,"Indianapolis Colts",9,41,19,386,218,168,5,24,356,243,113,0,2004-11-25,-5,0,"det",-32
"13","Sun","December 5","W","","5-7",TRUE,"Arizona Cardinals",26,12,16,398,183,215,1,15,254,160,94,4,2004-12-05,3,1,"det",14
"14","Sun","December 12","L","","5-8",FALSE,"Green Bay Packers",13,16,17,228,35,193,0,20,301,185,116,0,2004-12-12,0,0,"det",-3
"15","Sun","December 19","L","","5-9",TRUE,"Minnesota Vikings",27,28,24,463,350,113,3,21,461,370,91,1,2004-12-19,-2,0,"det",-1
"16","Sun","December 26","W","","6-9",TRUE,"Chicago Bears",19,13,17,314,156,158,1,16,229,105,124,1,2004-12-26,0,1,"det",6
"17","Sun","January 2","L","","6-10",FALSE,"Tennessee Titans",19,24,23,434,331,103,2,15,312,217,95,0,2005-01-02,-2,0,"det",-5
"1","Sun","September 11","W","","1-0",TRUE,"Green Bay Packers",17,3,18,254,152,102,0,13,216,170,46,3,2005-09-11,3,1,"det",14
"2","Sun","September 18","L","","1-1",FALSE,"Chicago Bears",6,38,14,234,205,29,5,18,336,149,187,0,2005-09-18,-5,0,"det",-32
"4","Sun","October 2","L","","1-2",FALSE,"Tampa Bay Buccaneers",13,17,11,226,135,91,1,17,353,284,69,4,2005-10-02,3,0,"det",-4
"5","Sun","October 9","W","","2-2",TRUE,"Baltimore Ravens",35,17,22,266,97,169,2,26,387,228,159,4,2005-10-09,2,1,"det",18
"6","Sun","October 16","L","","2-3",TRUE,"Carolina Panthers",20,21,11,209,157,52,4,14,317,263,54,4,2005-10-16,0,0,"det",-1
"7","Sun","October 23","W","","3-3",FALSE,"Cleveland Browns",13,10,19,329,210,119,1,11,174,56,118,3,2005-10-23,2,1,"det",3
"8","Sun","October 30","L","OT","3-4",TRUE,"Chicago Bears",13,19,17,278,185,93,1,14,333,218,115,1,2005-10-30,0,0,"det",-6
"9","Sun","November 6","L","","3-5",FALSE,"Minnesota Vikings",14,27,20,289,231,58,3,19,285,121,164,1,2005-11-06,-2,0,"det",-13
"10","Sun","November 13","W","","4-5",TRUE,"Arizona Cardinals",29,21,22,383,226,157,0,21,397,359,38,1,2005-11-13,1,1,"det",8
"11","Sun","November 20","L","","4-6",FALSE,"Dallas Cowboys",7,20,11,226,169,57,1,26,253,104,149,1,2005-11-20,0,0,"det",-13
"12","Thu","November 24","L","","4-7",TRUE,"Atlanta Falcons",7,27,20,304,229,75,4,22,402,146,256,2,2005-11-24,-2,0,"det",-20
"13","Sun","December 4","L","","4-8",TRUE,"Minnesota Vikings",16,21,19,223,118,105,1,20,345,242,103,0,2005-12-04,-1,0,"det",-5
"14","Sun","December 11","L","OT","4-9",FALSE,"Green Bay Packers",13,16,11,241,112,129,0,19,330,149,181,2,2005-12-11,2,0,"det",-3
"15","Sun","December 18","L","","4-10",TRUE,"Cincinnati Bengals",17,41,13,270,211,59,4,29,426,271,155,2,2005-12-18,-2,0,"det",-24
"16","Sat","December 24","W","","5-10",FALSE,"New Orleans Saints",13,12,14,279,208,71,1,19,273,226,47,1,2005-12-24,0,1,"det",1
"17","Sun","January 1","L","","5-11",FALSE,"Pittsburgh Steelers",21,35,16,308,203,105,2,20,331,132,199,2,2006-01-01,0,0,"det",-14
"1","Sun","September 10","L","","0-1",TRUE,"Seattle Seahawks",6,9,15,251,213,38,1,17,264,173,91,1,2006-09-10,0,0,"det",-3
"2","Sun","September 17","L","","0-2",FALSE,"Chicago Bears",7,34,15,245,199,46,3,22,383,294,89,1,2006-09-17,-2,0,"det",-27
"3","Sun","September 24","L","","0-3",TRUE,"Green Bay Packers",24,31,23,424,319,105,1,18,400,340,60,2,2006-09-24,1,0,"det",-7
"4","Sun","October 1","L","","0-4",FALSE,"St. Louis Rams",34,41,21,370,277,93,3,23,427,321,106,0,2006-10-01,-3,0,"det",-7
"5","Sun","October 8","L","","0-5",FALSE,"Minnesota Vikings",17,26,13,217,201,16,4,18,336,201,135,3,2006-10-08,-1,0,"det",-9
"6","Sun","October 15","W","","1-5",TRUE,"Buffalo Bills",20,17,21,397,262,135,1,16,242,157,85,3,2006-10-15,2,1,"det",3
"7","Sun","October 22","L","","1-6",FALSE,"New York Jets",24,31,22,386,261,125,2,27,398,177,221,1,2006-10-22,-1,0,"det",-7
"9","Sun","November 5","W","","2-6",TRUE,"Atlanta Falcons",30,14,20,435,308,127,1,19,319,154,165,3,2006-11-05,2,1,"det",16
"10","Sun","November 12","L","","2-7",TRUE,"San Francisco 49ers",13,19,16,251,180,71,4,17,315,117,198,1,2006-11-12,-3,0,"det",-6
"11","Sun","November 19","L","","2-8",FALSE,"Arizona Cardinals",10,17,19,281,213,68,1,20,338,228,110,0,2006-11-19,-1,0,"det",-7
"12","Thu","November 23","L","","2-9",TRUE,"Miami Dolphins",10,27,13,220,199,21,2,18,395,209,186,2,2006-11-23,0,0,"det",-17
"13","Sun","December 3","L","","2-10",FALSE,"New England Patriots",21,28,22,361,284,77,5,23,363,284,79,3,2006-12-03,-2,0,"det",-7
"14","Sun","December 10","L","","2-11",TRUE,"Minnesota Vikings",20,30,20,280,283,-3,6,21,328,156,172,2,2006-12-10,-4,0,"det",-10
"15","Sun","December 17","L","","2-12",FALSE,"Green Bay Packers",9,17,10,142,84,58,3,19,303,164,139,4,2006-12-17,1,0,"det",-8
"16","Sun","December 24","L","","2-13",TRUE,"Chicago Bears",21,26,18,327,260,67,1,22,354,238,116,0,2006-12-24,-1,0,"det",-5
"17","Sun","December 31","W","","3-13",FALSE,"Dallas Cowboys",39,31,22,362,277,85,1,19,365,307,58,4,2006-12-31,3,1,"det",8
"1","Sun","September 9","W","","1-0",FALSE,"Oakland Raiders",36,21,21,392,284,108,2,24,375,283,92,3,2007-09-09,1,1,"det",15
"2","Sun","September 16","W","OT","2-0",TRUE,"Minnesota Vikings",20,17,29,415,359,56,5,17,313,190,123,5,2007-09-16,0,1,"det",3
"3","Sun","September 23","L","","2-1",FALSE,"Philadelphia Eagles",21,56,20,432,393,39,3,29,536,363,173,2,2007-09-23,-1,0,"det",-35
"4","Sun","September 30","W","","3-1",TRUE,"Chicago Bears",37,27,19,310,215,95,2,22,303,234,69,3,2007-09-30,1,1,"det",10
"5","Sun","October 7","L","","3-2",FALSE,"Washington Redskins",3,34,11,144,76,68,2,23,366,248,118,1,2007-10-07,-1,0,"det",-31
"7","Sun","October 21","W","","4-2",TRUE,"Tampa Bay Buccaneers",23,16,17,278,131,147,0,27,422,298,124,2,2007-10-21,2,1,"det",7
"8","Sun","October 28","W","","5-2",FALSE,"Chicago Bears",16,7,22,365,246,119,1,16,255,192,63,4,2007-10-28,3,1,"det",9
"9","Sun","November 4","W","","6-2",TRUE,"Denver Broncos",44,7,20,376,246,130,1,16,303,256,47,4,2007-11-04,3,1,"det",37
"10","Sun","November 11","L","","6-3",FALSE,"Arizona Cardinals",21,31,16,247,265,-18,5,21,319,246,73,4,2007-11-11,-1,0,"det",-10
"11","Sun","November 18","L","","6-4",TRUE,"New York Giants",10,16,17,376,351,25,4,19,341,269,72,2,2007-11-18,-2,0,"det",-6
"12","Thu","November 22","L","","6-5",TRUE,"Green Bay Packers",26,37,25,331,197,134,1,25,481,381,100,1,2007-11-22,0,0,"det",-11
"13","Sun","December 2","L","","6-6",FALSE,"Minnesota Vikings",10,42,14,253,230,23,1,29,443,227,216,1,2007-12-02,0,0,"det",-32
"14","Sun","December 9","L","","6-7",TRUE,"Dallas Cowboys",27,28,25,390,238,152,0,25,368,281,87,1,2007-12-09,1,0,"det",-1
"15","Sun","December 16","L","","6-8",FALSE,"San Diego Chargers",14,51,19,328,302,26,6,26,416,142,274,0,2007-12-16,-6,0,"det",-37
"16","Sun","December 23","W","","7-8",TRUE,"Kansas City Chiefs",25,20,12,236,99,137,1,25,407,344,63,1,2007-12-23,0,1,"det",5
"17","Sun","December 30","L","","7-9",FALSE,"Green Bay Packers",13,34,16,293,246,47,2,19,394,177,217,1,2007-12-30,-1,0,"det",-21
"1","Sun","September 7","L","","0-1",FALSE,"Atlanta Falcons",21,34,21,316,246,70,1,23,474,156,318,0,2008-09-07,-1,0,"det",-13
"2","Sun","September 14","L","","0-2",TRUE,"Green Bay Packers",25,48,15,311,262,49,3,19,447,324,123,1,2008-09-14,-2,0,"det",-23
"3","Sun","September 21","L","","0-3",FALSE,"San Francisco 49ers",13,31,14,240,124,116,2,25,370,188,182,0,2008-09-21,-2,0,"det",-18
"5","Sun","October 5","L","","0-4",TRUE,"Chicago Bears",7,34,12,185,131,54,2,21,425,328,97,1,2008-10-05,-1,0,"det",-27
"6","Sun","October 12","L","","0-5",FALSE,"Minnesota Vikings",10,12,8,212,112,100,1,23,392,257,135,3,2008-10-12,2,0,"det",-2
"7","Sun","October 19","L","","0-6",FALSE,"Houston Texans",21,28,15,326,249,77,0,29,404,254,150,1,2008-10-19,1,0,"det",-7
"8","Sun","October 26","L","","0-7",TRUE,"Washington Redskins",17,25,13,274,217,57,0,22,439,304,135,1,2008-10-26,1,0,"det",-8
"9","Sun","November 2","L","","0-8",FALSE,"Chicago Bears",23,27,21,333,280,53,3,18,320,166,154,2,2008-11-02,-1,0,"det",-4
"10","Sun","November 9","L","","0-9",TRUE,"Jacksonville Jaguars",14,38,13,256,153,103,1,24,384,227,157,0,2008-11-09,-1,0,"det",-24
"11","Sun","November 16","L","","0-10",FALSE,"Carolina Panthers",22,31,20,316,186,130,4,16,362,98,264,1,2008-11-16,-3,0,"det",-9
"12","Sun","November 23","L","","0-11",TRUE,"Tampa Bay Buccaneers",20,38,9,207,99,108,3,15,255,139,116,3,2008-11-23,0,0,"det",-18
"13","Thu","November 27","L","","0-12",TRUE,"Tennessee Titans",10,47,6,154,131,23,3,19,456,164,292,1,2008-11-27,-2,0,"det",-37
"14","Sun","December 7","L","","0-13",TRUE,"Minnesota Vikings",16,20,15,268,191,77,0,20,301,168,133,2,2008-12-07,2,0,"det",-4
"15","Sun","December 14","L","","0-14",FALSE,"Indianapolis Colts",21,31,18,323,233,90,2,28,421,315,106,2,2008-12-14,0,0,"det",-10
"16","Sun","December 21","L","","0-15",TRUE,"New Orleans Saints",7,42,15,255,126,129,2,32,532,351,181,1,2008-12-21,-1,0,"det",-35
"17","Sun","December 28","L","","0-16",FALSE,"Green Bay Packers",21,31,19,316,220,96,2,20,484,273,211,1,2008-12-28,-1,0,"det",-10
"1","Sun","September 13","L","","0-1",FALSE,"New Orleans Saints",27,45,14,231,198,33,3,28,515,358,157,3,2009-09-13,0,0,"det",-18
"2","Sun","September 20","L","","0-2",TRUE,"Minnesota Vikings",13,27,17,265,136,129,3,18,265,153,112,1,2009-09-20,-2,0,"det",-14
"3","Sun","September 27","W","","1-2",TRUE,"Washington Redskins",19,14,23,381,227,154,0,22,390,325,65,1,2009-09-27,1,1,"det",5
"4","Sun","October 4","L","","1-3",FALSE,"Chicago Bears",24,48,25,398,308,90,2,14,276,125,151,0,2009-10-04,-2,0,"det",-24
"5","Sun","October 11","L","","1-4",TRUE,"Pittsburgh Steelers",20,28,21,335,225,110,1,18,344,262,82,1,2009-10-11,0,0,"det",-8
"6","Sun","October 18","L","","1-5",FALSE,"Green Bay Packers",0,26,10,149,71,78,3,23,435,328,107,2,2009-10-18,-1,0,"det",-26
"8","Sun","November 1","L","","1-6",TRUE,"St. Louis Rams",10,17,17,289,162,127,1,21,362,212,150,1,2009-11-01,0,0,"det",-7
"9","Sun","November 8","L","","1-7",FALSE,"Seattle Seahawks",20,32,17,300,186,114,5,25,397,342,55,2,2009-11-08,-3,0,"det",-12
"10","Sun","November 15","L","","1-8",FALSE,"Minnesota Vikings",10,27,19,297,204,93,1,19,492,340,152,2,2009-11-15,1,0,"det",-17
"11","Sun","November 22","W","","2-8",TRUE,"Cleveland Browns",38,37,26,473,416,57,2,22,439,308,131,0,2009-11-22,-2,1,"det",1
"12","Thu","November 26","L","","2-9",TRUE,"Green Bay Packers",12,34,16,272,199,73,5,20,422,342,80,2,2009-11-26,-3,0,"det",-22
"13","Sun","December 6","L","","2-10",FALSE,"Cincinnati Bengals",13,23,14,245,165,80,2,22,321,202,119,3,2009-12-06,1,0,"det",-10
"14","Sun","December 13","L","","2-11",FALSE,"Baltimore Ravens",3,48,13,229,126,103,2,24,548,240,308,1,2009-12-13,-1,0,"det",-45
"15","Sun","December 20","L","","2-12",TRUE,"Arizona Cardinals",24,31,15,282,121,161,3,21,340,218,122,3,2009-12-20,0,0,"det",-7
"16","Sun","December 27","L","","2-13",FALSE,"San Francisco 49ers",6,20,16,289,175,114,6,13,310,226,84,1,2009-12-27,-5,0,"det",-14
"17","Sun","January 3","L","","2-14",TRUE,"Chicago Bears",23,37,18,349,249,100,2,22,418,268,150,0,2010-01-03,-2,0,"det",-14
"1","Sun","September 12","L","","0-1",FALSE,"Chicago Bears",14,19,13,168,148,20,3,23,463,362,101,4,2010-09-12,1,0,"det",-5
"2","Sun","September 19","L","","0-2",TRUE,"Philadelphia Eagles",32,35,22,444,329,115,2,24,410,248,162,0,2010-09-19,-2,0,"det",-3
"3","Sun","September 26","L","","0-3",FALSE,"Minnesota Vikings",10,24,17,295,232,63,3,21,368,185,183,3,2010-09-26,0,0,"det",-14
"4","Sun","October 3","L","","0-4",FALSE,"Green Bay Packers",26,28,24,431,308,123,3,16,261,169,92,4,2010-10-03,1,0,"det",-2
"5","Sun","October 10","W","","1-4",TRUE,"St. Louis Rams",44,6,20,322,233,89,0,23,341,213,128,3,2010-10-10,3,1,"det",38
"6","Sun","October 17","L","","1-5",FALSE,"New York Giants",20,28,16,366,302,64,3,24,334,167,167,1,2010-10-17,-2,0,"det",-8
"8","Sun","October 31","W","","2-5",TRUE,"Washington Redskins",37,25,19,304,202,102,2,13,275,195,80,2,2010-10-31,0,1,"det",12
"9","Sun","November 7","L","OT","2-6",TRUE,"New York Jets",20,23,21,306,228,78,0,23,437,327,110,2,2010-11-07,2,0,"det",-3
"10","Sun","November 14","L","","2-7",FALSE,"Buffalo Bills",12,14,19,390,314,76,1,12,288,139,149,1,2010-11-14,0,0,"det",-2
"11","Sun","November 21","L","","2-8",FALSE,"Dallas Cowboys",19,35,17,338,263,75,2,19,265,131,134,1,2010-11-21,-1,0,"det",-16
"12","Thu","November 25","L","","2-9",TRUE,"New England Patriots",24,45,25,406,277,129,2,20,447,338,109,0,2010-11-25,-2,0,"det",-21
"13","Sun","December 5","L","","2-10",TRUE,"Chicago Bears",20,24,14,302,168,134,0,23,311,197,114,1,2010-12-05,1,0,"det",-4
"14","Sun","December 12","W","","3-10",TRUE,"Green Bay Packers",7,3,15,286,96,190,2,13,258,192,66,3,2010-12-12,1,1,"det",4
"15","Sun","December 19","W","OT","4-10",FALSE,"Tampa Bay Buccaneers",23,20,26,433,252,181,0,22,403,227,176,0,2010-12-19,0,1,"det",3
"16","Sun","December 26","W","","5-10",FALSE,"Miami Dolphins",34,27,14,275,208,67,0,28,425,271,154,3,2010-12-26,3,1,"det",7
"17","Sun","January 2","W","","6-10",TRUE,"Minnesota Vikings",20,13,22,357,250,107,2,16,211,137,74,1,2011-01-02,-1,1,"det",7
"1","Sun","September 11","W","","1-0",FALSE,"Tampa Bay Buccaneers",27,20,25,431,305,126,1,17,315,259,56,2,2011-09-11,1,1,"det",7
"2","Sun","September 18","W","","2-0",TRUE,"Kansas City Chiefs",48,3,23,411,322,89,1,12,267,116,151,6,2011-09-18,5,1,"det",45
"3","Sun","September 25","W","OT","3-0",FALSE,"Minnesota Vikings",26,23,19,358,338,20,0,16,321,189,132,0,2011-09-25,0,1,"det",3
"4","Sun","October 2","W","","4-0",FALSE,"Dallas Cowboys",34,30,18,303,240,63,1,25,434,321,113,3,2011-10-02,2,1,"det",4
"5","Mon","October 10","W","","5-0",TRUE,"Chicago Bears",24,13,16,395,214,181,1,23,359,237,122,0,2011-10-10,-1,1,"det",11
"6","Sun","October 16","L","","5-1",TRUE,"San Francisco 49ers",19,25,21,310,244,66,0,14,314,111,203,2,2011-10-16,2,0,"det",-6
"7","Sun","October 23","L","","5-2",TRUE,"Atlanta Falcons",16,23,13,263,159,104,1,22,328,199,129,2,2011-10-23,1,0,"det",-7
"8","Sun","October 30","W","","6-2",FALSE,"Denver Broncos",45,10,21,376,263,113,0,19,312,117,195,3,2011-10-30,3,1,"det",35
"10","Sun","November 13","L","","6-3",FALSE,"Chicago Bears",13,37,22,393,313,80,6,12,216,107,109,1,2011-11-13,-5,0,"det",-24
"11","Sun","November 20","W","","7-3",TRUE,"Carolina Panthers",49,35,29,495,326,169,3,24,409,272,137,4,2011-11-20,1,1,"det",14
"12","Thu","November 24","L","","7-4",TRUE,"Green Bay Packers",15,27,23,409,273,136,3,18,349,296,53,0,2011-11-24,-3,0,"det",-12
"13","Sun","December 4","L","","7-5",FALSE,"New Orleans Saints",17,31,25,466,379,87,1,21,438,338,100,0,2011-12-04,-1,0,"det",-14
"14","Sun","December 11","W","","8-5",TRUE,"Minnesota Vikings",34,28,13,280,208,72,0,29,425,156,269,6,2011-12-11,6,1,"det",6
"15","Sun","December 18","W","","9-5",FALSE,"Oakland Raiders",28,27,25,432,375,57,1,26,477,345,132,1,2011-12-18,0,1,"det",1
"16","Sat","December 24","W","","10-5",TRUE,"San Diego Chargers",38,10,24,440,353,87,0,20,367,299,68,2,2011-12-24,2,1,"det",28
"17","Sun","January 1","L","","10-6",FALSE,"Green Bay Packers",41,45,32,575,502,73,4,27,550,469,81,2,2012-01-01,-2,0,"det",-4
"WildCard","Sat","January 7","L","","10-7",FALSE,"New Orleans Saints",28,45,22,412,380,32,2,34,626,459,167,2,2012-01-07,0,0,"det",-17
"1","Sun","September 8","L","","0-1",TRUE,"Detroit Lions",27,28,21,300,140,160,1,16,286,156,130,2,1985-09-08,1,0,"atl",-1
"2","Sun","September 15","L","","0-2",FALSE,"San Francisco 49ers",16,35,18,253,130,123,1,23,380,184,196,1,1985-09-15,0,0,"atl",-19
"3","Sun","September 22","L","","0-3",TRUE,"Denver Broncos",28,44,16,341,233,108,2,27,428,280,148,2,1985-09-22,0,0,"atl",-16
"4","Sun","September 29","L","","0-4",FALSE,"Los Angeles Rams",6,17,18,258,154,104,1,14,283,177,106,0,1985-09-29,-1,0,"atl",-11
"5","Sun","October 6","L","","0-5",TRUE,"San Francisco 49ers",17,38,22,386,271,115,2,30,499,420,79,0,1985-10-06,-2,0,"atl",-21
"6","Sun","October 13","L","","0-6",FALSE,"Seattle Seahawks",26,30,20,350,187,163,1,22,421,358,63,3,1985-10-13,2,0,"atl",-4
"7","Sun","October 20","W","","1-6",TRUE,"New Orleans Saints",31,24,23,377,248,129,4,18,365,287,78,5,1985-10-20,1,1,"atl",7
"8","Sun","October 27","L","","1-7",FALSE,"Dallas Cowboys",10,24,18,253,91,162,4,28,461,352,109,4,1985-10-27,0,0,"atl",-14
"9","Sun","November 3","L","","1-8",TRUE,"Washington Redskins",10,44,14,298,129,169,1,24,461,154,307,0,1985-11-03,-1,0,"atl",-34
"10","Sun","November 10","L","OT","1-9",FALSE,"Philadelphia Eagles",17,23,20,310,94,216,2,15,330,235,95,2,1985-11-10,0,0,"atl",-6
"11","Sun","November 17","W","","2-9",TRUE,"Los Angeles Rams",30,14,22,290,132,158,1,9,177,132,45,5,1985-11-17,4,1,"atl",16
"12","Sun","November 24","L","","2-10",FALSE,"Chicago Bears",0,36,10,119,-22,141,3,24,379,183,196,1,1985-11-24,-2,0,"atl",-36
"13","Sun","December 1","L","","2-11",TRUE,"Los Angeles Raiders",24,34,16,365,235,130,3,20,388,211,177,1,1985-12-01,-2,0,"atl",-10
"14","Sun","December 8","L","","2-12",FALSE,"Kansas City Chiefs",10,38,21,354,93,261,3,21,369,205,164,1,1985-12-08,-2,0,"atl",-28
"15","Sun","December 15","W","","3-12",TRUE,"Minnesota Vikings",14,13,15,274,190,84,1,23,377,286,91,5,1985-12-15,4,1,"atl",1
"16","Sun","December 22","W","","4-12",FALSE,"New Orleans Saints",16,10,22,432,189,243,0,15,246,178,68,2,1985-12-22,2,1,"atl",6
"1","Sun","September 7","W","","1-0",FALSE,"New Orleans Saints",31,10,28,442,197,245,2,14,176,101,75,2,1986-09-07,0,1,"atl",21
"2","Sun","September 14","W","","2-0",TRUE,"St. Louis Cardinals",33,13,23,342,152,190,0,15,265,159,106,1,1986-09-14,1,1,"atl",20
"3","Sun","September 21","W","","3-0",FALSE,"Dallas Cowboys",37,35,26,420,233,187,1,22,415,263,152,4,1986-09-21,3,1,"atl",2
"4","Sun","September 28","W","OT","4-0",FALSE,"Tampa Bay Buccaneers",23,20,28,490,241,249,2,18,322,147,175,1,1986-09-28,-1,1,"atl",3
"5","Sun","October 5","L","","4-1",TRUE,"Philadelphia Eagles",0,16,15,228,173,55,3,15,309,212,97,1,1986-10-05,-2,0,"atl",-16
"6","Sun","October 12","W","","5-1",TRUE,"Los Angeles Rams",26,14,16,275,108,167,2,19,290,184,106,3,1986-10-12,1,1,"atl",12
"7","Sun","October 19","T","OT","5-1-1",TRUE,"San Francisco 49ers",10,10,21,356,139,217,5,17,254,139,115,3,1986-10-19,-2,0,"atl",0
"8","Sun","October 26","L","","5-2-1",FALSE,"Los Angeles Rams",7,14,8,151,55,96,3,18,335,101,234,5,1986-10-26,2,0,"atl",-7
"9","Sun","November 2","L","","5-3-1",FALSE,"New England Patriots",17,25,21,366,148,218,1,16,349,263,86,1,1986-11-02,0,0,"atl",-8
"10","Sun","November 9","L","","5-4-1",TRUE,"New York Jets",14,28,23,393,305,88,2,22,426,322,104,0,1986-11-09,-2,0,"atl",-14
"11","Sun","November 16","L","","5-5-1",TRUE,"Chicago Bears",10,13,11,159,41,118,3,15,368,203,165,3,1986-11-16,0,0,"atl",-3
"12","Sun","November 23","L","","5-6-1",FALSE,"San Francisco 49ers",0,20,12,229,154,75,1,21,365,210,155,0,1986-11-23,-1,0,"atl",-20
"13","Sun","November 30","W","","6-6-1",FALSE,"Miami Dolphins",20,14,13,362,143,219,1,16,375,303,72,4,1986-11-30,3,1,"atl",6
"14","Sun","December 7","L","","6-7-1",TRUE,"Indianapolis Colts",23,28,25,408,189,219,3,14,225,151,74,3,1986-12-07,0,0,"atl",-5
"15","Sun","December 14","L","","6-8-1",TRUE,"New Orleans Saints",9,14,18,247,185,62,3,14,241,161,80,1,1986-12-14,-2,0,"atl",-5
"16","Sun","December 21","W","","7-8-1",FALSE,"Detroit Lions",20,6,17,238,119,119,1,12,193,73,120,4,1986-12-21,3,1,"atl",14
"1","Sun","September 13","L","","0-1",FALSE,"Tampa Bay Buccaneers",10,48,13,197,134,63,3,30,460,333,127,2,1987-09-13,-1,0,"atl",-38
"2","Sun","September 20","W","","1-1",TRUE,"Washington Redskins",21,20,18,394,269,125,1,21,335,190,145,3,1987-09-20,2,1,"atl",1
"3","Sun","October 4","L","","1-2",TRUE,"Pittsburgh Steelers",12,28,13,215,148,67,4,19,361,219,142,3,1987-10-04,-1,0,"atl",-16
"4","Sun","October 11","L","","1-3",TRUE,"San Francisco 49ers",17,25,20,238,188,50,2,20,361,122,239,1,1987-10-11,-1,0,"atl",-8
"5","Sun","October 18","W","","2-3",TRUE,"Los Angeles Rams",24,20,22,342,296,46,5,21,350,164,186,4,1987-10-18,-1,1,"atl",4
"6","Sun","October 25","L","","2-4",FALSE,"Houston Oilers",33,37,14,304,183,121,5,24,439,234,205,2,1987-10-25,-3,0,"atl",-4
"7","Sun","November 1","L","","2-5",TRUE,"New Orleans Saints",0,38,12,183,128,55,5,29,410,166,244,0,1987-11-01,-5,0,"atl",-38
"8","Sun","November 8","L","","2-6",FALSE,"Cleveland Browns",3,38,13,243,126,117,2,24,365,192,173,1,1987-11-08,-1,0,"atl",-35
"9","Sun","November 15","L","","2-7",TRUE,"Cincinnati Bengals",10,16,13,266,147,119,2,27,416,146,270,2,1987-11-15,0,0,"atl",-6
"10","Sun","November 22","L","","2-8",FALSE,"Minnesota Vikings",13,24,16,290,194,96,1,18,302,169,133,1,1987-11-22,0,0,"atl",-11
"11","Sun","November 29","L","","2-9",TRUE,"St. Louis Cardinals",21,34,18,267,147,120,4,24,476,363,113,2,1987-11-29,-2,0,"atl",-13
"12","Sun","December 6","W","","3-9",FALSE,"Dallas Cowboys",21,10,18,364,253,111,4,24,354,263,91,3,1987-12-06,-1,1,"atl",11
"13","Sun","December 13","L","","3-10",FALSE,"Los Angeles Rams",0,33,13,269,210,59,2,28,494,256,238,0,1987-12-13,-2,0,"atl",-33
"14","Sun","December 20","L","","3-11",FALSE,"San Francisco 49ers",7,35,13,216,165,51,4,26,461,206,255,1,1987-12-20,-3,0,"atl",-28
"15","Sun","December 27","L","","3-12",TRUE,"Detroit Lions",13,30,14,278,180,98,5,19,323,150,173,2,1987-12-27,-3,0,"atl",-17
"1","Sun","September 4","L","","0-1",FALSE,"Detroit Lions",17,31,26,359,187,172,4,19,230,88,142,1,1988-09-04,-3,0,"atl",-14
"2","Sun","September 11","L","","0-2",TRUE,"New Orleans Saints",21,29,19,307,146,161,4,25,434,222,212,4,1988-09-11,0,0,"atl",-8
"3","Sun","September 18","W","","1-2",FALSE,"San Francisco 49ers",34,17,19,367,171,196,2,22,426,322,104,4,1988-09-18,2,1,"atl",17
"4","Sun","September 25","L","","1-3",FALSE,"Dallas Cowboys",20,26,15,314,207,107,2,17,323,210,113,1,1988-09-25,-1,0,"atl",-6
"5","Sun","October 2","L","","1-4",TRUE,"Seattle Seahawks",20,31,18,385,245,140,4,22,317,149,168,1,1988-10-02,-3,0,"atl",-11
"6","Sun","October 9","L","","1-5",TRUE,"Los Angeles Rams",0,33,12,150,77,73,2,27,501,249,252,1,1988-10-09,-1,0,"atl",-33
"7","Sun","October 16","L","","1-6",FALSE,"Denver Broncos",14,30,20,311,137,174,3,21,406,302,104,1,1988-10-16,-2,0,"atl",-16
"8","Sun","October 23","L","","1-7",TRUE,"New York Giants",16,23,23,368,216,152,2,22,346,225,121,3,1988-10-23,1,0,"atl",-7
"9","Sun","October 30","W","","2-7",FALSE,"Philadelphia Eagles",27,24,11,294,202,92,1,25,424,269,155,3,1988-10-30,2,1,"atl",3
"10","Sun","November 6","W","","3-7",TRUE,"Green Bay Packers",20,0,18,341,177,164,3,13,284,183,101,7,1988-11-06,4,1,"atl",20
"11","Sun","November 13","L","","3-8",TRUE,"San Diego Chargers",7,10,13,245,188,57,2,15,355,170,185,2,1988-11-13,0,0,"atl",-3
"12","Sun","November 20","W","","4-8",FALSE,"Los Angeles Raiders",12,6,17,280,150,130,2,9,212,147,65,2,1988-11-20,0,1,"atl",6
"13","Sun","November 27","W","","5-8",TRUE,"Tampa Bay Buccaneers",17,10,16,289,108,181,2,16,313,186,127,4,1988-11-27,2,1,"atl",7
"14","Sun","December 4","L","","5-9",TRUE,"San Francisco 49ers",3,13,8,177,134,43,1,20,378,238,140,0,1988-12-04,-1,0,"atl",-10
"15","Sun","December 11","L","","5-10",FALSE,"Los Angeles Rams",7,22,9,193,128,65,2,21,418,291,127,2,1988-12-11,0,0,"atl",-15
"16","Sun","December 18","L","","5-11",FALSE,"New Orleans Saints",9,10,13,202,93,109,1,18,325,122,203,2,1988-12-18,1,0,"atl",-1
"1","Sun","September 10","L","","0-1",TRUE,"Los Angeles Rams",21,31,16,314,271,43,0,21,363,195,168,1,1989-09-10,1,0,"atl",-10
"2","Sun","September 17","W","","1-1",TRUE,"Dallas Cowboys",27,21,23,333,243,90,0,18,349,241,108,3,1989-09-17,3,1,"atl",6
"3","Sun","September 24","L","","1-2",FALSE,"Indianapolis Colts",9,13,11,208,103,105,3,15,214,84,130,1,1989-09-24,-2,0,"atl",-4
"4","Sun","October 1","L","","1-3",FALSE,"Green Bay Packers",21,23,17,333,258,75,1,27,448,295,153,2,1989-10-01,1,0,"atl",-2
"5","Sun","October 8","L","","1-4",FALSE,"Los Angeles Rams",14,26,19,353,315,38,1,21,438,273,165,1,1989-10-08,0,0,"atl",-12
"6","Sun","October 15","W","","2-4",TRUE,"New England Patriots",16,15,14,312,240,72,2,13,241,148,93,4,1989-10-15,2,1,"atl",1
"7","Sun","October 22","L","","2-5",FALSE,"Phoenix Cardinals",20,34,22,351,240,111,2,21,299,174,125,1,1989-10-22,-1,0,"atl",-14
"8","Sun","October 29","L","","2-6",FALSE,"New Orleans Saints",13,20,11,148,91,57,3,17,392,261,131,2,1989-10-29,-1,0,"atl",-7
"9","Sun","November 5","W","","3-6",TRUE,"Buffalo Bills",30,28,20,340,213,127,0,19,329,211,118,2,1989-11-05,2,1,"atl",2
"10","Sun","November 12","L","","3-7",FALSE,"San Francisco 49ers",3,45,11,192,119,73,1,30,515,280,235,2,1989-11-12,1,0,"atl",-42
"11","Sun","November 19","L","","3-8",TRUE,"New Orleans Saints",17,26,15,267,190,77,1,21,354,148,206,4,1989-11-19,3,0,"atl",-9
"12","Sun","November 26","L","","3-9",FALSE,"New York Jets",7,27,12,213,147,66,1,24,318,138,180,2,1989-11-26,1,0,"atl",-20
"13","Sun","December 3","L","","3-10",TRUE,"San Francisco 49ers",10,23,13,263,226,37,2,23,425,296,129,1,1989-12-03,-1,0,"atl",-13
"14","Sun","December 10","L","","3-11",FALSE,"Minnesota Vikings",17,43,15,255,188,67,3,23,457,237,220,1,1989-12-10,-2,0,"atl",-26
"15","Sun","December 17","L","","3-12",TRUE,"Washington Redskins",30,31,15,374,346,28,2,26,507,376,131,3,1989-12-17,1,0,"atl",-1
"16","Sun","December 24","L","","3-13",TRUE,"Detroit Lions",24,31,27,413,324,89,1,17,376,197,179,2,1989-12-24,1,0,"atl",-7
"1","Sun","September 9","W","","1-0",TRUE,"Houston Oilers",47,27,19,301,206,95,2,28,418,389,29,6,1990-09-09,4,1,"atl",20
"2","Sun","September 16","L","","1-1",FALSE,"Detroit Lions",14,21,14,295,173,122,1,17,264,181,83,2,1990-09-16,1,0,"atl",-7
"3","Sun","September 23","L","","1-2",FALSE,"San Francisco 49ers",13,19,18,369,320,49,3,17,445,379,66,1,1990-09-23,-2,0,"atl",-6
"5","Sun","October 7","W","","2-2",TRUE,"New Orleans Saints",28,27,25,457,366,91,2,15,293,218,75,1,1990-10-07,-1,1,"atl",1
"6","Sun","October 14","L","","2-3",TRUE,"San Francisco 49ers",35,45,21,394,365,29,2,30,492,442,50,2,1990-10-14,0,0,"atl",-10
"7","Sun","October 21","L","","2-4",FALSE,"Los Angeles Rams",24,44,12,315,236,79,3,26,431,302,129,0,1990-10-21,-3,0,"atl",-20
"8","Sun","October 28","W","","3-4",TRUE,"Cincinnati Bengals",38,17,17,299,124,175,0,21,309,225,84,4,1990-10-28,4,1,"atl",21
"9","Sun","November 4","L","","3-5",FALSE,"Pittsburgh Steelers",9,21,21,332,239,93,5,10,333,214,119,3,1990-11-04,-2,0,"atl",-12
"10","Sun","November 11","L","","3-6",FALSE,"Chicago Bears",24,30,17,276,227,49,5,19,287,187,100,2,1990-11-11,-3,0,"atl",-6
"11","Sun","November 18","L","","3-7",TRUE,"Philadelphia Eagles",23,24,16,315,256,59,1,16,279,191,88,2,1990-11-18,1,0,"atl",-1
"12","Sun","November 25","L","","3-8",FALSE,"New Orleans Saints",7,10,9,226,167,59,1,19,258,173,85,1,1990-11-25,0,0,"atl",-3
"13","Sun","December 2","L","","3-9",FALSE,"Tampa Bay Buccaneers",17,23,22,374,152,222,4,16,373,331,42,3,1990-12-02,-1,0,"atl",-6
"14","Sun","December 9","L","","3-10",TRUE,"Phoenix Cardinals",13,24,15,318,222,96,4,20,361,216,145,2,1990-12-09,-2,0,"atl",-11
"15","Sun","December 16","L","","3-11",FALSE,"Cleveland Browns",10,13,16,260,179,81,0,20,348,206,142,2,1990-12-16,2,0,"atl",-3
"16","Sun","December 23","W","","4-11",TRUE,"Los Angeles Rams",20,13,16,281,170,111,3,18,228,155,73,2,1990-12-23,-1,1,"atl",7
"17","Sun","December 30","W","","5-11",TRUE,"Dallas Cowboys",26,7,15,243,59,184,3,8,151,104,47,2,1990-12-30,-1,1,"atl",19
"1","Sun","September 1","L","","0-1",FALSE,"Kansas City Chiefs",3,14,13,243,102,141,6,17,291,139,152,1,1991-09-01,-5,0,"atl",-11
"2","Sun","September 8","L","","0-2",TRUE,"Minnesota Vikings",19,20,23,439,280,159,2,17,290,157,133,2,1991-09-08,0,0,"atl",-1
"3","Sun","September 15","W","","1-2",FALSE,"San Diego Chargers",13,10,18,317,195,122,1,13,313,129,184,1,1991-09-15,0,1,"atl",3
"4","Sun","September 22","W","","2-2",TRUE,"Los Angeles Raiders",21,17,16,320,240,80,4,12,159,87,72,3,1991-09-22,-1,1,"atl",4
"5","Sun","September 29","L","","2-3",TRUE,"New Orleans Saints",6,27,8,162,129,33,2,17,367,197,170,1,1991-09-29,-1,0,"atl",-21
"7","Sun","October 13","W","","3-3",FALSE,"San Francisco 49ers",39,34,19,368,208,160,0,24,437,343,94,4,1991-10-13,4,1,"atl",5
"8","Sun","October 20","L","","3-4",FALSE,"Phoenix Cardinals",10,16,15,318,211,107,5,16,266,98,168,2,1991-10-20,-3,0,"atl",-6
"9","Sun","October 27","W","","4-4",TRUE,"Los Angeles Rams",31,14,16,399,278,121,1,13,209,109,100,1,1991-10-27,0,1,"atl",17
"10","Sun","November 3","W","","5-4",TRUE,"San Francisco 49ers",17,14,11,202,127,75,1,19,396,267,129,3,1991-11-03,2,1,"atl",3
"11","Sun","November 10","L","","5-5",FALSE,"Washington Redskins",17,56,12,271,209,62,6,20,559,451,108,0,1991-11-10,-6,0,"atl",-39
"12","Sun","November 17","W","","6-5",TRUE,"Tampa Bay Buccaneers",43,7,20,358,226,132,0,15,249,207,42,3,1991-11-17,3,1,"atl",36
"13","Sun","November 24","W","OT","7-5",FALSE,"New Orleans Saints",23,20,12,331,240,91,4,20,419,255,164,3,1991-11-24,-1,1,"atl",3
"14","Sun","December 1","W","","8-5",TRUE,"Green Bay Packers",35,31,23,352,273,79,1,22,393,261,132,2,1991-12-01,1,1,"atl",4
"15","Sun","December 8","W","","9-5",FALSE,"Los Angeles Rams",31,14,21,359,275,84,1,15,274,165,109,2,1991-12-08,1,1,"atl",17
"16","Sun","December 15","W","","10-5",TRUE,"Seattle Seahawks",26,13,14,271,140,131,1,14,235,202,33,3,1991-12-15,2,1,"atl",13
"17","Sun","December 22","L","","10-6",FALSE,"Dallas Cowboys",27,31,17,403,316,87,1,24,391,228,163,4,1991-12-22,3,0,"atl",-4
"WildCard","Sat","December 28","W","","11-6",FALSE,"New Orleans Saints",27,20,20,334,255,79,2,23,330,265,65,3,1991-12-28,1,1,"atl",7
"Division","Sat","January 4","L","","11-7",FALSE,"Washington Redskins",7,24,12,193,150,43,6,22,332,170,162,1,1992-01-04,-5,0,"atl",-17
"1","Sun","September 6","W","","1-0",TRUE,"New York Jets",20,17,17,306,189,117,0,21,411,343,68,2,1992-09-06,2,1,"atl",3
"2","Sun","September 13","L","","1-1",FALSE,"Washington Redskins",17,24,7,266,232,34,1,24,343,169,174,2,1992-09-13,1,0,"atl",-7
"3","Sun","September 20","L","","1-2",TRUE,"New Orleans Saints",7,10,19,278,181,97,2,13,229,108,121,0,1992-09-20,-2,0,"atl",-3
"4","Sun","September 27","L","","1-3",FALSE,"Chicago Bears",31,41,19,348,324,24,1,23,489,272,217,0,1992-09-27,-1,0,"atl",-10
"5","Sun","October 4","W","","2-3",TRUE,"Green Bay Packers",24,10,17,268,166,102,0,21,338,261,77,2,1992-10-04,2,1,"atl",14
"6","Sun","October 11","L","","2-4",FALSE,"Miami Dolphins",17,21,19,323,254,69,2,22,346,248,98,1,1992-10-11,-1,0,"atl",-4
"7","Sun","October 18","L","","2-5",FALSE,"San Francisco 49ers",17,56,18,297,250,47,2,29,590,399,191,1,1992-10-18,-1,0,"atl",-39
"9","Sun","November 1","W","","3-5",TRUE,"Los Angeles Rams",30,28,19,350,214,136,2,19,359,212,147,2,1992-11-01,0,1,"atl",2
"10","Mon","November 9","L","","3-6",TRUE,"San Francisco 49ers",3,41,20,304,245,59,6,16,303,151,152,0,1992-11-09,-6,0,"atl",-38
"11","Sun","November 15","W","","4-6",TRUE,"Phoenix Cardinals",20,17,19,337,223,114,3,15,271,239,32,4,1992-11-15,1,1,"atl",3
"12","Sun","November 22","L","","4-7",FALSE,"Buffalo Bills",14,41,11,174,128,46,1,19,412,97,315,1,1992-11-22,0,0,"atl",-27
"13","Sun","November 29","W","","5-7",TRUE,"New England Patriots",34,0,17,253,112,141,0,8,105,15,90,4,1992-11-29,4,1,"atl",34
"14","Thu","December 3","L","","5-8",FALSE,"New Orleans Saints",14,22,10,168,92,76,3,22,388,244,144,2,1992-12-03,-1,0,"atl",-8
"15","Sun","December 13","W","","6-8",FALSE,"Tampa Bay Buccaneers",35,7,20,413,327,86,0,17,254,150,104,1,1992-12-13,1,1,"atl",28
"16","Mon","December 21","L","","6-9",TRUE,"Dallas Cowboys",17,41,18,373,333,40,3,19,435,239,196,0,1992-12-21,-3,0,"atl",-24
"17","Sun","December 27","L","","6-10",FALSE,"Los Angeles Rams",27,38,23,445,363,82,3,16,276,108,168,1,1992-12-27,-2,0,"atl",-11
"1","Sun","September 5","L","","0-1",FALSE,"Detroit Lions",13,30,12,237,216,21,3,12,262,166,96,0,1993-09-05,-3,0,"atl",-17
"2","Sun","September 12","L","","0-2",TRUE,"New Orleans Saints",31,34,20,375,297,78,2,24,557,330,227,1,1993-09-12,-1,0,"atl",-3
"3","Sun","September 19","L","","0-3",FALSE,"San Francisco 49ers",30,37,24,381,187,194,1,23,478,210,268,2,1993-09-19,1,0,"atl",-7
"4","Mon","September 27","L","","0-4",TRUE,"Pittsburgh Steelers",17,45,16,220,176,44,6,22,368,259,109,1,1993-09-27,-5,0,"atl",-28
"5","Sun","October 3","L","","0-5",FALSE,"Chicago Bears",0,6,16,271,184,87,3,14,220,114,106,0,1993-10-03,-3,0,"atl",-6
"7","Thu","October 14","W","","1-5",TRUE,"Los Angeles Rams",30,24,16,311,208,103,1,22,450,283,167,3,1993-10-14,2,1,"atl",6
"8","Sun","October 24","W","","2-5",FALSE,"New Orleans Saints",26,15,17,279,156,123,0,16,321,274,47,2,1993-10-24,2,1,"atl",11
"9","Sun","October 31","L","","2-6",TRUE,"Tampa Bay Buccaneers",24,31,16,337,269,68,3,16,405,307,98,2,1993-10-31,-1,0,"atl",-7
"11","Sun","November 14","W","","3-6",FALSE,"Los Angeles Rams",13,0,15,319,182,137,2,14,260,165,95,3,1993-11-14,1,1,"atl",13
"12","Sun","November 21","W","","4-6",TRUE,"Dallas Cowboys",27,14,22,400,315,85,1,13,230,182,48,0,1993-11-21,-1,1,"atl",13
"13","Sun","November 28","W","","5-6",TRUE,"Cleveland Browns",17,14,13,261,194,67,1,16,306,191,115,1,1993-11-28,0,1,"atl",3
"14","Sun","December 5","L","","5-7",FALSE,"Houston Oilers",17,33,25,333,296,37,7,18,388,336,52,3,1993-12-05,-4,0,"atl",-16
"15","Sat","December 11","W","","6-7",TRUE,"San Francisco 49ers",27,24,20,362,270,92,1,22,330,251,79,4,1993-12-11,3,1,"atl",3
"16","Sun","December 19","L","","6-8",FALSE,"Washington Redskins",17,30,22,378,196,182,6,8,167,129,38,2,1993-12-19,-4,0,"atl",-13
"17","Sun","December 26","L","","6-9",FALSE,"Cincinnati Bengals",17,21,22,376,185,191,1,16,284,162,122,0,1993-12-26,-1,0,"atl",-4
"18","Sun","January 2","L","","6-10",TRUE,"Phoenix Cardinals",10,27,16,270,189,81,4,22,395,278,117,0,1994-01-02,-4,0,"atl",-17
"1","Sun","September 4","L","OT","0-1",FALSE,"Detroit Lions",28,31,22,389,271,118,0,21,352,203,149,1,1994-09-04,1,0,"atl",-3
"2","Sun","September 11","W","","1-1",TRUE,"Los Angeles Rams",31,13,24,428,304,124,2,20,421,281,140,4,1994-09-11,2,1,"atl",18
"3","Sun","September 18","L","","1-2",TRUE,"Kansas City Chiefs",10,30,21,384,284,100,6,22,427,361,66,4,1994-09-18,-2,0,"atl",-20
"4","Sun","September 25","W","","2-2",FALSE,"Washington Redskins",27,20,19,309,238,71,1,18,354,310,44,5,1994-09-25,4,1,"atl",7
"5","Sun","October 2","W","","3-2",FALSE,"Los Angeles Rams",8,5,23,366,285,81,1,16,246,120,126,2,1994-10-02,1,1,"atl",3
"6","Sun","October 9","W","","4-2",TRUE,"Tampa Bay Buccaneers",34,13,20,356,271,85,3,19,320,288,32,3,1994-10-09,0,1,"atl",21
"7","Sun","October 16","L","","4-3",TRUE,"San Francisco 49ers",3,42,17,254,192,62,6,16,281,180,101,0,1994-10-16,-6,0,"atl",-39
"8","Sun","October 23","L","","4-4",FALSE,"Los Angeles Raiders",17,30,15,255,185,70,2,21,313,197,116,1,1994-10-23,-1,0,"atl",-13
"10","Sun","November 6","W","","5-4",TRUE,"San Diego Chargers",10,9,11,219,176,43,2,20,296,179,117,0,1994-11-06,-2,1,"atl",1
"11","Sun","November 13","L","","5-5",FALSE,"New Orleans Saints",32,33,21,389,317,72,1,30,429,276,153,5,1994-11-13,4,0,"atl",-1
"12","Sun","November 20","L","","5-6",FALSE,"Denver Broncos",28,32,16,330,254,76,0,25,425,336,89,2,1994-11-20,2,0,"atl",-4
"13","Sun","November 27","W","","6-6",TRUE,"Philadelphia Eagles",28,21,24,418,354,64,3,14,318,203,115,2,1994-11-27,-1,1,"atl",7
"14","Sun","December 4","L","","6-7",FALSE,"San Francisco 49ers",14,50,12,248,205,43,5,28,476,315,161,1,1994-12-04,-4,0,"atl",-36
"15","Sun","December 11","L","","6-8",TRUE,"New Orleans Saints",20,29,23,376,284,92,1,19,402,264,138,0,1994-12-11,-1,0,"atl",-9
"16","Sun","December 18","L","","6-9",FALSE,"Green Bay Packers",17,21,22,333,236,97,2,23,384,310,74,1,1994-12-18,-1,0,"atl",-4
"17","Sat","December 24","W","","7-9",TRUE,"Arizona Cardinals",10,6,12,307,256,51,1,18,385,313,72,2,1994-12-24,1,1,"atl",4
"1","Sun","September 3","W","OT","1-0",TRUE,"Carolina Panthers",23,20,20,391,274,117,3,17,312,261,51,1,1995-09-03,-2,1,"atl",3
"2","Sun","September 10","L","","1-1",FALSE,"San Francisco 49ers",10,41,15,267,242,25,3,28,489,331,158,1,1995-09-10,-2,0,"atl",-31
"3","Sun","September 17","W","OT","2-1",FALSE,"New Orleans Saints",27,24,24,461,337,124,1,18,410,360,50,1,1995-09-17,0,1,"atl",3
"4","Sun","September 24","W","","3-1",TRUE,"New York Jets",13,3,24,348,200,148,2,16,270,176,94,4,1995-09-24,2,1,"atl",10
"5","Sun","October 1","W","","4-1",TRUE,"New England Patriots",30,17,19,375,288,87,2,17,332,224,108,3,1995-10-01,1,1,"atl",13
"7","Thu","October 12","L","","4-2",FALSE,"St. Louis Rams",19,21,10,192,148,44,0,24,451,318,133,2,1995-10-12,2,0,"atl",-2
"8","Sun","October 22","W","","5-2",FALSE,"Tampa Bay Buccaneers",24,21,23,389,268,121,1,16,258,169,89,0,1995-10-22,-1,1,"atl",3
"9","Sun","October 29","L","","5-3",TRUE,"Dallas Cowboys",13,28,16,258,158,100,0,23,380,194,186,1,1995-10-29,1,0,"atl",-15
"10","Sun","November 5","W","","6-3",TRUE,"Detroit Lions",34,22,30,434,349,85,1,19,375,314,61,2,1995-11-05,1,1,"atl",12
"11","Sun","November 12","L","","6-4",FALSE,"Buffalo Bills",17,23,18,319,252,67,2,27,415,261,154,2,1995-11-12,0,0,"atl",-6
"12","Sun","November 19","W","","7-4",TRUE,"St. Louis Rams",31,6,22,440,325,115,0,19,351,280,71,3,1995-11-19,3,1,"atl",25
"13","Sun","November 26","L","OT","7-5",FALSE,"Arizona Cardinals",37,40,15,294,260,34,4,28,513,392,121,4,1995-11-26,0,0,"atl",-3
"14","Sun","December 3","L","","7-6",FALSE,"Miami Dolphins",20,21,18,296,204,92,0,29,428,343,85,2,1995-12-03,2,0,"atl",-1
"15","Sun","December 10","W","","8-6",TRUE,"New Orleans Saints",19,14,18,333,242,91,0,21,342,287,55,1,1995-12-10,1,1,"atl",5
"16","Sun","December 17","L","","8-7",FALSE,"Carolina Panthers",17,21,25,419,332,87,2,15,328,283,45,2,1995-12-17,0,0,"atl",-4
"17","Sun","December 24","W","","9-7",TRUE,"San Francisco 49ers",28,27,20,363,307,56,0,23,434,348,86,1,1995-12-24,1,1,"atl",1
"WildCard","Sun","December 31","L","","9-8",FALSE,"Green Bay Packers",20,37,18,360,339,21,2,23,307,190,117,0,1995-12-31,-2,0,"atl",-17
"1","Sun","September 1","L","","0-1",FALSE,"Carolina Panthers",6,29,12,281,162,119,1,23,315,186,129,1,1996-09-01,0,0,"atl",-23
"2","Sun","September 8","L","","0-2",TRUE,"Minnesota Vikings",17,23,21,324,245,79,2,18,365,266,99,2,1996-09-08,0,0,"atl",-6
"4","Sun","September 22","L","","0-3",TRUE,"Philadelphia Eagles",18,33,18,391,351,40,6,14,318,195,123,1,1996-09-22,-5,0,"atl",-15
"5","Sun","September 29","L","","0-4",FALSE,"San Francisco 49ers",17,39,18,317,191,126,4,16,396,246,150,0,1996-09-29,-4,0,"atl",-22
"6","Sun","October 6","L","","0-5",FALSE,"Detroit Lions",24,28,19,281,165,116,1,23,357,262,95,1,1996-10-06,0,0,"atl",-4
"7","Sun","October 13","L","","0-6",TRUE,"Houston Oilers",13,23,20,323,268,55,2,16,320,199,121,1,1996-10-13,-1,0,"atl",-10
"8","Sun","October 20","L","","0-7",FALSE,"Dallas Cowboys",28,32,22,369,256,113,0,17,306,250,56,2,1996-10-20,2,0,"atl",-4
"9","Sun","October 27","L","","0-8",TRUE,"Pittsburgh Steelers",17,20,19,301,234,67,1,20,311,184,127,0,1996-10-27,-1,0,"atl",-3
"10","Sun","November 3","W","","1-8",TRUE,"Carolina Panthers",20,17,16,313,189,124,2,17,347,243,104,3,1996-11-03,1,1,"atl",3
"11","Sun","November 10","L","","1-9",FALSE,"St. Louis Rams",16,59,15,292,248,44,3,29,464,185,279,1,1996-11-10,-2,0,"atl",-43
"12","Sun","November 17","W","","2-9",TRUE,"New Orleans Saints",17,15,18,293,219,74,1,15,270,235,35,3,1996-11-17,2,1,"atl",2
"13","Sun","November 24","L","","2-10",FALSE,"Cincinnati Bengals",31,41,21,417,305,112,4,24,463,342,121,0,1996-11-24,-4,0,"atl",-10
"14","Mon","December 2","L","","2-11",TRUE,"San Francisco 49ers",10,34,9,178,117,61,4,25,466,264,202,2,1996-12-02,-2,0,"atl",-24
"15","Sun","December 8","W","","3-11",FALSE,"New Orleans Saints",31,15,19,304,182,122,3,14,251,168,83,2,1996-12-08,-1,1,"atl",16
"16","Sun","December 15","L","","3-12",TRUE,"St. Louis Rams",27,34,24,423,360,63,7,17,480,306,174,4,1996-12-15,-3,0,"atl",-7
"17","Sun","December 22","L","","3-13",FALSE,"Jacksonville Jaguars",17,19,21,309,163,146,0,21,357,214,143,0,1996-12-22,0,0,"atl",-2
"1","Sun","August 31","L","","0-1",FALSE,"Detroit Lions",17,28,13,323,268,55,4,10,221,175,46,3,1997-08-31,-1,0,"atl",-11
"2","Sun","September 7","L","","0-2",TRUE,"Carolina Panthers",6,9,8,210,162,48,2,21,321,228,93,2,1997-09-07,0,0,"atl",-3
"3","Sun","September 14","L","","0-3",TRUE,"Oakland Raiders",31,36,24,366,250,116,2,11,414,265,149,1,1997-09-14,-1,0,"atl",-5
"4","Sun","September 21","L","","0-4",FALSE,"San Francisco 49ers",7,34,15,211,154,57,1,18,424,353,71,0,1997-09-21,-1,0,"atl",-27
"5","Sun","September 28","L","","0-5",TRUE,"Denver Broncos",21,29,17,308,196,112,1,16,329,228,101,1,1997-09-28,0,0,"atl",-8
"7","Sun","October 12","W","","1-5",FALSE,"New Orleans Saints",23,17,14,166,77,89,2,13,179,99,80,4,1997-10-12,2,1,"atl",6
"8","Sun","October 19","L","","1-6",TRUE,"San Francisco 49ers",28,35,19,292,253,39,0,24,438,241,197,1,1997-10-19,1,0,"atl",-7
"9","Sun","October 26","L","","1-7",FALSE,"Carolina Panthers",12,21,17,301,233,68,3,14,228,91,137,3,1997-10-26,0,0,"atl",-9
"10","Sun","November 2","W","","2-7",TRUE,"St. Louis Rams",34,31,28,462,265,197,1,24,507,399,108,1,1997-11-02,0,1,"atl",3
"11","Sun","November 9","L","","2-8",TRUE,"Tampa Bay Buccaneers",10,31,18,275,173,102,2,20,349,150,199,0,1997-11-09,-2,0,"atl",-21
"12","Sun","November 16","W","","3-8",FALSE,"St. Louis Rams",27,21,22,314,214,100,2,22,330,242,88,0,1997-11-16,-2,1,"atl",6
"13","Sun","November 23","W","","4-8",TRUE,"New Orleans Saints",20,3,16,269,177,92,1,11,173,118,55,5,1997-11-23,4,1,"atl",17
"14","Sun","November 30","W","","5-8",FALSE,"Seattle Seahawks",24,17,14,273,201,72,0,19,351,228,123,1,1997-11-30,1,1,"atl",7
"15","Sun","December 7","W","","6-8",FALSE,"San Diego Chargers",14,3,13,204,108,96,1,16,268,221,47,3,1997-12-07,2,1,"atl",11
"16","Sun","December 14","W","","7-8",TRUE,"Philadelphia Eagles",20,17,21,386,175,211,1,15,277,171,106,1,1997-12-14,0,1,"atl",3
"17","Sun","December 21","L","","7-9",FALSE,"Arizona Cardinals",26,29,22,356,167,189,1,20,297,231,66,2,1997-12-21,1,0,"atl",-3
"1","Sun","September 6","W","","1-0",FALSE,"Carolina Panthers",19,14,19,323,230,93,1,16,317,263,54,2,1998-09-06,1,1,"atl",5
"2","Sun","September 13","W","","2-0",TRUE,"Philadelphia Eagles",17,12,17,245,167,78,0,19,284,221,63,0,1998-09-13,0,1,"atl",5
"4","Sun","September 27","L","","2-1",FALSE,"San Francisco 49ers",20,31,19,369,222,147,4,23,538,377,161,2,1998-09-27,-2,0,"atl",-11
"5","Sun","October 4","W","","3-1",TRUE,"Carolina Panthers",51,23,18,323,193,130,2,16,346,289,57,6,1998-10-04,4,1,"atl",28
"6","Sun","October 11","W","","4-1",FALSE,"New York Giants",34,20,20,381,253,128,2,17,266,156,110,3,1998-10-11,1,1,"atl",14
"7","Sun","October 18","W","","5-1",TRUE,"New Orleans Saints",31,23,19,297,163,134,0,15,322,255,67,4,1998-10-18,4,1,"atl",8
"8","Sun","October 25","L","","5-2",FALSE,"New York Jets",3,28,13,207,152,55,3,21,311,192,119,0,1998-10-25,-3,0,"atl",-25
"9","Sun","November 1","W","","6-2",TRUE,"St. Louis Rams",37,15,25,434,235,199,1,16,247,207,40,1,1998-11-01,0,1,"atl",22
"10","Sun","November 8","W","","7-2",FALSE,"New England Patriots",41,10,22,366,249,117,2,15,223,205,18,5,1998-11-08,3,1,"atl",31
"11","Sun","November 15","W","","8-2",TRUE,"San Francisco 49ers",31,19,19,298,184,114,1,18,383,307,76,2,1998-11-15,1,1,"atl",12
"12","Sun","November 22","W","","9-2",TRUE,"Chicago Bears",20,13,21,358,263,95,2,10,210,104,106,3,1998-11-22,1,1,"atl",7
"13","Sun","November 29","W","","10-2",FALSE,"St. Louis Rams",21,10,20,374,170,204,1,12,169,129,40,0,1998-11-29,-1,1,"atl",11
"14","Sun","December 6","W","","11-2",TRUE,"Indianapolis Colts",28,21,27,394,257,137,2,17,244,159,85,3,1998-12-06,1,1,"atl",7
"15","Sun","December 13","W","","12-2",FALSE,"New Orleans Saints",27,17,25,504,322,182,3,15,216,164,52,4,1998-12-13,1,1,"atl",10
"16","Sun","December 20","W","","13-2",FALSE,"Detroit Lions",24,17,20,268,123,145,0,17,258,141,117,3,1998-12-20,3,1,"atl",7
"17","Sun","December 27","W","","14-2",TRUE,"Miami Dolphins",38,16,15,346,203,143,0,20,400,362,38,6,1998-12-27,6,1,"atl",22
"Division","Sat","January 9","W","","15-2",TRUE,"San Francisco 49ers",20,18,16,289,153,136,1,15,334,288,46,3,1999-01-09,2,1,"atl",2
"ConfChamp","Sun","January 17","W","OT","16-2",FALSE,"Minnesota Vikings",30,27,25,427,317,110,2,26,356,254,102,2,1999-01-17,0,1,"atl",3
"SuperBowl","Sun","January 31","L","","16-3",TRUE,"Denver Broncos",19,34,21,337,206,131,4,22,457,336,121,1,1999-01-31,-3,0,"atl",-15
"1","Sun","September 12","L","","0-1",TRUE,"Minnesota Vikings",14,17,22,359,278,81,3,19,299,184,115,0,1999-09-12,-3,0,"atl",-3
"2","Mon","September 20","L","","0-2",FALSE,"Dallas Cowboys",7,24,13,324,239,85,4,17,232,98,134,2,1999-09-20,-2,0,"atl",-17
"3","Sun","September 26","L","","0-3",FALSE,"St. Louis Rams",7,35,12,233,165,68,1,19,442,275,167,0,1999-09-26,-1,0,"atl",-28
"4","Sun","October 3","L","OT","0-4",TRUE,"Baltimore Ravens",13,19,20,298,246,52,3,17,307,163,144,0,1999-10-03,-3,0,"atl",-6
"5","Sun","October 10","W","","1-4",FALSE,"New Orleans Saints",20,17,12,251,147,104,2,18,390,319,71,2,1999-10-10,0,1,"atl",3
"6","Sun","October 17","L","","1-5",TRUE,"St. Louis Rams",13,41,16,316,270,46,3,17,283,94,189,1,1999-10-17,-2,0,"atl",-28
"7","Mon","October 25","L","","1-6",FALSE,"Pittsburgh Steelers",9,13,20,236,187,49,1,14,226,115,111,1,1999-10-25,0,0,"atl",-4
"8","Sun","October 31","W","","2-6",TRUE,"Carolina Panthers",27,20,20,283,176,107,0,19,290,227,63,5,1999-10-31,5,1,"atl",7
"9","Sun","November 7","L","","2-7",TRUE,"Jacksonville Jaguars",7,30,10,182,140,42,4,20,367,215,152,0,1999-11-07,-4,0,"atl",-23
"11","Sun","November 21","L","","2-8",FALSE,"Tampa Bay Buccaneers",10,19,9,168,92,76,2,12,239,120,119,1,1999-11-21,-1,0,"atl",-9
"12","Sun","November 28","L","","2-9",FALSE,"Carolina Panthers",28,34,22,343,279,64,1,25,380,254,126,1,1999-11-28,0,0,"atl",-6
"13","Sun","December 5","W","","3-9",TRUE,"New Orleans Saints",35,12,21,361,233,128,3,21,240,91,149,2,1999-12-05,-1,1,"atl",23
"14","Sun","December 12","L","","3-10",FALSE,"San Francisco 49ers",7,26,7,105,67,38,2,21,334,153,181,0,1999-12-12,-2,0,"atl",-19
"15","Sun","December 19","L","","3-11",FALSE,"Tennessee Titans",17,30,23,347,291,56,6,14,399,268,131,0,1999-12-19,-6,0,"atl",-13
"16","Sun","December 26","W","","4-11",TRUE,"Arizona Cardinals",37,14,22,393,230,163,0,17,289,212,77,2,1999-12-26,2,1,"atl",23
"17","Mon","January 3","W","","5-11",TRUE,"San Francisco 49ers",34,29,24,343,306,37,0,23,506,363,143,1,2000-01-03,1,1,"atl",5
"1","Sun","September 3","W","","1-0",TRUE,"San Francisco 49ers",36,28,22,359,264,95,1,23,339,247,92,1,2000-09-03,0,1,"atl",8
"2","Sun","September 10","L","","1-1",FALSE,"Denver Broncos",14,42,12,186,139,47,3,29,407,255,152,0,2000-09-10,-3,0,"atl",-28
"3","Sun","September 17","W","","2-1",FALSE,"Carolina Panthers",15,10,10,262,154,108,2,17,284,225,59,4,2000-09-17,2,1,"atl",5
"4","Sun","September 24","L","","2-2",TRUE,"St. Louis Rams",20,41,18,286,218,68,4,14,395,321,74,2,2000-09-24,-2,0,"atl",-21
"5","Sun","October 1","L","","2-3",FALSE,"Philadelphia Eagles",10,38,13,200,139,61,1,22,502,307,195,3,2000-10-01,2,0,"atl",-28
"6","Sun","October 8","L","","2-4",TRUE,"New York Giants",6,13,17,238,225,13,3,14,255,151,104,2,2000-10-08,-1,0,"atl",-7
"7","Sun","October 15","L","","2-5",FALSE,"St. Louis Rams",29,45,21,259,198,61,1,29,529,302,227,1,2000-10-15,0,0,"atl",-16
"8","Sun","October 22","L","","2-6",TRUE,"New Orleans Saints",19,21,13,278,203,75,0,25,402,206,196,1,2000-10-22,1,0,"atl",-2
"9","Sun","October 29","W","","3-6",TRUE,"Carolina Panthers",13,12,16,281,184,97,3,16,209,179,30,4,2000-10-29,1,1,"atl",1
"10","Sun","November 5","L","","3-7",TRUE,"Tampa Bay Buccaneers",14,27,22,283,224,59,4,15,267,141,126,2,2000-11-05,-2,0,"atl",-13
"11","Sun","November 12","L","","3-8",FALSE,"Detroit Lions",10,13,17,218,104,114,2,12,222,115,107,1,2000-11-12,-1,0,"atl",-3
"12","Sun","November 19","L","","3-9",FALSE,"San Francisco 49ers",6,16,11,211,118,93,1,17,337,210,127,1,2000-11-19,0,0,"atl",-10
"13","Sun","November 26","L","","3-10",FALSE,"Oakland Raiders",14,41,15,181,150,31,2,24,492,222,270,1,2000-11-26,-1,0,"atl",-27
"14","Sun","December 3","L","","3-11",TRUE,"Seattle Seahawks",10,30,20,301,204,97,4,17,335,252,83,0,2000-12-03,-4,0,"atl",-20
"16","Sun","December 17","L","","3-12",FALSE,"New Orleans Saints",7,23,9,163,99,64,3,19,373,281,92,1,2000-12-17,-2,0,"atl",-16
"17","Sun","December 24","W","","4-12",TRUE,"Kansas City Chiefs",29,13,20,288,157,131,0,15,259,210,49,1,2000-12-24,1,1,"atl",16
"1","Sun","September 9","L","OT","0-1",FALSE,"San Francisco 49ers",13,16,13,241,107,134,0,20,429,324,105,1,2001-09-09,1,0,"atl",-3
"2","Sun","September 23","W","","1-1",TRUE,"Carolina Panthers",24,16,16,377,256,121,2,18,359,270,89,1,2001-09-23,-1,1,"atl",8
"3","Sun","September 30","W","","2-1",FALSE,"Arizona Cardinals",34,14,21,379,268,111,0,21,335,245,90,4,2001-09-30,4,1,"atl",20
"4","Sun","October 7","L","","2-2",TRUE,"Chicago Bears",3,31,19,335,232,103,5,15,300,221,79,2,2001-10-07,-3,0,"atl",-28
"5","Sun","October 14","L","OT","2-3",TRUE,"San Francisco 49ers",31,37,21,342,254,88,1,27,517,330,187,2,2001-10-14,1,0,"atl",-6
"6","Sun","October 21","W","","3-3",FALSE,"New Orleans Saints",20,13,12,297,173,124,2,16,276,213,63,1,2001-10-21,-1,1,"atl",7
"8","Sun","November 4","L","","3-4",TRUE,"New England Patriots",10,24,11,244,104,140,1,21,371,236,135,2,2001-11-04,1,0,"atl",-14
"9","Sun","November 11","W","","4-4",TRUE,"Dallas Cowboys",20,13,12,201,46,155,1,15,303,96,207,2,2001-11-11,1,1,"atl",7
"10","Sun","November 18","W","","5-4",FALSE,"Green Bay Packers",23,20,25,417,335,82,2,14,313,243,70,4,2001-11-18,2,1,"atl",3
"11","Sun","November 25","W","","6-4",FALSE,"Carolina Panthers",10,7,13,239,94,145,0,14,247,151,96,2,2001-11-25,2,1,"atl",3
"12","Sun","December 2","L","","6-5",TRUE,"St. Louis Rams",6,35,20,320,192,128,2,19,422,333,89,0,2001-12-02,-2,0,"atl",-29
"13","Sun","December 9","L","","6-6",TRUE,"New Orleans Saints",10,28,20,230,180,50,2,19,379,265,114,2,2001-12-09,0,0,"atl",-18
"14","Sun","December 16","L","","6-7",FALSE,"Indianapolis Colts",27,41,21,316,250,66,1,29,512,325,187,1,2001-12-16,0,0,"atl",-14
"15","Sun","December 23","W","","7-7",TRUE,"Buffalo Bills",33,30,22,489,422,67,2,15,398,208,190,0,2001-12-23,-2,1,"atl",3
"16","Sun","December 30","L","","7-8",FALSE,"Miami Dolphins",14,21,21,388,236,152,4,12,226,176,50,3,2001-12-30,-1,0,"atl",-7
"17","Sun","January 6","L","","7-9",FALSE,"St. Louis Rams",13,31,13,255,159,96,3,23,458,266,192,3,2002-01-06,0,0,"atl",-18
"1","Sun","September 8","L","OT","0-1",FALSE,"Green Bay Packers",34,37,22,374,194,180,1,29,484,273,211,1,2002-09-08,0,0,"atl",-3
"2","Sun","September 15","L","","0-2",TRUE,"Chicago Bears",13,14,19,257,135,122,3,13,242,136,106,2,2002-09-15,-1,0,"atl",-1
"3","Sun","September 22","W","","1-2",TRUE,"Cincinnati Bengals",30,3,18,306,163,143,0,11,191,125,66,2,2002-09-22,2,1,"atl",27
"5","Sun","October 6","L","","1-3",TRUE,"Tampa Bay Buccaneers",6,20,14,243,173,70,4,15,327,253,74,2,2002-10-06,-2,0,"atl",-14
"6","Sun","October 13","W","","2-3",FALSE,"New York Giants",17,10,15,313,246,67,0,18,303,190,113,2,2002-10-13,2,1,"atl",7
"7","Sun","October 20","W","","3-3",TRUE,"Carolina Panthers",30,0,25,393,206,187,0,12,205,104,101,1,2002-10-20,1,1,"atl",30
"8","Sun","October 27","W","","4-3",FALSE,"New Orleans Saints",37,35,28,446,186,260,2,22,351,192,159,3,2002-10-27,1,1,"atl",2
"9","Sun","November 3","W","","5-3",TRUE,"Baltimore Ravens",20,17,14,241,115,126,1,15,340,187,153,2,2002-11-03,1,1,"atl",3
"10","Sun","November 10","T","OT","5-3-1",FALSE,"Pittsburgh Steelers",34,34,21,447,279,168,2,30,645,463,182,3,2002-11-10,1,0,"atl",0
"11","Sun","November 17","W","","6-3-1",TRUE,"New Orleans Saints",24,17,22,292,137,155,1,16,344,264,80,2,2002-11-17,1,1,"atl",7
"12","Sun","November 24","W","","7-3-1",FALSE,"Carolina Panthers",41,0,25,426,277,149,1,10,122,51,71,6,2002-11-24,5,1,"atl",41
"13","Sun","December 1","W","OT","8-3-1",FALSE,"Minnesota Vikings",30,24,19,379,152,227,3,21,369,230,139,3,2002-12-01,0,1,"atl",6
"14","Sun","December 8","L","","8-4-1",FALSE,"Tampa Bay Buccaneers",10,34,10,181,119,62,1,22,421,271,150,0,2002-12-08,-1,0,"atl",-24
"15","Sun","December 15","L","OT","8-5-1",TRUE,"Seattle Seahawks",24,30,21,373,223,150,3,25,464,298,166,3,2002-12-15,0,0,"atl",-6
"16","Sun","December 22","W","","9-5-1",TRUE,"Detroit Lions",36,15,27,533,336,197,2,12,208,121,87,3,2002-12-22,1,1,"atl",21
"17","Sun","December 29","L","","9-6-1",FALSE,"Cleveland Browns",16,24,16,331,226,105,3,17,318,129,189,4,2002-12-29,1,0,"atl",-8
"WildCard","Sat","January 4","W","","10-6-1",FALSE,"Green Bay Packers",27,7,21,309,117,192,0,17,289,233,56,5,2003-01-04,5,1,"atl",20
"Division","Sat","January 11","L","","10-7-1",FALSE,"Philadelphia Eagles",6,20,19,354,261,93,2,15,318,227,91,0,2003-01-11,-2,0,"atl",-14
"1","Sun","September 7","W","","1-0",FALSE,"Dallas Cowboys",27,13,17,318,220,98,1,16,403,254,149,2,2003-09-07,1,1,"atl",14
"2","Sun","September 14","L","","1-1",TRUE,"Washington Redskins",31,33,17,283,184,99,2,23,435,310,125,2,2003-09-14,0,0,"atl",-2
"3","Sun","September 21","L","","1-2",TRUE,"Tampa Bay Buccaneers",10,31,13,136,107,29,5,18,316,184,132,1,2003-09-21,-4,0,"atl",-21
"4","Sun","September 28","L","","1-3",FALSE,"Carolina Panthers",3,23,11,267,123,144,1,19,361,168,193,1,2003-09-28,0,0,"atl",-20
"5","Sun","October 5","L","","1-4",TRUE,"Minnesota Vikings",26,39,21,440,336,104,3,16,399,233,166,1,2003-10-05,-2,0,"atl",-13
"6","Mon","October 13","L","","1-5",FALSE,"St. Louis Rams",0,36,9,209,136,73,4,26,496,377,119,3,2003-10-13,-1,0,"atl",-36
"7","Sun","October 19","L","","1-6",TRUE,"New Orleans Saints",17,45,11,238,108,130,1,27,506,342,164,1,2003-10-19,0,0,"atl",-28
"9","Sun","November 2","L","","1-7",TRUE,"Philadelphia Eagles",16,23,17,278,147,131,2,24,430,302,128,0,2003-11-02,-2,0,"atl",-7
"10","Sun","November 9","W","","2-7",FALSE,"New York Giants",27,7,20,274,58,216,0,18,320,196,124,4,2003-11-09,4,1,"atl",20
"11","Sun","November 16","L","OT","2-8",FALSE,"New Orleans Saints",20,23,11,244,76,168,3,23,403,193,210,4,2003-11-16,1,0,"atl",-3
"12","Sun","November 23","L","","2-9",TRUE,"Tennessee Titans",31,38,16,282,257,25,2,20,347,203,144,1,2003-11-23,-1,0,"atl",-7
"13","Sun","November 30","L","","2-10",FALSE,"Houston Texans",13,17,16,243,174,69,1,17,236,101,135,1,2003-11-30,0,0,"atl",-4
"14","Sun","December 7","W","OT","3-10",TRUE,"Carolina Panthers",20,14,24,380,156,224,2,13,231,141,90,3,2003-12-07,1,1,"atl",6
"15","Sun","December 14","L","","3-11",FALSE,"Indianapolis Colts",7,38,12,154,29,125,2,27,465,287,178,2,2003-12-14,0,0,"atl",-31
"16","Sat","December 20","W","","4-11",FALSE,"Tampa Bay Buccaneers",30,28,16,267,119,148,1,25,440,346,94,4,2003-12-20,3,1,"atl",2
"17","Sun","December 28","W","","5-11",TRUE,"Jacksonville Jaguars",21,14,21,344,178,166,1,21,320,163,157,1,2003-12-28,0,1,"atl",7
"1","Sun","September 12","W","","1-0",FALSE,"San Francisco 49ers",21,19,14,227,132,95,1,21,359,266,93,2,2004-09-12,1,1,"atl",2
"2","Sun","September 19","W","","2-0",TRUE,"St. Louis Rams",34,17,22,416,174,242,0,14,280,250,30,2,2004-09-19,2,1,"atl",17
"3","Sun","September 26","W","","3-0",TRUE,"Arizona Cardinals",6,3,15,283,89,194,4,13,240,179,61,4,2004-09-26,0,1,"atl",3
"4","Sun","October 3","W","","4-0",FALSE,"Carolina Panthers",27,10,20,313,148,165,0,19,360,293,67,3,2004-10-03,3,1,"atl",17
"5","Sun","October 10","L","","4-1",TRUE,"Detroit Lions",10,17,17,279,185,94,4,15,227,126,101,0,2004-10-10,-4,0,"atl",-7
"6","Sun","October 17","W","","5-1",TRUE,"San Diego Chargers",21,20,15,299,206,93,2,18,318,223,95,1,2004-10-17,-1,1,"atl",1
"7","Sun","October 24","L","","5-2",FALSE,"Kansas City Chiefs",10,56,9,222,103,119,2,36,540,269,271,1,2004-10-24,-1,0,"atl",-46
"8","Sun","October 31","W","","6-2",FALSE,"Denver Broncos",41,28,22,467,272,195,1,27,567,499,68,3,2004-10-31,2,1,"atl",13
"10","Sun","November 14","W","","7-2",TRUE,"Tampa Bay Buccaneers",24,14,18,325,120,205,1,14,193,125,68,1,2004-11-14,0,1,"atl",10
"11","Sun","November 21","W","","8-2",FALSE,"New York Giants",14,10,16,298,97,201,0,20,277,158,119,2,2004-11-21,2,1,"atl",4
"12","Sun","November 28","W","","9-2",TRUE,"New Orleans Saints",24,21,21,396,210,186,2,19,306,165,141,2,2004-11-28,0,1,"atl",3
"13","Sun","December 5","L","","9-3",FALSE,"Tampa Bay Buccaneers",0,27,13,255,92,163,5,16,247,115,132,1,2004-12-05,-4,0,"atl",-27
"14","Sun","December 12","W","","10-3",TRUE,"Oakland Raiders",35,10,23,354,135,219,0,18,296,165,131,3,2004-12-12,3,1,"atl",25
"15","Sat","December 18","W","OT","11-3",TRUE,"Carolina Panthers",34,31,22,329,125,204,4,22,375,314,61,4,2004-12-18,0,1,"atl",3
"16","Sun","December 26","L","","11-4",FALSE,"New Orleans Saints",13,26,15,267,174,93,3,17,369,209,160,2,2004-12-26,-1,0,"atl",-13
"17","Sun","January 2","L","","11-5",FALSE,"Seattle Seahawks",26,28,22,354,150,204,1,21,253,170,83,1,2005-01-02,0,0,"atl",-2
"Division","Sat","January 15","W","","12-5",TRUE,"St. Louis Rams",47,17,18,397,70,327,1,19,339,262,77,2,2005-01-15,1,1,"atl",30
"ConfChamp","Sun","January 23","L","","12-6",FALSE,"Philadelphia Eagles",10,27,14,202,103,99,1,22,326,170,156,0,2005-01-23,-1,0,"atl",-17
"1","Mon","September 12","W","","1-0",TRUE,"Philadelphia Eagles",14,10,18,319,119,200,3,18,301,250,51,3,2005-09-12,0,1,"atl",4
"2","Sun","September 18","L","","1-1",FALSE,"Seattle Seahawks",18,21,14,223,108,115,0,24,428,265,163,1,2005-09-18,1,0,"atl",-3
"3","Sun","September 25","W","","2-1",FALSE,"Buffalo Bills",24,16,24,403,167,236,2,18,208,36,172,2,2005-09-25,0,1,"atl",8
"4","Sun","October 2","W","","3-1",TRUE,"Minnesota Vikings",30,10,22,368,83,285,0,17,261,198,63,3,2005-10-02,3,1,"atl",20
"5","Sun","October 9","L","","3-2",TRUE,"New England Patriots",28,31,22,400,284,116,0,20,483,342,141,1,2005-10-09,1,0,"atl",-3
"6","Sun","October 16","W","","4-2",FALSE,"New Orleans Saints",34,31,21,266,106,160,1,32,456,245,211,2,2005-10-16,1,1,"atl",3
"7","Mon","October 24","W","","5-2",TRUE,"New York Jets",27,14,19,310,105,205,3,16,231,194,37,4,2005-10-24,1,1,"atl",13
"9","Sun","November 6","W","","6-2",FALSE,"Miami Dolphins",17,10,27,382,220,162,2,11,208,103,105,1,2005-11-06,-1,1,"atl",7
"10","Sun","November 13","L","","6-3",TRUE,"Green Bay Packers",25,33,19,321,192,129,3,25,351,244,107,1,2005-11-13,-2,0,"atl",-8
"11","Sun","November 20","L","","6-4",TRUE,"Tampa Bay Buccaneers",27,30,26,443,293,150,2,15,258,118,140,1,2005-11-20,-1,0,"atl",-3
"12","Thu","November 24","W","","7-4",FALSE,"Detroit Lions",27,7,22,402,146,256,2,20,304,229,75,4,2005-11-24,2,1,"atl",20
"13","Sun","December 4","L","","7-5",FALSE,"Carolina Panthers",6,24,14,259,148,111,2,14,306,164,142,1,2005-12-04,-1,0,"atl",-18
"14","Mon","December 12","W","","8-5",TRUE,"New Orleans Saints",36,17,19,406,279,127,1,22,332,207,125,1,2005-12-12,0,1,"atl",19
"15","Sun","December 18","L","","8-6",FALSE,"Chicago Bears",3,16,12,231,117,114,3,14,226,98,128,1,2005-12-18,-2,0,"atl",-13
"16","Sat","December 24","L","OT","8-7",FALSE,"Tampa Bay Buccaneers",24,27,19,281,127,154,1,30,444,270,174,3,2005-12-24,2,0,"atl",-3
"17","Sun","January 1","L","","8-8",TRUE,"Carolina Panthers",11,44,15,211,185,26,4,23,403,174,229,0,2006-01-01,-4,0,"atl",-33
"1","Sun","September 10","W","","1-0",FALSE,"Carolina Panthers",20,6,24,385,133,252,0,15,215,150,65,2,2006-09-10,2,1,"atl",14
"2","Sun","September 17","W","","2-0",TRUE,"Tampa Bay Buccaneers",14,3,22,382,76,306,2,22,351,311,40,3,2006-09-17,1,1,"atl",11
"3","Mon","September 25","L","","2-1",FALSE,"New Orleans Saints",3,23,10,229,112,117,0,19,326,180,146,0,2006-09-25,0,0,"atl",-20
"4","Sun","October 1","W","","3-1",TRUE,"Arizona Cardinals",32,10,19,405,143,262,1,14,187,161,26,4,2006-10-01,3,1,"atl",22
"6","Sun","October 15","L","","3-2",TRUE,"New York Giants",14,27,16,329,106,223,2,28,424,165,259,2,2006-10-15,0,0,"atl",-13
"7","Sun","October 22","W","OT","4-2",TRUE,"Pittsburgh Steelers",41,38,24,399,226,173,2,27,473,418,55,3,2006-10-22,1,1,"atl",3
"8","Sun","October 29","W","","5-2",FALSE,"Cincinnati Bengals",29,27,25,420,277,143,0,22,331,258,73,1,2006-10-29,1,1,"atl",2
"9","Sun","November 5","L","","5-3",FALSE,"Detroit Lions",14,30,19,319,154,165,3,20,435,308,127,1,2006-11-05,-2,0,"atl",-16
"10","Sun","November 12","L","","5-4",TRUE,"Cleveland Browns",13,17,16,343,194,149,3,9,236,145,91,2,2006-11-12,-1,0,"atl",-4
"11","Sun","November 19","L","","5-5",FALSE,"Baltimore Ravens",10,24,12,186,82,104,0,20,328,225,103,1,2006-11-19,1,0,"atl",-14
"12","Sun","November 26","L","","5-6",TRUE,"New Orleans Saints",13,31,21,333,52,281,0,20,427,332,95,0,2006-11-26,0,0,"atl",-18
"13","Sun","December 3","W","","6-6",FALSE,"Washington Redskins",24,14,16,369,113,256,0,25,381,204,177,2,2006-12-03,2,1,"atl",10
"14","Sun","December 10","W","","7-6",FALSE,"Tampa Bay Buccaneers",17,6,15,280,141,139,1,15,272,192,80,2,2006-12-10,1,1,"atl",11
"15","Sat","December 16","L","","7-7",TRUE,"Dallas Cowboys",28,38,19,376,249,127,3,21,352,258,94,2,2006-12-16,-1,0,"atl",-10
"16","Sun","December 24","L","","7-8",TRUE,"Carolina Panthers",3,10,8,177,94,83,2,15,194,11,183,0,2006-12-24,-2,0,"atl",-7
"17","Sun","December 31","L","","7-9",FALSE,"Philadelphia Eagles",17,24,21,378,219,159,1,21,393,350,43,1,2006-12-31,0,0,"atl",-7
"1","Sun","September 9","L","","0-1",FALSE,"Minnesota Vikings",3,24,17,265,169,96,2,15,302,163,139,1,2007-09-09,-1,0,"atl",-21
"2","Sun","September 16","L","","0-2",FALSE,"Jacksonville Jaguars",7,13,13,248,166,82,0,17,364,251,113,0,2007-09-16,0,0,"atl",-6
"3","Sun","September 23","L","","0-3",TRUE,"Carolina Panthers",20,27,21,442,351,91,2,24,313,138,175,0,2007-09-23,-2,0,"atl",-7
"4","Sun","September 30","W","","1-3",TRUE,"Houston Texans",26,16,20,304,214,90,0,18,398,311,87,2,2007-09-30,2,1,"atl",10
"5","Sun","October 7","L","","1-4",FALSE,"Tennessee Titans",13,20,9,198,99,99,2,20,249,157,92,5,2007-10-07,3,0,"atl",-7
"6","Mon","October 15","L","","1-5",TRUE,"New York Giants",10,31,14,284,181,103,1,28,491,303,188,3,2007-10-15,2,0,"atl",-21
"7","Sun","October 21","L","","1-6",FALSE,"New Orleans Saints",16,22,18,334,259,75,0,14,310,219,91,1,2007-10-21,1,0,"atl",-6
"9","Sun","November 4","W","","2-6",TRUE,"San Francisco 49ers",20,16,15,286,131,155,1,16,251,135,116,4,2007-11-04,3,1,"atl",4
"10","Sun","November 11","W","","3-6",FALSE,"Carolina Panthers",20,13,12,277,189,88,1,10,235,145,90,2,2007-11-11,1,1,"atl",7
"11","Sun","November 18","L","","3-7",TRUE,"Tampa Bay Buccaneers",7,31,15,265,216,49,4,15,305,156,149,2,2007-11-18,-2,0,"atl",-24
"12","Thu","November 22","L","","3-8",TRUE,"Indianapolis Colts",13,31,13,250,138,112,2,26,365,247,118,1,2007-11-22,-1,0,"atl",-18
"13","Sun","December 2","L","","3-9",FALSE,"St. Louis Rams",16,28,23,435,324,111,3,19,409,304,105,2,2007-12-02,-1,0,"atl",-12
"14","Mon","December 10","L","","3-10",TRUE,"New Orleans Saints",14,34,13,323,286,37,1,23,473,328,145,1,2007-12-10,0,0,"atl",-20
"15","Sun","December 16","L","","3-11",FALSE,"Tampa Bay Buccaneers",3,37,5,133,27,106,4,21,285,95,190,1,2007-12-16,-3,0,"atl",-34
"16","Sun","December 23","L","OT","3-12",FALSE,"Arizona Cardinals",27,30,21,405,303,102,1,24,437,369,68,0,2007-12-23,-1,0,"atl",-3
"17","Sun","December 30","W","","4-12",TRUE,"Seattle Seahawks",44,41,19,364,240,124,0,30,501,334,167,3,2007-12-30,3,1,"atl",3
"1","Sun","September 7","W","","1-0",TRUE,"Detroit Lions",34,21,23,474,156,318,0,21,316,246,70,1,2008-09-07,1,1,"atl",13
"2","Sun","September 14","L","","1-1",FALSE,"Tampa Bay Buccaneers",9,24,14,234,129,105,2,15,311,147,164,1,2008-09-14,-1,0,"atl",-15
"3","Sun","September 21","W","","2-1",TRUE,"Kansas City Chiefs",38,14,16,378,192,186,1,17,301,117,184,3,2008-09-21,2,1,"atl",24
"4","Sun","September 28","L","","2-2",FALSE,"Carolina Panthers",9,24,17,268,150,118,0,19,401,294,107,0,2008-09-28,0,0,"atl",-15
"5","Sun","October 5","W","","3-2",FALSE,"Green Bay Packers",27,24,22,370,194,176,1,21,408,304,104,1,2008-10-05,0,1,"atl",3
"6","Sun","October 12","W","","4-2",TRUE,"Chicago Bears",22,20,18,376,301,75,1,22,361,282,79,1,2008-10-12,0,1,"atl",2
"8","Sun","October 26","L","","4-3",FALSE,"Philadelphia Eagles",14,27,19,335,258,77,3,24,432,240,192,1,2008-10-26,-2,0,"atl",-13
"9","Sun","November 2","W","","5-3",FALSE,"Oakland Raiders",24,0,30,453,201,252,1,3,77,10,67,2,2008-11-02,1,1,"atl",24
"10","Sun","November 9","W","","6-3",TRUE,"New Orleans Saints",34,20,18,361,248,113,0,25,521,416,105,3,2008-11-09,3,1,"atl",14
"11","Sun","November 16","L","","6-4",TRUE,"Denver Broncos",20,24,20,364,250,114,1,19,332,208,124,0,2008-11-16,-1,0,"atl",-4
"12","Sun","November 23","W","","7-4",TRUE,"Carolina Panthers",45,28,21,392,259,133,1,22,408,274,134,0,2008-11-23,-1,1,"atl",17
"13","Sun","November 30","W","","8-4",FALSE,"San Diego Chargers",22,16,20,348,207,141,3,12,201,131,70,0,2008-11-30,-3,1,"atl",6
"14","Sun","December 7","L","","8-5",FALSE,"New Orleans Saints",25,29,22,414,315,99,1,24,414,230,184,0,2008-12-07,-1,0,"atl",-4
"15","Sun","December 14","W","OT","9-5",TRUE,"Tampa Bay Buccaneers",13,10,18,373,198,175,3,19,325,226,99,1,2008-12-14,-2,1,"atl",3
"16","Sun","December 21","W","","10-5",FALSE,"Minnesota Vikings",24,17,18,222,124,98,0,24,350,195,155,4,2008-12-21,4,1,"atl",7
"17","Sun","December 28","W","","11-5",TRUE,"St. Louis Rams",31,27,17,417,154,263,3,22,408,206,202,0,2008-12-28,-3,1,"atl",4
"WildCard","Sat","January 3","L","","11-6",FALSE,"Arizona Cardinals",24,30,20,250,190,60,3,15,357,271,86,1,2009-01-03,-2,0,"atl",-6
"1","Sun","September 13","W","","1-0",TRUE,"Miami Dolphins",19,7,19,281,213,68,0,16,259,163,96,4,2009-09-13,4,1,"atl",12
"2","Sun","September 20","W","","2-0",TRUE,"Carolina Panthers",28,20,23,371,220,151,2,24,440,296,144,2,2009-09-20,0,1,"atl",8
"3","Sun","September 27","L","","2-1",FALSE,"New England Patriots",10,26,13,257,199,58,1,28,445,277,168,0,2009-09-27,-1,0,"atl",-16
"5","Sun","October 11","W","","3-1",FALSE,"San Francisco 49ers",45,10,28,477,329,148,2,13,279,179,100,3,2009-10-11,1,1,"atl",35
"6","Sun","October 18","W","","4-1",TRUE,"Chicago Bears",21,14,16,253,185,68,2,21,373,290,83,3,2009-10-18,1,1,"atl",7
"7","Sun","October 25","L","","4-2",FALSE,"Dallas Cowboys",21,37,21,298,174,124,3,18,414,299,115,1,2009-10-25,-2,0,"atl",-16
"8","Mon","November 2","L","","4-3",FALSE,"New Orleans Saints",27,35,21,442,281,161,3,23,437,291,146,4,2009-11-02,1,0,"atl",-8
"9","Sun","November 8","W","","5-3",TRUE,"Washington Redskins",31,17,18,306,125,181,1,17,312,176,136,1,2009-11-08,0,1,"atl",14
"10","Sun","November 15","L","","5-4",FALSE,"Carolina Panthers",19,28,22,400,224,176,2,19,380,195,185,0,2009-11-15,-2,0,"atl",-9
"11","Sun","November 22","L","OT","5-5",FALSE,"New York Giants",31,34,27,352,262,90,1,26,456,368,88,1,2009-11-22,0,0,"atl",-3
"12","Sun","November 29","W","","6-5",TRUE,"Tampa Bay Buccaneers",20,17,21,297,222,75,1,13,318,245,73,1,2009-11-29,0,1,"atl",3
"13","Sun","December 6","L","","6-6",TRUE,"Philadelphia Eagles",7,34,22,295,234,61,3,20,380,277,103,0,2009-12-06,-3,0,"atl",-27
"14","Sun","December 13","L","","6-7",TRUE,"New Orleans Saints",23,26,19,392,303,89,1,24,391,296,95,0,2009-12-13,-1,0,"atl",-3
"15","Sun","December 20","W","","7-7",FALSE,"New York Jets",10,7,12,238,152,86,0,17,314,215,99,3,2009-12-20,3,1,"atl",3
"16","Sun","December 27","W","","8-7",TRUE,"Buffalo Bills",31,3,24,391,234,157,0,11,178,138,40,3,2009-12-27,3,1,"atl",28
"17","Sun","January 3","W","","9-7",FALSE,"Tampa Bay Buccaneers",20,10,24,397,214,183,3,13,206,166,40,2,2010-01-03,-1,1,"atl",10
"1","Sun","September 12","L","OT","0-1",FALSE,"Pittsburgh Steelers",9,15,18,295,237,58,1,14,354,211,143,1,2010-09-12,0,0,"atl",-6
"2","Sun","September 19","W","","1-1",TRUE,"Arizona Cardinals",41,7,33,444,223,221,1,11,267,149,118,3,2010-09-19,2,1,"atl",34
"3","Sun","September 26","W","OT","2-1",FALSE,"New Orleans Saints",27,24,25,417,215,202,1,20,398,355,43,3,2010-09-26,2,1,"atl",3
"4","Sun","October 3","W","","3-1",TRUE,"San Francisco 49ers",16,14,23,357,259,98,2,17,262,181,81,3,2010-10-03,1,1,"atl",2
"5","Sun","October 10","W","","4-1",FALSE,"Cleveland Browns",20,10,17,338,173,165,1,18,269,221,48,3,2010-10-10,2,1,"atl",10
"6","Sun","October 17","L","","4-2",FALSE,"Philadelphia Eagles",17,31,20,293,228,65,2,23,474,320,154,1,2010-10-17,-1,0,"atl",-14
"7","Sun","October 24","W","","5-2",TRUE,"Cincinnati Bengals",39,32,22,452,299,153,2,28,469,385,84,1,2010-10-24,-1,1,"atl",7
"9","Sun","November 7","W","","6-2",TRUE,"Tampa Bay Buccaneers",27,21,26,365,235,130,0,14,278,182,96,2,2010-11-07,2,1,"atl",6
"10","Thu","November 11","W","","7-2",TRUE,"Baltimore Ravens",26,21,23,362,302,60,0,20,320,204,116,2,2010-11-11,2,1,"atl",5
"11","Sun","November 21","W","","8-2",FALSE,"St. Louis Rams",34,17,24,391,253,138,0,15,304,233,71,1,2010-11-21,1,1,"atl",17
"12","Sun","November 28","W","","9-2",TRUE,"Green Bay Packers",20,17,19,294,177,117,0,22,418,341,77,1,2010-11-28,1,1,"atl",3
"13","Sun","December 5","W","","10-2",FALSE,"Tampa Bay Buccaneers",28,24,20,290,205,85,2,19,325,174,151,1,2010-12-05,-1,1,"atl",4
"14","Sun","December 12","W","","11-2",FALSE,"Carolina Panthers",31,10,24,327,200,127,1,13,288,76,212,2,2010-12-12,1,1,"atl",21
"15","Sun","December 19","W","","12-2",FALSE,"Seattle Seahawks",34,18,21,266,168,98,1,15,234,143,91,3,2010-12-19,2,1,"atl",16
"16","Mon","December 27","L","","12-3",TRUE,"New Orleans Saints",14,17,14,215,140,75,2,23,368,296,72,2,2010-12-27,0,0,"atl",-3
"17","Sun","January 2","W","","13-3",TRUE,"Carolina Panthers",31,10,24,352,253,99,1,12,291,154,137,2,2011-01-02,1,1,"atl",21
"Division","Sat","January 15","L","","13-4",TRUE,"Green Bay Packers",21,48,15,194,149,45,4,28,442,346,96,1,2011-01-15,-3,0,"atl",-27
"1","Sun","September 11","L","","0-1",FALSE,"Chicago Bears",12,30,25,386,276,110,3,17,377,289,88,1,2011-09-11,-2,0,"atl",-18
"2","Sun","September 18","W","","1-1",TRUE,"Philadelphia Eagles",35,31,20,318,180,138,2,27,447,314,133,3,2011-09-18,1,1,"atl",4
"3","Sun","September 25","L","","1-2",FALSE,"Tampa Bay Buccaneers",13,16,21,325,295,30,3,20,295,180,115,2,2011-09-25,-1,0,"atl",-3
"4","Sun","October 2","W","","2-2",FALSE,"Seattle Seahawks",30,28,25,412,291,121,0,20,372,319,53,2,2011-10-02,2,1,"atl",2
"5","Sun","October 9","L","","2-3",TRUE,"Green Bay Packers",14,25,18,251,156,95,2,19,426,369,57,1,2011-10-09,-1,0,"atl",-11
"6","Sun","October 16","W","","3-3",TRUE,"Carolina Panthers",31,17,24,325,159,166,0,24,368,229,139,3,2011-10-16,3,1,"atl",14
"7","Sun","October 23","W","","4-3",FALSE,"Detroit Lions",23,16,22,328,199,129,2,13,263,159,104,1,2011-10-23,-1,1,"atl",7
"9","Sun","November 6","W","","5-3",FALSE,"Indianapolis Colts",31,7,21,432,269,163,1,10,186,103,83,2,2011-11-06,1,1,"atl",24
"10","Sun","November 13","L","OT","5-4",TRUE,"New Orleans Saints",23,26,30,481,343,138,1,18,363,322,41,0,2011-11-13,-1,0,"atl",-3
"11","Sun","November 20","W","","6-4",TRUE,"Tennessee Titans",23,17,25,432,316,116,1,17,298,257,41,1,2011-11-20,0,1,"atl",6
"12","Sun","November 27","W","","7-4",TRUE,"Minnesota Vikings",24,14,22,335,246,89,1,12,226,162,64,0,2011-11-27,-1,1,"atl",10
"13","Sun","December 4","L","","7-5",FALSE,"Houston Texans",10,17,18,337,267,70,2,20,337,175,162,1,2011-12-04,-1,0,"atl",-7
"14","Sun","December 11","W","","8-5",FALSE,"Carolina Panthers",31,23,18,394,308,86,0,19,416,259,157,2,2011-12-11,2,1,"atl",8
"15","Thu","December 15","W","","9-5",TRUE,"Jacksonville Jaguars",41,14,20,373,276,97,0,12,207,91,116,4,2011-12-15,4,1,"atl",27
"16","Mon","December 26","L","","9-6",FALSE,"New Orleans Saints",16,45,23,469,434,35,1,26,463,299,164,2,2011-12-26,1,0,"atl",-29
"17","Sun","January 1","W","","10-6",TRUE,"Tampa Bay Buccaneers",45,24,22,428,177,251,2,18,294,259,35,4,2012-01-01,2,1,"atl",21
"WildCard","Sun","January 8","L","","10-7",FALSE,"New York Giants",2,24,14,247,183,64,0,19,442,270,172,0,2012-01-08,0,0,"atl",-22
"1","Sun","September 8","L","","0-1",FALSE,"Chicago Bears",28,38,17,307,141,166,2,27,436,251,185,3,1985-09-08,1,0,"tam",-10
"2","Sun","September 15","L","","0-2",TRUE,"Minnesota Vikings",16,31,22,349,234,115,5,18,262,183,79,2,1985-09-15,-3,0,"tam",-15
"3","Sun","September 22","L","","0-3",FALSE,"New Orleans Saints",13,20,20,334,220,114,3,18,338,226,112,2,1985-09-22,-1,0,"tam",-7
"4","Sun","September 29","L","","0-4",FALSE,"Detroit Lions",9,30,19,277,158,119,4,18,315,221,94,1,1985-09-29,-3,0,"tam",-21
"5","Sun","October 6","L","","0-5",TRUE,"Chicago Bears",19,27,19,373,346,27,3,22,433,286,147,3,1985-10-06,0,0,"tam",-8
"6","Sun","October 13","L","","0-6",TRUE,"Los Angeles Rams",27,31,15,210,151,59,5,14,282,148,134,4,1985-10-13,-1,0,"tam",-4
"7","Sun","October 20","L","","0-7",FALSE,"Miami Dolphins",38,41,24,476,365,111,1,30,446,302,144,2,1985-10-20,1,0,"tam",-3
"8","Sun","October 27","L","","0-8",TRUE,"New England Patriots",14,32,14,209,130,79,2,18,420,223,197,2,1985-10-27,0,0,"tam",-18
"9","Sun","November 3","L","","0-9",FALSE,"New York Giants",20,22,20,316,228,88,1,23,342,167,175,0,1985-11-03,-1,0,"tam",-2
"10","Sun","November 10","W","","1-9",TRUE,"St. Louis Cardinals",16,0,16,306,182,124,2,17,279,184,95,3,1985-11-10,1,1,"tam",16
"11","Sun","November 17","L","","1-10",FALSE,"New York Jets",28,62,15,212,190,22,5,35,581,379,202,3,1985-11-17,-2,0,"tam",-34
"12","Sun","November 24","W","OT","2-10",TRUE,"Detroit Lions",19,16,23,288,119,169,0,16,273,200,73,1,1985-11-24,1,1,"tam",3
"13","Sun","December 1","L","","2-11",FALSE,"Green Bay Packers",0,21,5,65,11,54,1,31,512,280,232,4,1985-12-01,3,0,"tam",-21
"14","Sun","December 8","L","","2-12",FALSE,"Minnesota Vikings",7,26,17,327,176,151,6,23,474,309,165,5,1985-12-08,-1,0,"tam",-19
"15","Sun","December 15","L","","2-13",TRUE,"Indianapolis Colts",23,31,23,387,230,157,4,23,384,127,257,1,1985-12-15,-3,0,"tam",-8
"16","Sun","December 22","L","","2-14",TRUE,"Green Bay Packers",17,20,22,330,241,89,4,18,331,192,139,4,1985-12-22,0,0,"tam",-3
"1","Sun","September 7","L","","0-1",TRUE,"San Francisco 49ers",7,31,17,286,195,91,7,28,453,345,108,2,1986-09-07,-5,0,"tam",-24
"2","Sun","September 14","L","","0-2",TRUE,"Minnesota Vikings",10,23,21,239,156,83,3,17,242,120,122,0,1986-09-14,-3,0,"tam",-13
"3","Sun","September 21","W","","1-2",FALSE,"Detroit Lions",24,20,14,253,24,229,1,26,379,286,93,5,1986-09-21,4,1,"tam",4
"4","Sun","September 28","L","OT","1-3",TRUE,"Atlanta Falcons",20,23,18,322,147,175,1,28,490,241,249,2,1986-09-28,1,0,"tam",-3
"5","Sun","October 5","L","OT","1-4",FALSE,"Los Angeles Rams",20,26,14,234,60,174,1,20,357,106,251,2,1986-10-05,1,0,"tam",-6
"6","Sun","October 12","L","","1-5",TRUE,"St. Louis Cardinals",19,30,19,347,257,90,0,23,431,213,218,1,1986-10-12,1,0,"tam",-11
"7","Sun","October 19","L","","1-6",FALSE,"New Orleans Saints",7,38,16,220,160,60,5,28,450,185,265,2,1986-10-19,-3,0,"tam",-31
"8","Sun","October 26","L","","1-7",FALSE,"Kansas City Chiefs",20,27,16,216,86,130,2,20,355,222,133,2,1986-10-26,0,0,"tam",-7
"9","Sun","November 2","W","","2-7",TRUE,"Buffalo Bills",34,28,20,306,171,135,0,23,403,324,79,3,1986-11-02,3,1,"tam",6
"10","Sun","November 9","L","","2-8",TRUE,"Chicago Bears",3,23,14,272,188,84,2,20,434,258,176,1,1986-11-09,-1,0,"tam",-20
"11","Sun","November 16","L","","2-9",FALSE,"Green Bay Packers",7,31,16,263,200,63,3,24,437,283,154,4,1986-11-16,1,0,"tam",-24
"12","Sun","November 23","L","","2-10",TRUE,"Detroit Lions",17,38,26,380,193,187,4,22,393,264,129,2,1986-11-23,-2,0,"tam",-21
"13","Sun","November 30","L","","2-11",FALSE,"Minnesota Vikings",13,45,20,267,166,101,3,25,463,342,121,0,1986-11-30,-3,0,"tam",-32
"14","Sun","December 7","L","","2-12",FALSE,"Chicago Bears",14,48,13,271,221,50,5,23,432,187,245,3,1986-12-07,-2,0,"tam",-34
"15","Sun","December 14","L","","2-13",TRUE,"Green Bay Packers",7,21,14,242,117,125,2,20,349,173,176,0,1986-12-14,-2,0,"tam",-14
"16","Sun","December 21","L","","2-14",FALSE,"St. Louis Cardinals",17,21,15,243,157,86,3,15,265,136,129,3,1986-12-21,0,0,"tam",-4
"1","Sun","September 13","W","","1-0",TRUE,"Atlanta Falcons",48,10,30,460,333,127,2,13,197,134,63,3,1987-09-13,1,1,"tam",38
"2","Sun","September 20","L","","1-1",FALSE,"Chicago Bears",3,20,18,262,173,89,4,18,301,133,168,4,1987-09-20,0,0,"tam",-17
"3","Sun","October 4","W","","2-1",FALSE,"Detroit Lions",31,27,12,219,106,113,1,12,262,161,101,4,1987-10-04,3,1,"tam",4
"4","Sun","October 11","L","","2-2",TRUE,"San Diego Chargers",13,17,7,201,70,131,1,22,385,260,125,3,1987-10-11,2,0,"tam",-4
"5","Sun","October 18","W","","3-2",TRUE,"Minnesota Vikings",20,10,15,268,193,75,2,16,175,152,23,6,1987-10-18,4,1,"tam",10
"6","Sun","October 25","L","","3-3",TRUE,"Chicago Bears",26,27,20,285,184,101,0,19,300,209,91,4,1987-10-25,4,0,"tam",-1
"7","Sun","November 1","W","","4-3",FALSE,"Green Bay Packers",23,17,20,279,190,89,1,22,279,190,89,2,1987-11-01,1,1,"tam",6
"8","Sun","November 8","L","","4-4",FALSE,"St. Louis Cardinals",28,31,26,377,294,83,1,26,415,278,137,2,1987-11-08,1,0,"tam",-3
"9","Sun","November 15","L","","4-5",FALSE,"Minnesota Vikings",17,23,14,259,244,15,4,23,330,106,224,1,1987-11-15,-3,0,"tam",-6
"10","Sun","November 22","L","","4-6",TRUE,"San Francisco 49ers",10,24,14,256,196,60,2,28,432,295,137,1,1987-11-22,-1,0,"tam",-14
"11","Sun","November 29","L","","4-7",FALSE,"Los Angeles Rams",3,35,11,201,122,79,3,27,425,212,213,1,1987-11-29,-2,0,"tam",-32
"12","Sun","December 6","L","","4-8",FALSE,"New Orleans Saints",34,44,27,449,352,97,4,19,365,248,117,1,1987-12-06,-3,0,"tam",-10
"13","Sun","December 13","L","","4-9",TRUE,"Detroit Lions",10,20,20,263,216,47,1,22,298,108,190,1,1987-12-13,0,0,"tam",-10
"14","Sun","December 20","L","","4-10",TRUE,"St. Louis Cardinals",14,31,19,370,207,163,4,24,351,217,134,2,1987-12-20,-2,0,"tam",-17
"15","Sun","December 27","L","","4-11",FALSE,"Indianapolis Colts",6,24,10,232,136,96,1,23,472,246,226,1,1987-12-27,0,0,"tam",-18
"1","Sun","September 4","L","","0-1",TRUE,"Philadelphia Eagles",14,41,19,362,319,43,5,18,389,248,141,2,1988-09-04,-3,0,"tam",-27
"2","Sun","September 11","W","","1-1",FALSE,"Green Bay Packers",13,10,18,266,118,148,2,13,240,181,59,2,1988-09-11,0,1,"tam",3
"3","Sun","September 18","L","","1-2",TRUE,"Phoenix Cardinals",24,30,15,298,184,114,3,24,475,294,181,0,1988-09-18,-3,0,"tam",-6
"4","Sun","September 25","L","","1-3",FALSE,"New Orleans Saints",9,13,19,296,204,92,1,18,268,151,117,1,1988-09-25,0,0,"tam",-4
"5","Sun","October 2","W","","2-3",TRUE,"Green Bay Packers",27,24,17,368,283,85,5,22,426,354,72,3,1988-10-02,-2,1,"tam",3
"6","Sun","October 9","L","","2-4",FALSE,"Minnesota Vikings",13,14,18,331,154,177,3,15,276,207,69,2,1988-10-09,-1,0,"tam",-1
"7","Sun","October 16","L","","2-5",FALSE,"Indianapolis Colts",31,35,24,483,444,39,2,25,349,246,103,2,1988-10-16,0,0,"tam",-4
"8","Sun","October 23","L","","2-6",TRUE,"Minnesota Vikings",20,49,18,243,215,28,7,25,433,305,128,1,1988-10-23,-6,0,"tam",-29
"9","Sun","October 30","L","","2-7",TRUE,"Miami Dolphins",14,17,21,362,283,79,5,20,309,266,43,0,1988-10-30,-5,0,"tam",-3
"10","Sun","November 6","L","","2-8",FALSE,"Chicago Bears",10,28,25,357,273,84,2,19,338,269,69,3,1988-11-06,1,0,"tam",-18
"11","Sun","November 13","W","","3-8",FALSE,"Detroit Lions",23,20,17,304,79,225,4,21,278,203,75,3,1988-11-13,-1,1,"tam",3
"12","Sun","November 20","L","","3-9",TRUE,"Chicago Bears",15,27,18,321,153,168,3,16,339,200,139,4,1988-11-20,1,0,"tam",-12
"13","Sun","November 27","L","","3-10",FALSE,"Atlanta Falcons",10,17,16,313,186,127,4,16,289,108,181,2,1988-11-27,-2,0,"tam",-7
"14","Sun","December 4","W","","4-10",TRUE,"Buffalo Bills",10,5,19,253,143,110,0,16,273,234,39,2,1988-12-04,2,1,"tam",5
"15","Sun","December 11","L","OT","4-11",FALSE,"New England Patriots",7,10,14,262,131,131,2,11,223,147,76,2,1988-12-11,0,0,"tam",-3
"16","Sun","December 18","W","","5-11",TRUE,"Detroit Lions",21,10,17,242,139,103,4,14,250,191,59,4,1988-12-18,0,1,"tam",11
"1","Sun","September 10","W","","1-0",FALSE,"Green Bay Packers",23,21,26,347,205,142,0,17,321,218,103,3,1989-09-10,3,1,"tam",2
"2","Sun","September 17","L","","1-1",TRUE,"San Francisco 49ers",16,20,13,217,126,91,3,22,307,244,63,3,1989-09-17,0,0,"tam",-4
"3","Sun","September 24","W","","2-1",TRUE,"New Orleans Saints",20,10,20,336,218,118,3,25,325,211,114,2,1989-09-24,-1,1,"tam",10
"4","Sun","October 1","L","","2-2",FALSE,"Minnesota Vikings",3,17,7,158,64,94,1,23,365,203,162,3,1989-10-01,2,0,"tam",-14
"5","Sun","October 8","W","","3-2",TRUE,"Chicago Bears",42,35,27,415,268,147,2,22,350,214,136,3,1989-10-08,1,1,"tam",7
"6","Sun","October 15","L","","3-3",TRUE,"Detroit Lions",16,17,14,191,103,88,1,20,376,237,139,4,1989-10-15,3,0,"tam",-1
"7","Sun","October 22","L","","3-4",FALSE,"Washington Redskins",28,32,13,297,296,1,2,24,388,209,179,2,1989-10-22,0,0,"tam",-4
"8","Sun","October 29","L","","3-5",FALSE,"Cincinnati Bengals",23,56,21,475,336,139,4,30,482,294,188,2,1989-10-29,-2,0,"tam",-33
"9","Sun","November 5","L","","3-6",TRUE,"Cleveland Browns",31,42,24,398,349,49,4,18,271,157,114,0,1989-11-05,-4,0,"tam",-11
"10","Sun","November 12","L","","3-7",TRUE,"Minnesota Vikings",10,24,13,201,111,90,2,18,303,145,158,1,1989-11-12,-1,0,"tam",-14
"11","Sun","November 19","W","","4-7",FALSE,"Chicago Bears",32,31,21,390,263,127,0,14,377,266,111,4,1989-11-19,4,1,"tam",1
"12","Sun","November 26","W","","5-7",FALSE,"Phoenix Cardinals",14,13,23,260,139,121,2,12,237,194,43,2,1989-11-26,0,1,"tam",1
"13","Sun","December 3","L","","5-8",TRUE,"Green Bay Packers",16,17,18,258,170,88,5,19,376,315,61,3,1989-12-03,-2,0,"tam",-1
"14","Sun","December 10","L","","5-9",FALSE,"Houston Oilers",17,20,23,353,287,66,2,15,284,149,135,2,1989-12-10,0,0,"tam",-3
"15","Sun","December 17","L","","5-10",FALSE,"Detroit Lions",7,33,6,225,163,62,5,24,382,212,170,2,1989-12-17,-3,0,"tam",-26
"16","Sun","December 24","L","","5-11",TRUE,"Pittsburgh Steelers",22,31,19,321,237,84,1,14,316,169,147,3,1989-12-24,2,0,"tam",-9
"1","Sun","September 9","W","","1-0",FALSE,"Detroit Lions",38,21,20,375,237,138,2,18,258,168,90,6,1990-09-09,4,1,"tam",17
"2","Sun","September 16","L","","1-1",TRUE,"Los Angeles Rams",14,35,13,255,194,61,2,22,389,253,136,0,1990-09-16,-2,0,"tam",-21
"3","Sun","September 23","W","","2-1",TRUE,"Detroit Lions",23,20,19,323,171,152,1,18,307,152,155,2,1990-09-23,1,1,"tam",3
"4","Sun","September 30","W","OT","3-1",FALSE,"Minnesota Vikings",23,20,15,336,150,186,1,24,414,244,170,2,1990-09-30,1,1,"tam",3
"5","Sun","October 7","L","","3-2",FALSE,"Dallas Cowboys",10,14,12,271,164,107,1,19,304,149,155,1,1990-10-07,0,0,"tam",-4
"6","Sun","October 14","W","","4-2",TRUE,"Green Bay Packers",26,14,15,356,256,100,1,22,381,345,36,6,1990-10-14,5,1,"tam",12
"7","Sun","October 21","L","","4-3",TRUE,"Dallas Cowboys",13,17,22,331,241,90,5,14,223,145,78,1,1990-10-21,-4,0,"tam",-4
"8","Sun","October 28","L","","4-4",FALSE,"San Diego Chargers",10,41,8,157,119,38,7,17,314,157,157,1,1990-10-28,-6,0,"tam",-31
"9","Sun","November 4","L","","4-5",TRUE,"Chicago Bears",6,26,9,205,113,92,6,21,378,191,187,3,1990-11-04,-3,0,"tam",-20
"10","Sun","November 11","L","","4-6",FALSE,"New Orleans Saints",7,35,15,199,110,89,3,17,295,84,211,2,1990-11-11,-1,0,"tam",-28
"11","Sun","November 18","L","","4-7",FALSE,"San Francisco 49ers",7,31,13,180,78,102,1,22,393,241,152,1,1990-11-18,0,0,"tam",-24
"12","Sun","November 25","L","","4-8",FALSE,"Green Bay Packers",10,20,19,322,261,61,2,16,331,187,144,1,1990-11-25,-1,0,"tam",-10
"13","Sun","December 2","W","","5-8",TRUE,"Atlanta Falcons",23,17,16,373,331,42,3,22,374,152,222,4,1990-12-02,1,1,"tam",6
"15","Sun","December 16","W","","6-8",TRUE,"Minnesota Vikings",26,13,13,345,146,199,2,20,433,377,56,8,1990-12-16,6,1,"tam",13
"16","Sun","December 23","L","","6-9",FALSE,"Chicago Bears",14,27,13,209,110,99,3,24,368,249,119,3,1990-12-23,0,0,"tam",-13
"17","Sun","December 30","L","","6-10",TRUE,"New York Jets",14,16,16,238,168,70,3,17,317,162,155,1,1990-12-30,-2,0,"tam",-2
"1","Sun","September 1","L","","0-1",FALSE,"New York Jets",13,16,15,277,190,87,2,19,271,152,119,0,1991-09-01,-2,0,"tam",-3
"2","Sun","September 8","L","","0-2",TRUE,"Chicago Bears",20,21,16,257,125,132,1,20,247,147,100,4,1991-09-08,3,0,"tam",-1
"3","Sun","September 15","L","","0-3",FALSE,"Green Bay Packers",13,15,17,305,231,74,1,21,340,243,97,1,1991-09-15,0,0,"tam",-2
"4","Sun","September 22","L","","0-4",TRUE,"Buffalo Bills",10,17,22,303,165,138,1,19,421,301,120,2,1991-09-22,1,0,"tam",-7
"5","Sun","September 29","L","","0-5",FALSE,"Detroit Lions",3,31,16,187,106,81,4,21,359,147,212,4,1991-09-29,0,0,"tam",-28
"6","Sun","October 6","W","","1-5",TRUE,"Philadelphia Eagles",14,13,12,193,133,60,6,12,171,54,117,4,1991-10-06,-2,1,"tam",1
"8","Sun","October 20","L","","1-6",FALSE,"New Orleans Saints",7,23,12,219,173,46,3,17,284,205,79,2,1991-10-20,-1,0,"tam",-16
"9","Sun","October 27","L","","1-7",TRUE,"Green Bay Packers",0,27,12,170,135,35,8,13,244,185,59,2,1991-10-27,-6,0,"tam",-27
"10","Sun","November 3","L","","1-8",FALSE,"Minnesota Vikings",13,28,16,231,105,126,5,18,315,153,162,0,1991-11-03,-5,0,"tam",-15
"11","Sun","November 10","W","","2-8",TRUE,"Detroit Lions",30,21,19,346,165,181,1,18,345,226,119,4,1991-11-10,3,1,"tam",9
"12","Sun","November 17","L","","2-9",FALSE,"Atlanta Falcons",7,43,15,249,207,42,3,20,358,226,132,0,1991-11-17,-3,0,"tam",-36
"13","Sun","November 24","L","","2-10",TRUE,"New York Giants",14,21,13,227,88,139,2,15,236,158,78,0,1991-11-24,-2,0,"tam",-7
"14","Sun","December 1","L","","2-11",FALSE,"Miami Dolphins",14,33,19,258,199,59,2,25,468,297,171,1,1991-12-01,-1,0,"tam",-19
"15","Sun","December 8","L","","2-12",TRUE,"Minnesota Vikings",24,26,20,373,328,45,0,22,436,140,296,0,1991-12-08,0,0,"tam",-2
"16","Sat","December 14","L","","2-13",FALSE,"Chicago Bears",0,27,7,106,54,52,4,23,254,72,182,0,1991-12-14,-4,0,"tam",-27
"17","Sun","December 22","W","","3-13",TRUE,"Indianapolis Colts",17,3,18,300,168,132,4,12,230,166,64,3,1991-12-22,-1,1,"tam",14
"1","Sun","September 6","W","","1-0",TRUE,"Phoenix Cardinals",23,7,17,268,140,128,0,14,181,120,61,3,1992-09-06,3,1,"tam",16
"2","Sun","September 13","W","","2-0",TRUE,"Green Bay Packers",31,3,21,395,333,62,1,16,215,106,109,3,1992-09-13,2,1,"tam",28
"3","Sun","September 20","L","","2-1",FALSE,"Minnesota Vikings",20,26,18,333,231,102,2,20,319,190,129,1,1992-09-20,-1,0,"tam",-6
"4","Sun","September 27","W","","3-1",FALSE,"Detroit Lions",27,23,21,395,248,147,3,18,368,298,70,1,1992-09-27,-2,1,"tam",4
"5","Sun","October 4","L","","3-2",TRUE,"Indianapolis Colts",14,24,28,359,243,116,3,15,293,224,69,3,1992-10-04,0,0,"tam",-10
"7","Sun","October 18","L","","3-3",FALSE,"Chicago Bears",14,31,18,298,172,126,3,18,391,298,93,1,1992-10-18,-2,0,"tam",-17
"8","Sun","October 25","L","","3-4",TRUE,"Detroit Lions",7,38,15,236,148,88,2,21,400,236,164,1,1992-10-25,-1,0,"tam",-31
"9","Sun","November 1","L","","3-5",FALSE,"New Orleans Saints",21,23,10,154,70,84,1,18,309,164,145,4,1992-11-01,3,0,"tam",-2
"10","Sun","November 8","L","","3-6",TRUE,"Minnesota Vikings",7,35,24,351,278,73,3,22,296,171,125,3,1992-11-08,0,0,"tam",-28
"11","Sun","November 15","W","","4-6",TRUE,"Chicago Bears",20,17,14,299,172,127,1,19,315,202,113,1,1992-11-15,0,1,"tam",3
"12","Sun","November 22","L","","4-7",FALSE,"San Diego Chargers",14,29,18,287,174,113,0,17,307,126,181,1,1992-11-22,1,0,"tam",-15
"13","Sun","November 29","L","","4-8",FALSE,"Green Bay Packers",14,19,14,281,152,129,5,17,283,218,65,1,1992-11-29,-4,0,"tam",-5
"14","Sun","December 6","L","","4-9",TRUE,"Los Angeles Rams",27,31,16,313,163,150,3,21,405,342,63,3,1992-12-06,0,0,"tam",-4
"15","Sun","December 13","L","","4-10",TRUE,"Atlanta Falcons",7,35,17,254,150,104,1,20,413,327,86,0,1992-12-13,-1,0,"tam",-28
"16","Sat","December 19","L","","4-11",FALSE,"San Francisco 49ers",14,21,18,308,181,127,0,19,337,255,82,1,1992-12-19,1,0,"tam",-7
"17","Sun","December 27","W","","5-11",FALSE,"Phoenix Cardinals",7,3,12,240,210,30,1,21,353,233,120,6,1992-12-27,5,1,"tam",4
"1","Sun","September 5","L","","0-1",TRUE,"Kansas City Chiefs",3,27,15,157,132,25,1,20,400,278,122,3,1993-09-05,2,0,"tam",-24
"2","Sun","September 12","L","","0-2",FALSE,"New York Giants",7,23,12,199,154,45,1,21,381,200,181,1,1993-09-12,0,0,"tam",-16
"4","Sun","September 26","L","","0-3",FALSE,"Chicago Bears",17,47,17,328,292,36,7,18,332,206,126,1,1993-09-26,-6,0,"tam",-30
"5","Sun","October 3","W","","1-3",TRUE,"Detroit Lions",27,10,14,324,196,128,1,17,311,167,144,3,1993-10-03,2,1,"tam",17
"6","Sun","October 10","L","","1-4",FALSE,"Minnesota Vikings",0,15,11,169,110,59,5,18,268,144,124,1,1993-10-10,-4,0,"tam",-15
"8","Sun","October 24","L","","1-5",TRUE,"Green Bay Packers",14,37,13,246,162,84,4,18,421,259,162,2,1993-10-24,-2,0,"tam",-23
"9","Sun","October 31","W","","2-5",FALSE,"Atlanta Falcons",31,24,16,405,307,98,2,16,337,269,68,3,1993-10-31,1,1,"tam",7
"10","Sun","November 7","L","","2-6",FALSE,"Detroit Lions",0,23,6,146,102,44,1,20,366,125,241,0,1993-11-07,-1,0,"tam",-23
"11","Sun","November 14","L","","2-7",TRUE,"San Francisco 49ers",21,45,18,322,228,94,4,27,448,324,124,0,1993-11-14,-4,0,"tam",-24
"12","Sun","November 21","W","","3-7",TRUE,"Minnesota Vikings",23,10,18,300,200,100,0,12,235,153,82,2,1993-11-21,2,1,"tam",13
"13","Sun","November 28","L","","3-8",FALSE,"Green Bay Packers",10,13,11,207,115,92,0,14,259,152,107,0,1993-11-28,0,0,"tam",-3
"14","Sun","December 5","L","","3-9",TRUE,"Washington Redskins",17,23,18,307,163,144,3,10,238,63,175,1,1993-12-05,-2,0,"tam",-6
"15","Sun","December 12","W","","4-9",TRUE,"Chicago Bears",13,10,13,215,112,103,1,18,286,167,119,2,1993-12-12,1,1,"tam",3
"16","Sun","December 19","L","","4-10",FALSE,"Los Angeles Raiders",20,27,24,366,265,101,2,17,265,248,17,0,1993-12-19,-2,0,"tam",-7
"17","Sun","December 26","W","","5-10",FALSE,"Denver Broncos",17,10,13,236,171,65,1,18,335,225,110,3,1993-12-26,2,1,"tam",7
"18","Sun","January 2","L","","5-11",TRUE,"San Diego Chargers",17,32,22,384,312,72,3,16,364,272,92,0,1994-01-02,-3,0,"tam",-15
"1","Sun","September 4","L","","0-1",FALSE,"Chicago Bears",9,21,17,304,181,123,0,17,270,204,66,0,1994-09-04,0,0,"tam",-12
"2","Sun","September 11","W","","1-1",TRUE,"Indianapolis Colts",24,10,13,367,313,54,0,20,364,201,163,1,1994-09-11,1,1,"tam",14
"3","Sun","September 18","L","","1-2",TRUE,"New Orleans Saints",7,9,16,232,147,85,1,12,233,176,57,0,1994-09-18,-1,0,"tam",-2
"4","Sun","September 25","L","","1-3",FALSE,"Green Bay Packers",3,30,15,231,177,54,3,24,401,306,95,0,1994-09-25,-3,0,"tam",-27
"5","Sun","October 2","W","","2-3",TRUE,"Detroit Lions",24,14,16,234,115,119,0,17,321,125,196,1,1994-10-02,1,1,"tam",10
"6","Sun","October 9","L","","2-4",FALSE,"Atlanta Falcons",13,34,19,320,288,32,3,20,356,271,85,3,1994-10-09,0,0,"tam",-21
"8","Sun","October 23","L","","2-5",FALSE,"San Francisco 49ers",16,41,17,235,125,110,1,28,451,270,181,1,1994-10-23,0,0,"tam",-25
"9","Sun","October 30","L","","2-6",TRUE,"Minnesota Vikings",13,36,14,234,185,49,5,19,361,212,149,2,1994-10-30,-3,0,"tam",-23
"10","Sun","November 6","L","","2-7",TRUE,"Chicago Bears",6,20,9,188,150,38,1,23,383,205,178,1,1994-11-06,0,0,"tam",-14
"11","Sun","November 13","L","","2-8",FALSE,"Detroit Lions",9,14,18,343,218,125,0,16,342,99,243,0,1994-11-13,0,0,"tam",-5
"12","Sun","November 20","L","","2-9",FALSE,"Seattle Seahawks",21,22,23,332,212,120,2,18,294,117,177,3,1994-11-20,1,0,"tam",-1
"13","Sun","November 27","W","OT","3-9",FALSE,"Minnesota Vikings",20,17,20,326,254,72,1,19,331,246,85,2,1994-11-27,1,1,"tam",3
"14","Sun","December 4","W","","4-9",TRUE,"Washington Redskins",26,21,28,464,251,213,2,7,268,258,10,3,1994-12-04,1,1,"tam",5
"15","Sun","December 11","W","","5-9",TRUE,"Los Angeles Rams",24,14,17,355,230,125,0,19,261,198,63,2,1994-12-11,2,1,"tam",10
"16","Sun","December 18","W","","6-9",FALSE,"Washington Redskins",17,14,20,375,267,108,2,14,267,194,73,0,1994-12-18,-2,1,"tam",3
"17","Sat","December 24","L","","6-10",TRUE,"Green Bay Packers",19,34,14,214,152,62,2,25,433,290,143,2,1994-12-24,0,0,"tam",-15
"1","Sun","September 3","W","","1-0",FALSE,"Philadelphia Eagles",21,6,15,285,202,83,1,20,273,162,111,2,1995-09-03,1,1,"tam",15
"2","Sun","September 10","L","","1-1",FALSE,"Cleveland Browns",6,22,24,311,210,101,4,19,323,253,70,1,1995-09-10,-3,0,"tam",-16
"3","Sun","September 17","L","","1-2",TRUE,"Chicago Bears",6,25,15,239,165,74,7,20,335,207,128,2,1995-09-17,-5,0,"tam",-19
"4","Sun","September 24","W","","2-2",TRUE,"Washington Redskins",14,6,15,236,123,113,1,23,311,216,95,2,1995-09-24,1,1,"tam",8
"5","Sun","October 1","W","","3-2",FALSE,"Carolina Panthers",20,13,16,310,252,58,0,20,393,234,159,4,1995-10-01,4,1,"tam",7
"6","Sun","October 8","W","","4-2",TRUE,"Cincinnati Bengals",19,16,20,299,182,117,0,13,312,204,108,6,1995-10-08,6,1,"tam",3
"7","Sun","October 15","W","OT","5-2",TRUE,"Minnesota Vikings",20,17,19,263,219,44,2,23,394,332,62,4,1995-10-15,2,1,"tam",3
"8","Sun","October 22","L","","5-3",TRUE,"Atlanta Falcons",21,24,16,258,169,89,0,23,389,268,121,1,1995-10-22,1,0,"tam",-3
"9","Sun","October 29","L","","5-4",FALSE,"Houston Oilers",7,19,10,155,61,94,3,22,275,156,119,1,1995-10-29,-2,0,"tam",-12
"11","Sun","November 12","L","","5-5",FALSE,"Detroit Lions",24,27,26,411,221,190,4,23,356,254,102,1,1995-11-12,-3,0,"tam",-3
"12","Sun","November 19","W","","6-5",TRUE,"Jacksonville Jaguars",17,16,17,246,101,145,0,19,350,263,87,1,1995-11-19,1,1,"tam",1
"13","Sun","November 26","L","","6-6",FALSE,"Green Bay Packers",13,35,22,325,283,42,0,22,369,261,108,0,1995-11-26,0,0,"tam",-22
"14","Sun","December 3","L","","6-7",FALSE,"Minnesota Vikings",17,31,17,256,166,90,2,22,451,261,190,2,1995-12-03,0,0,"tam",-14
"15","Sun","December 10","W","OT","7-7",TRUE,"Green Bay Packers",13,10,19,345,218,127,2,20,346,285,61,1,1995-12-10,-1,1,"tam",3
"16","Sun","December 17","L","","7-8",FALSE,"Chicago Bears",10,31,15,289,213,76,4,23,429,256,173,1,1995-12-17,-3,0,"tam",-21
"17","Sat","December 23","L","","7-9",TRUE,"Detroit Lions",10,37,17,314,170,144,4,24,406,346,60,1,1995-12-23,-3,0,"tam",-27
"1","Sun","September 1","L","","0-1",TRUE,"Green Bay Packers",3,34,15,176,117,59,6,24,406,267,139,2,1996-09-01,-4,0,"tam",-31
"2","Sun","September 8","L","","0-2",FALSE,"Detroit Lions",6,21,13,274,200,74,4,12,234,114,120,1,1996-09-08,-3,0,"tam",-15
"3","Sun","September 15","L","","0-3",FALSE,"Denver Broncos",23,27,15,307,186,121,2,20,374,180,194,3,1996-09-15,1,0,"tam",-4
"4","Sun","September 22","L","","0-4",TRUE,"Seattle Seahawks",13,17,14,217,106,111,1,22,322,198,124,1,1996-09-22,0,0,"tam",-4
"5","Sun","September 29","L","","0-5",TRUE,"Detroit Lions",0,27,13,226,156,70,4,20,350,221,129,0,1996-09-29,-4,0,"tam",-27
"7","Sun","October 13","W","","1-5",TRUE,"Minnesota Vikings",24,13,20,284,208,76,0,17,394,255,139,3,1996-10-13,3,1,"tam",11
"8","Sun","October 20","L","","1-6",FALSE,"Arizona Cardinals",9,13,19,313,218,95,0,21,237,133,104,0,1996-10-20,0,0,"tam",-4
"9","Sun","October 27","L","","1-7",FALSE,"Green Bay Packers",7,13,14,196,139,57,2,24,298,169,129,2,1996-10-27,0,0,"tam",-6
"10","Sun","November 3","L","","1-8",FALSE,"Chicago Bears",10,13,14,245,178,67,2,18,269,84,185,1,1996-11-03,-1,0,"tam",-3
"11","Sun","November 10","W","OT","2-8",TRUE,"Oakland Raiders",20,17,27,339,177,162,2,17,271,182,89,1,1996-11-10,-1,1,"tam",3
"12","Sun","November 17","W","","3-8",FALSE,"San Diego Chargers",25,17,23,423,324,99,3,11,277,183,94,3,1996-11-17,0,1,"tam",8
"13","Sun","November 24","W","","4-8",TRUE,"New Orleans Saints",13,7,15,381,251,130,2,14,242,184,58,4,1996-11-24,2,1,"tam",6
"14","Sun","December 1","L","","4-9",FALSE,"Carolina Panthers",0,24,17,284,206,78,4,13,215,83,132,0,1996-12-01,-4,0,"tam",-24
"15","Sun","December 8","W","","5-9",TRUE,"Washington Redskins",24,10,18,301,92,209,0,17,247,206,41,2,1996-12-08,2,1,"tam",14
"16","Sun","December 15","L","","5-10",FALSE,"Minnesota Vikings",10,21,8,169,77,92,2,21,339,194,145,4,1996-12-15,2,0,"tam",-11
"17","Sun","December 22","W","","6-10",TRUE,"Chicago Bears",34,19,15,181,92,89,0,25,339,272,67,2,1996-12-22,2,1,"tam",15
"1","Sun","August 31","W","","1-0",TRUE,"San Francisco 49ers",13,6,15,271,156,115,2,12,191,91,100,1,1997-08-31,-1,1,"tam",7
"2","Sun","September 7","W","","2-0",FALSE,"Detroit Lions",24,17,20,272,99,173,0,13,346,322,24,1,1997-09-07,1,1,"tam",7
"3","Sun","September 14","W","","3-0",FALSE,"Minnesota Vikings",28,14,17,376,185,191,0,20,382,310,72,2,1997-09-14,2,1,"tam",14
"4","Sun","September 21","W","","4-0",TRUE,"Miami Dolphins",31,21,24,357,248,109,1,21,283,235,48,0,1997-09-21,-1,1,"tam",10
"5","Sun","September 28","W","","5-0",TRUE,"Arizona Cardinals",19,18,6,167,113,54,1,23,364,294,70,3,1997-09-28,2,1,"tam",1
"6","Sun","October 5","L","","5-1",FALSE,"Green Bay Packers",16,21,23,372,155,217,2,13,234,170,64,1,1997-10-05,-1,0,"tam",-5
"7","Sun","October 12","L","","5-2",TRUE,"Detroit Lions",9,27,13,289,217,72,2,17,447,188,259,1,1997-10-12,-1,0,"tam",-18
"9","Sun","October 26","L","","5-3",TRUE,"Minnesota Vikings",6,10,11,229,177,52,0,16,308,214,94,0,1997-10-26,0,0,"tam",-4
"10","Sun","November 2","W","","6-3",FALSE,"Indianapolis Colts",31,28,18,234,150,84,1,23,359,212,147,3,1997-11-02,2,1,"tam",3
"11","Sun","November 9","W","","7-3",FALSE,"Atlanta Falcons",31,10,20,349,150,199,0,18,275,173,102,2,1997-11-09,2,1,"tam",21
"12","Sun","November 16","W","","8-3",TRUE,"New England Patriots",27,7,21,348,202,146,2,10,168,93,75,3,1997-11-16,1,1,"tam",20
"13","Sun","November 23","L","","8-4",FALSE,"Chicago Bears",7,13,14,272,237,35,3,17,279,110,169,0,1997-11-23,-3,0,"tam",-6
"14","Sun","November 30","W","","9-4",FALSE,"New York Giants",20,8,21,299,152,147,3,13,202,103,99,2,1997-11-30,-1,1,"tam",12
"15","Sun","December 7","L","","9-5",TRUE,"Green Bay Packers",6,17,8,161,94,67,2,20,362,280,82,3,1997-12-07,1,0,"tam",-11
"16","Sun","December 14","L","","9-6",FALSE,"New York Jets",0,31,6,111,21,90,3,14,234,112,122,1,1997-12-14,-2,0,"tam",-31
"17","Sun","December 21","W","","10-6",TRUE,"Chicago Bears",31,15,12,269,86,183,1,15,194,104,90,3,1997-12-21,2,1,"tam",16
"WildCard","Sun","December 28","W","","11-6",TRUE,"Detroit Lions",20,10,15,316,175,141,2,18,307,198,109,1,1997-12-28,-1,1,"tam",10
"Division","Sun","January 4","L","","11-7",FALSE,"Green Bay Packers",7,21,15,263,173,90,2,16,289,171,118,3,1998-01-04,1,0,"tam",-14
"1","Sun","September 6","L","","0-1",FALSE,"Minnesota Vikings",7,31,17,319,251,68,2,19,298,181,117,1,1998-09-06,-1,0,"tam",-24
"2","Sun","September 13","L","","0-2",FALSE,"Green Bay Packers",15,23,17,211,161,50,4,15,260,223,37,2,1998-09-13,-2,0,"tam",-8
"3","Sun","September 20","W","","1-2",TRUE,"Chicago Bears",27,15,20,364,144,220,2,13,254,169,85,2,1998-09-20,0,1,"tam",12
"4","Mon","September 28","L","","1-3",FALSE,"Detroit Lions",6,27,6,133,78,55,2,17,280,124,156,1,1998-09-28,-1,0,"tam",-21
"5","Sun","October 4","W","","2-3",TRUE,"New York Giants",20,3,16,234,60,174,2,8,135,71,64,3,1998-10-04,1,1,"tam",17
"7","Sun","October 18","W","","3-3",TRUE,"Carolina Panthers",16,13,21,349,213,136,2,17,290,223,67,0,1998-10-18,-2,1,"tam",3
"8","Sun","October 25","L","","3-4",FALSE,"New Orleans Saints",3,9,11,238,180,58,3,12,266,210,56,1,1998-10-25,-2,0,"tam",-6
"9","Sun","November 1","W","","4-4",TRUE,"Minnesota Vikings",27,24,22,378,132,246,0,18,340,270,70,1,1998-11-01,1,1,"tam",3
"10","Sun","November 8","L","","4-5",TRUE,"Tennessee Oilers",22,31,19,397,294,103,1,20,353,117,236,1,1998-11-08,0,0,"tam",-9
"11","Sun","November 15","L","","4-6",FALSE,"Jacksonville Jaguars",24,29,13,343,186,157,3,18,374,230,144,0,1998-11-15,-3,0,"tam",-5
"12","Sun","November 22","L","","4-7",TRUE,"Detroit Lions",25,28,22,428,283,145,2,19,300,188,112,0,1998-11-22,-2,0,"tam",-3
"13","Sun","November 29","W","","5-7",FALSE,"Chicago Bears",31,17,13,267,153,114,2,13,224,155,69,2,1998-11-29,0,1,"tam",14
"14","Mon","December 7","W","","6-7",TRUE,"Green Bay Packers",24,22,12,283,178,105,1,23,333,228,105,2,1998-12-07,1,1,"tam",2
"15","Sun","December 13","W","","7-7",TRUE,"Pittsburgh Steelers",16,3,14,253,109,144,1,10,166,78,88,5,1998-12-13,4,1,"tam",13
"16","Sat","December 19","L","","7-8",FALSE,"Washington Redskins",16,20,17,237,87,150,3,11,226,136,90,2,1998-12-19,-1,0,"tam",-4
"17","Sun","December 27","W","","8-8",FALSE,"Cincinnati Bengals",35,0,22,320,97,223,1,11,246,159,87,3,1998-12-27,2,1,"tam",35
"1","Sun","September 12","L","","0-1",TRUE,"New York Giants",13,17,15,254,177,77,5,4,107,79,28,0,1999-09-12,-5,0,"tam",-4
"2","Sun","September 19","W","","1-1",FALSE,"Philadelphia Eagles",19,5,16,220,64,156,2,9,150,66,84,1,1999-09-19,-1,1,"tam",14
"3","Sun","September 26","W","","2-1",TRUE,"Denver Broncos",13,10,17,243,78,165,2,8,173,120,53,1,1999-09-26,-1,1,"tam",3
"4","Sun","October 3","L","","2-2",FALSE,"Minnesota Vikings",14,21,22,370,286,84,2,20,364,296,68,1,1999-10-03,-1,0,"tam",-7
"5","Sun","October 10","L","","2-3",FALSE,"Green Bay Packers",23,26,21,273,100,173,4,18,450,352,98,1,1999-10-10,-3,0,"tam",-3
"7","Sun","October 24","W","","3-3",TRUE,"Chicago Bears",6,3,11,225,101,124,0,15,275,189,86,2,1999-10-24,2,1,"tam",3
"8","Sun","October 31","L","","3-4",FALSE,"Detroit Lions",3,20,18,292,220,72,2,13,256,109,147,0,1999-10-31,-2,0,"tam",-17
"9","Sun","November 7","W","","4-4",FALSE,"New Orleans Saints",31,16,18,381,225,156,2,21,303,205,98,3,1999-11-07,1,1,"tam",15
"10","Sun","November 14","W","","5-4",TRUE,"Kansas City Chiefs",17,10,14,370,270,100,6,11,271,184,87,3,1999-11-14,-3,1,"tam",7
"11","Sun","November 21","W","","6-4",TRUE,"Atlanta Falcons",19,10,12,239,120,119,1,9,168,92,76,2,1999-11-21,1,1,"tam",9
"12","Sun","November 28","W","","7-4",FALSE,"Seattle Seahawks",16,3,9,156,51,105,0,15,259,170,89,6,1999-11-28,6,1,"tam",13
"13","Mon","December 6","W","","8-4",TRUE,"Minnesota Vikings",24,17,13,190,87,103,3,21,339,246,93,4,1999-12-06,1,1,"tam",7
"14","Sun","December 12","W","","9-4",TRUE,"Detroit Lions",23,16,17,312,271,41,2,16,265,210,55,1,1999-12-12,-1,1,"tam",7
"15","Sun","December 19","L","","9-5",FALSE,"Oakland Raiders",0,45,9,137,103,34,3,21,400,138,262,0,1999-12-19,-3,0,"tam",-45
"16","Sun","December 26","W","","10-5",TRUE,"Green Bay Packers",29,10,17,274,150,124,1,14,243,231,12,4,1999-12-26,3,1,"tam",19
"17","Sun","January 2","W","","11-5",FALSE,"Chicago Bears",20,6,16,318,175,143,0,13,257,186,71,2,2000-01-02,2,1,"tam",14
"Division","Sat","January 15","W","","12-5",TRUE,"Washington Redskins",14,13,12,186,142,44,1,10,157,111,46,2,2000-01-15,1,1,"tam",1
"ConfChamp","Sun","January 23","L","","12-6",FALSE,"St. Louis Rams",6,11,12,203,126,77,2,17,309,258,51,3,2000-01-23,1,0,"tam",-5
"1","Sun","September 3","W","","1-0",FALSE,"New England Patriots",21,16,17,296,156,140,1,14,278,190,88,1,2000-09-03,0,1,"tam",5
"2","Sun","September 10","W","","2-0",TRUE,"Chicago Bears",41,0,21,327,171,156,0,9,165,49,116,4,2000-09-10,4,1,"tam",41
"3","Sun","September 17","W","","3-0",FALSE,"Detroit Lions",31,10,22,331,211,120,0,13,243,226,17,3,2000-09-17,3,1,"tam",21
"4","Sun","September 24","L","","3-1",TRUE,"New York Jets",17,21,12,239,120,119,4,16,296,198,98,3,2000-09-24,-1,0,"tam",-4
"5","Sun","October 1","L","OT","3-2",FALSE,"Washington Redskins",17,20,16,255,183,72,2,14,330,185,145,1,2000-10-01,-1,0,"tam",-3
"6","Mon","October 9","L","","3-3",FALSE,"Minnesota Vikings",23,30,22,346,283,63,3,17,322,207,115,2,2000-10-09,-1,0,"tam",-7
"8","Thu","October 19","L","","3-4",TRUE,"Detroit Lions",14,28,12,258,149,109,4,21,277,107,170,0,2000-10-19,-4,0,"tam",-14
"9","Sun","October 29","W","","4-4",TRUE,"Minnesota Vikings",41,13,23,413,261,152,0,25,401,302,99,3,2000-10-29,3,1,"tam",28
"10","Sun","November 5","W","","5-4",FALSE,"Atlanta Falcons",27,14,15,267,141,126,2,22,283,224,59,4,2000-11-05,2,1,"tam",13
"11","Sun","November 12","W","","6-4",TRUE,"Green Bay Packers",20,15,14,272,164,108,1,16,302,205,97,1,2000-11-12,0,1,"tam",5
"12","Sun","November 19","L","","6-5",FALSE,"Chicago Bears",10,13,14,225,60,165,3,15,243,160,83,1,2000-11-19,-2,0,"tam",-3
"13","Sun","November 26","W","","7-5",TRUE,"Buffalo Bills",31,17,13,180,66,114,0,25,433,294,139,2,2000-11-26,2,1,"tam",14
"14","Sun","December 3","W","","8-5",TRUE,"Dallas Cowboys",27,7,17,301,51,250,1,19,266,153,113,4,2000-12-03,3,1,"tam",20
"15","Sun","December 10","W","","9-5",FALSE,"Miami Dolphins",16,13,14,221,121,100,1,17,254,170,84,5,2000-12-10,4,1,"tam",3
"16","Mon","December 18","W","","10-5",TRUE,"St. Louis Rams",38,35,27,446,241,205,2,19,388,298,90,3,2000-12-18,1,1,"tam",3
"17","Sun","December 24","L","OT","10-6",FALSE,"Green Bay Packers",14,17,16,272,205,67,0,21,319,184,135,4,2000-12-24,4,0,"tam",-3
"WildCard","Sun","December 31","L","","10-7",FALSE,"Philadelphia Eagles",3,21,11,199,149,50,1,20,277,151,126,1,2000-12-31,0,0,"tam",-18
"1","Sun","September 9","W","","1-0",FALSE,"Dallas Cowboys",10,6,19,263,192,71,2,8,127,28,99,3,2001-09-09,1,1,"tam",4
"3","Sun","September 30","L","","1-1",FALSE,"Minnesota Vikings",16,20,20,331,223,108,1,25,402,312,90,2,2001-09-30,1,0,"tam",-4
"4","Sun","October 7","W","","2-1",TRUE,"Green Bay Packers",14,10,12,253,154,99,1,15,322,253,69,3,2001-10-07,2,1,"tam",4
"5","Sun","October 14","L","OT","2-2",FALSE,"Tennessee Titans",28,31,22,306,282,24,1,21,365,223,142,1,2001-10-14,0,0,"tam",-3
"6","Sun","October 21","L","","2-3",TRUE,"Pittsburgh Steelers",10,17,19,278,214,64,1,17,344,124,220,3,2001-10-21,2,0,"tam",-7
"7","Sun","October 28","W","","3-3",TRUE,"Minnesota Vikings",41,14,26,446,269,177,1,11,195,130,65,1,2001-10-28,0,1,"tam",27
"8","Sun","November 4","L","","3-4",FALSE,"Green Bay Packers",20,21,15,194,133,61,0,16,352,168,184,3,2001-11-04,3,0,"tam",-1
"9","Sun","November 11","W","","4-4",FALSE,"Detroit Lions",20,17,16,274,175,99,1,19,270,218,52,3,2001-11-11,2,1,"tam",3
"10","Sun","November 18","L","","4-5",TRUE,"Chicago Bears",24,27,26,414,395,19,4,13,274,206,68,1,2001-11-18,-3,0,"tam",-3
"11","Mon","November 26","W","","5-5",FALSE,"St. Louis Rams",24,17,18,264,173,91,1,19,345,269,76,6,2001-11-26,5,1,"tam",7
"12","Sun","December 2","W","OT","6-5",FALSE,"Cincinnati Bengals",16,13,19,264,199,65,1,17,201,115,86,2,2001-12-02,1,1,"tam",3
"13","Sun","December 9","W","","7-5",TRUE,"Detroit Lions",15,12,24,356,275,81,2,14,253,151,102,1,2001-12-09,-1,1,"tam",3
"14","Sun","December 16","L","","7-6",FALSE,"Chicago Bears",3,27,10,238,177,61,4,21,379,172,207,1,2001-12-16,-3,0,"tam",-24
"15","Sun","December 23","W","","8-6",TRUE,"New Orleans Saints",48,21,23,364,207,157,0,16,271,230,41,4,2001-12-23,4,1,"tam",27
"16","Sat","December 29","W","","9-6",TRUE,"Baltimore Ravens",22,10,13,213,90,123,0,15,257,167,90,3,2001-12-29,3,1,"tam",12
"17","Sun","January 6","L","","9-7",TRUE,"Philadelphia Eagles",13,17,16,236,165,71,2,15,296,185,111,2,2002-01-06,0,0,"tam",-4
"WildCard","Sat","January 12","L","","9-8",FALSE,"Philadelphia Eagles",9,31,16,258,195,63,4,17,334,186,148,1,2002-01-12,-3,0,"tam",-22
"1","Sun","September 8","L","OT","0-1",TRUE,"New Orleans Saints",20,26,19,333,261,72,1,21,368,250,118,1,2002-09-08,0,0,"tam",-6
"2","Sun","September 15","W","","1-1",FALSE,"Baltimore Ravens",25,0,17,279,205,74,0,12,173,118,55,1,2002-09-15,1,1,"tam",25
"3","Mon","September 23","W","","2-1",TRUE,"St. Louis Rams",26,14,14,252,189,63,1,21,358,269,89,4,2002-09-23,3,1,"tam",12
"4","Sun","September 29","W","","3-1",FALSE,"Cincinnati Bengals",35,7,17,363,262,101,3,11,168,94,74,2,2002-09-29,-1,1,"tam",28
"5","Sun","October 6","W","","4-1",FALSE,"Atlanta Falcons",20,6,15,327,253,74,2,14,243,173,70,4,2002-10-06,2,1,"tam",14
"6","Sun","October 13","W","","5-1",TRUE,"Cleveland Browns",17,3,22,380,194,186,1,11,194,134,60,1,2002-10-13,0,1,"tam",14
"7","Sun","October 20","L","","5-2",FALSE,"Philadelphia Eagles",10,20,15,207,126,81,2,14,269,110,159,2,2002-10-20,0,0,"tam",-10
"8","Sun","October 27","W","","6-2",FALSE,"Carolina Panthers",12,9,14,226,155,71,2,9,130,20,110,4,2002-10-27,2,1,"tam",3
"9","Sun","November 3","W","","7-2",TRUE,"Minnesota Vikings",38,24,27,446,313,133,0,22,387,214,173,3,2002-11-03,3,1,"tam",14
"11","Sun","November 17","W","","8-2",TRUE,"Carolina Panthers",23,10,19,314,247,67,2,14,231,168,63,4,2002-11-17,2,1,"tam",13
"12","Sun","November 24","W","","9-2",TRUE,"Green Bay Packers",21,7,14,246,153,93,1,15,267,171,96,4,2002-11-24,3,1,"tam",14
"13","Sun","December 1","L","","9-3",FALSE,"New Orleans Saints",20,23,17,283,249,34,3,14,238,136,102,1,2002-12-01,-2,0,"tam",-3
"14","Sun","December 8","W","","10-3",TRUE,"Atlanta Falcons",34,10,22,421,271,150,0,10,181,119,62,1,2002-12-08,1,1,"tam",24
"15","Sun","December 15","W","","11-3",FALSE,"Detroit Lions",23,20,22,376,253,123,0,15,292,148,144,1,2002-12-15,1,1,"tam",3
"16","Mon","December 23","L","","11-4",TRUE,"Pittsburgh Steelers",7,17,18,277,203,74,3,19,327,233,94,1,2002-12-23,-2,0,"tam",-10
"17","Sun","December 29","W","","12-4",FALSE,"Chicago Bears",15,0,15,272,111,161,0,14,218,133,85,4,2002-12-29,4,1,"tam",15
"Division","Sun","January 12","W","","13-4",TRUE,"San Francisco 49ers",31,6,21,329,208,121,2,14,228,166,62,5,2003-01-12,3,1,"tam",25
"ConfChamp","Sun","January 19","W","","14-4",FALSE,"Philadelphia Eagles",27,10,15,308,259,49,1,20,312,232,80,3,2003-01-19,2,1,"tam",17
"SuperBowl","Sun","January 26","W","","15-4",TRUE,"Oakland Raiders",48,21,24,365,215,150,1,11,269,250,19,5,2003-01-26,4,1,"tam",27
"1","Mon","September 8","W","","1-0",FALSE,"Philadelphia Eagles",17,0,19,328,238,90,1,13,245,124,121,2,2003-09-08,1,1,"tam",17
"2","Sun","September 14","L","OT","1-1",TRUE,"Carolina Panthers",9,12,25,397,337,60,1,14,258,87,171,2,2003-09-14,1,0,"tam",-3
"3","Sun","September 21","W","","2-1",FALSE,"Atlanta Falcons",31,10,18,316,184,132,1,13,136,107,29,5,2003-09-21,4,1,"tam",21
"5","Mon","October 6","L","OT","2-2",TRUE,"Indianapolis Colts",35,38,25,457,318,139,1,24,455,381,74,2,2003-10-06,1,0,"tam",-3
"6","Sun","October 12","W","","3-2",FALSE,"Washington Redskins",35,13,25,379,268,111,0,19,275,207,68,3,2003-10-12,3,1,"tam",22
"7","Sun","October 19","L","","3-3",FALSE,"San Francisco 49ers",7,24,14,326,258,68,4,22,458,246,212,2,2003-10-19,-2,0,"tam",-17
"8","Sun","October 26","W","","4-3",TRUE,"Dallas Cowboys",16,0,14,261,133,128,0,9,178,118,60,3,2003-10-26,3,1,"tam",16
"9","Sun","November 2","L","","4-4",TRUE,"New Orleans Saints",14,17,21,352,296,56,6,10,257,133,124,1,2003-11-02,-5,0,"tam",-3
"10","Sun","November 9","L","","4-5",FALSE,"Carolina Panthers",24,27,18,347,258,89,1,18,341,263,78,2,2003-11-09,1,0,"tam",-3
"11","Sun","November 16","L","","4-6",TRUE,"Green Bay Packers",13,20,10,285,131,154,3,15,282,92,190,1,2003-11-16,-2,0,"tam",-7
"12","Mon","November 24","W","","5-6",TRUE,"New York Giants",19,13,21,358,265,93,3,12,212,133,79,4,2003-11-24,1,1,"tam",6
"13","Sun","November 30","L","","5-7",FALSE,"Jacksonville Jaguars",10,17,16,221,144,77,1,21,359,224,135,1,2003-11-30,0,0,"tam",-7
"14","Sun","December 7","W","","6-7",FALSE,"New Orleans Saints",14,7,16,314,207,107,1,16,292,202,90,3,2003-12-07,2,1,"tam",7
"15","Sun","December 14","W","","7-7",TRUE,"Houston Texans",16,3,24,398,237,161,0,7,107,42,65,0,2003-12-14,0,1,"tam",13
"16","Sat","December 20","L","","7-8",TRUE,"Atlanta Falcons",28,30,25,440,346,94,4,16,267,119,148,1,2003-12-20,-3,0,"tam",-2
"17","Sun","December 28","L","","7-9",FALSE,"Tennessee Titans",13,33,16,274,185,89,4,20,344,232,112,1,2003-12-28,-3,0,"tam",-20
"1","Sun","September 12","L","","0-1",FALSE,"Washington Redskins",10,16,10,169,139,30,2,13,291,125,166,1,2004-09-12,-1,0,"tam",-6
"2","Sun","September 19","L","","0-2",TRUE,"Seattle Seahawks",6,10,17,271,179,92,3,9,182,124,58,1,2004-09-19,-2,0,"tam",-4
"3","Sun","September 26","L","","0-3",FALSE,"Oakland Raiders",20,30,19,389,297,92,1,23,399,226,173,2,2004-09-26,1,0,"tam",-10
"4","Sun","October 3","L","","0-4",TRUE,"Denver Broncos",13,16,12,269,159,110,1,19,249,138,111,0,2004-10-03,-1,0,"tam",-3
"5","Sun","October 10","W","","1-4",FALSE,"New Orleans Saints",20,17,16,319,238,81,1,16,251,106,145,2,2004-10-10,1,1,"tam",3
"6","Mon","October 18","L","","1-5",FALSE,"St. Louis Rams",21,28,17,332,277,55,4,14,324,230,94,2,2004-10-18,-2,0,"tam",-7
"7","Sun","October 24","W","","2-5",TRUE,"Chicago Bears",19,7,17,293,155,138,2,11,167,91,76,2,2004-10-24,0,1,"tam",12
"9","Sun","November 7","W","","3-5",TRUE,"Kansas City Chiefs",34,31,23,418,288,130,0,27,459,354,105,3,2004-11-07,3,1,"tam",3
"10","Sun","November 14","L","","3-6",FALSE,"Atlanta Falcons",14,24,14,193,125,68,1,18,325,120,205,1,2004-11-14,0,0,"tam",-10
"11","Sun","November 21","W","","4-6",TRUE,"San Francisco 49ers",35,3,19,352,193,159,2,13,197,125,72,2,2004-11-21,0,1,"tam",32
"12","Sun","November 28","L","","4-7",FALSE,"Carolina Panthers",14,21,20,398,336,62,3,15,300,188,112,1,2004-11-28,-2,0,"tam",-7
"13","Sun","December 5","W","","5-7",TRUE,"Atlanta Falcons",27,0,16,247,115,132,1,13,255,92,163,5,2004-12-05,4,1,"tam",27
"14","Sun","December 12","L","","5-8",FALSE,"San Diego Chargers",24,31,21,436,373,63,4,18,336,206,130,3,2004-12-12,-1,0,"tam",-7
"15","Sun","December 19","L","","5-9",TRUE,"New Orleans Saints",17,21,17,283,114,169,4,15,247,132,115,1,2004-12-19,-3,0,"tam",-4
"16","Sun","December 26","L","","5-10",TRUE,"Carolina Panthers",20,37,22,345,299,46,3,22,348,207,141,0,2004-12-26,-3,0,"tam",-17
"17","Sun","January 2","L","","5-11",FALSE,"Arizona Cardinals",7,12,11,249,187,62,4,12,222,115,107,1,2005-01-02,-3,0,"tam",-5
"1","Sun","September 11","W","","1-0",FALSE,"Minnesota Vikings",24,13,12,345,199,146,2,15,248,215,33,5,2005-09-11,3,1,"tam",11
"2","Sun","September 18","W","","2-0",TRUE,"Buffalo Bills",19,3,18,318,127,191,0,8,147,100,47,0,2005-09-18,0,1,"tam",16
"3","Sun","September 25","W","","3-0",FALSE,"Green Bay Packers",17,16,19,293,132,161,1,15,260,185,75,4,2005-09-25,3,1,"tam",1
"4","Sun","October 2","W","","4-0",TRUE,"Detroit Lions",17,13,17,353,284,69,4,11,226,135,91,1,2005-10-02,-3,1,"tam",4
"5","Sun","October 9","L","","4-1",FALSE,"New York Jets",12,14,20,285,201,84,1,15,212,150,62,3,2005-10-09,2,0,"tam",-2
"6","Sun","October 16","W","","5-1",TRUE,"Miami Dolphins",27,13,15,342,162,180,1,13,307,243,64,2,2005-10-16,1,1,"tam",14
"8","Sun","October 30","L","","5-2",FALSE,"San Francisco 49ers",10,15,13,275,232,43,3,9,208,50,158,0,2005-10-30,-3,0,"tam",-5
"9","Sun","November 6","L","","5-3",TRUE,"Carolina Panthers",14,34,18,270,226,44,4,15,287,210,77,0,2005-11-06,-4,0,"tam",-20
"10","Sun","November 13","W","","6-3",TRUE,"Washington Redskins",36,35,19,340,279,61,1,23,389,204,185,3,2005-11-13,2,1,"tam",1
"11","Sun","November 20","W","","7-3",FALSE,"Atlanta Falcons",30,27,15,258,118,140,1,26,443,293,150,2,2005-11-20,1,1,"tam",3
"12","Sun","November 27","L","","7-4",TRUE,"Chicago Bears",10,13,15,275,168,107,1,15,239,121,118,1,2005-11-27,0,0,"tam",-3
"13","Sun","December 4","W","","8-4",FALSE,"New Orleans Saints",10,3,14,248,115,133,0,16,279,214,65,4,2005-12-04,4,1,"tam",7
"14","Sun","December 11","W","","9-4",FALSE,"Carolina Panthers",20,10,17,247,133,114,0,14,276,194,82,1,2005-12-11,1,1,"tam",10
"15","Sat","December 17","L","","9-5",FALSE,"New England Patriots",0,28,12,138,108,30,1,22,336,253,83,0,2005-12-17,-1,0,"tam",-28
"16","Sat","December 24","W","OT","10-5",TRUE,"Atlanta Falcons",27,24,30,444,270,174,3,19,281,127,154,1,2005-12-24,-2,1,"tam",3
"17","Sun","January 1","W","","11-5",TRUE,"New Orleans Saints",27,13,14,285,136,149,0,18,306,235,71,3,2006-01-01,3,1,"tam",14
"WildCard","Sat","January 7","L","","11-6",TRUE,"Washington Redskins",10,17,17,243,168,75,3,9,120,25,95,1,2006-01-07,-2,0,"tam",-7
"1","Sun","September 10","L","","0-1",TRUE,"Baltimore Ravens",0,27,8,142,116,26,3,16,271,168,103,0,2006-09-10,-3,0,"tam",-27
"2","Sun","September 17","L","","0-2",FALSE,"Atlanta Falcons",3,14,22,351,311,40,3,22,382,76,306,2,2006-09-17,-1,0,"tam",-11
"3","Sun","September 24","L","","0-3",TRUE,"Carolina Panthers",24,26,13,209,145,64,2,22,350,249,101,3,2006-09-24,1,0,"tam",-2
"5","Sun","October 8","L","","0-4",FALSE,"New Orleans Saints",21,24,18,406,219,187,1,15,314,171,143,0,2006-10-08,-1,0,"tam",-3
"6","Sun","October 15","W","","1-4",TRUE,"Cincinnati Bengals",14,13,21,300,174,126,1,14,305,252,53,0,2006-10-15,-1,1,"tam",1
"7","Sun","October 22","W","","2-4",TRUE,"Philadelphia Eagles",23,21,14,196,85,111,0,22,506,298,208,4,2006-10-22,4,1,"tam",2
"8","Sun","October 29","L","","2-5",FALSE,"New York Giants",3,17,10,174,134,40,1,16,251,143,108,0,2006-10-29,-1,0,"tam",-14
"9","Sun","November 5","L","","2-6",TRUE,"New Orleans Saints",14,31,11,226,158,68,1,19,363,314,49,0,2006-11-05,-1,0,"tam",-17
"10","Mon","November 13","L","","2-7",FALSE,"Carolina Panthers",10,24,13,222,153,69,4,17,318,240,78,2,2006-11-13,-2,0,"tam",-14
"11","Sun","November 19","W","","3-7",TRUE,"Washington Redskins",20,17,19,359,178,181,2,15,252,193,59,1,2006-11-19,-1,1,"tam",3
"12","Thu","November 23","L","","3-8",FALSE,"Dallas Cowboys",10,38,10,211,110,101,2,27,435,298,137,0,2006-11-23,-2,0,"tam",-28
"13","Sun","December 3","L","","3-9",FALSE,"Pittsburgh Steelers",3,20,16,254,144,110,4,13,267,191,76,1,2006-12-03,-3,0,"tam",-17
"14","Sun","December 10","L","","3-10",TRUE,"Atlanta Falcons",6,17,15,272,192,80,2,15,280,141,139,1,2006-12-10,-1,0,"tam",-11
"15","Sun","December 17","L","OT","3-11",FALSE,"Chicago Bears",31,34,11,357,300,57,2,27,446,312,134,1,2006-12-17,-1,0,"tam",-3
"16","Sun","December 24","W","","4-11",FALSE,"Cleveland Browns",22,7,21,355,202,153,2,12,187,96,91,4,2006-12-24,2,1,"tam",15
"17","Sun","December 31","L","","4-12",TRUE,"Seattle Seahawks",7,23,15,287,177,110,2,28,344,212,132,1,2006-12-31,-1,0,"tam",-16
"1","Sun","September 9","L","","0-1",FALSE,"Seattle Seahawks",6,20,13,284,194,90,2,17,343,204,139,1,2007-09-09,-1,0,"tam",-14
"2","Sun","September 16","W","","1-1",TRUE,"New Orleans Saints",31,14,14,330,243,87,0,19,343,244,99,2,2007-09-16,2,1,"tam",17
"3","Sun","September 23","W","","2-1",TRUE,"St. Louis Rams",24,3,22,322,140,182,1,18,245,109,136,3,2007-09-23,2,1,"tam",21
"4","Sun","September 30","W","","3-1",FALSE,"Carolina Panthers",20,7,22,365,176,189,1,13,236,137,99,2,2007-09-30,1,1,"tam",13
"5","Sun","October 7","L","","3-2",FALSE,"Indianapolis Colts",14,33,12,177,160,17,1,28,400,253,147,1,2007-10-07,0,0,"tam",-19
"6","Sun","October 14","W","","4-2",TRUE,"Tennessee Titans",13,10,13,304,274,30,1,20,317,221,96,3,2007-10-14,2,1,"tam",3
"7","Sun","October 21","L","","4-3",FALSE,"Detroit Lions",16,23,27,422,298,124,2,17,278,131,147,0,2007-10-21,-2,0,"tam",-7
"8","Sun","October 28","L","","4-4",TRUE,"Jacksonville Jaguars",23,24,18,385,249,136,3,12,219,86,133,0,2007-10-28,-3,0,"tam",-1
"9","Sun","November 4","W","","5-4",TRUE,"Arizona Cardinals",17,10,18,350,188,162,0,9,195,172,23,2,2007-11-04,2,1,"tam",7
"11","Sun","November 18","W","","6-4",FALSE,"Atlanta Falcons",31,7,15,305,156,149,2,15,265,216,49,4,2007-11-18,2,1,"tam",24
"12","Sun","November 25","W","","7-4",TRUE,"Washington Redskins",19,13,9,192,93,99,0,23,412,292,120,6,2007-11-25,6,1,"tam",6
"13","Sun","December 2","W","","8-4",FALSE,"New Orleans Saints",27,23,24,466,294,172,1,13,246,162,84,1,2007-12-02,0,1,"tam",4
"14","Sun","December 9","L","","8-5",FALSE,"Houston Texans",14,28,16,305,234,71,2,18,257,186,71,2,2007-12-09,0,0,"tam",-14
"15","Sun","December 16","W","","9-5",TRUE,"Atlanta Falcons",37,3,21,285,95,190,1,5,133,27,106,4,2007-12-16,3,1,"tam",34
"16","Sun","December 23","L","","9-6",FALSE,"San Francisco 49ers",19,21,20,434,367,67,2,11,213,116,97,2,2007-12-23,0,0,"tam",-2
"17","Sun","December 30","L","","9-7",TRUE,"Carolina Panthers",23,31,17,303,196,107,1,20,349,169,180,2,2007-12-30,1,0,"tam",-8
"WildCard","Sun","January 6","L","","9-8",TRUE,"New York Giants",14,24,20,271,202,69,3,16,277,177,100,0,2008-01-06,-3,0,"tam",-10
"1","Sun","September 7","L","","0-1",FALSE,"New Orleans Saints",20,24,18,352,206,146,1,16,438,337,101,1,2008-09-07,0,0,"tam",-4
"2","Sun","September 14","W","","1-1",TRUE,"Atlanta Falcons",24,9,15,311,147,164,1,14,234,129,105,2,2008-09-14,1,1,"tam",15
"3","Sun","September 21","W","OT","2-1",FALSE,"Chicago Bears",27,24,28,454,407,47,4,21,405,247,158,2,2008-09-21,-2,1,"tam",3
"4","Sun","September 28","W","","3-1",TRUE,"Green Bay Packers",30,21,20,327,149,178,3,8,181,153,28,4,2008-09-28,1,1,"tam",9
"5","Sun","October 5","L","","3-2",FALSE,"Denver Broncos",13,16,17,307,168,139,1,17,333,227,106,1,2008-10-05,0,0,"tam",-3
"6","Sun","October 12","W","","4-2",TRUE,"Carolina Panthers",27,3,17,315,173,142,0,14,282,242,40,3,2008-10-12,3,1,"tam",24
"7","Sun","October 19","W","","5-2",TRUE,"Seattle Seahawks",20,10,22,402,305,97,1,7,176,73,103,2,2008-10-19,1,1,"tam",10
"8","Sun","October 26","L","","5-3",FALSE,"Dallas Cowboys",9,13,15,262,213,49,1,17,172,102,70,0,2008-10-26,-1,0,"tam",-4
"9","Sun","November 2","W","OT","6-3",FALSE,"Kansas City Chiefs",30,27,24,423,342,81,4,21,384,201,183,1,2008-11-02,-3,1,"tam",3
"11","Sun","November 16","W","","7-3",TRUE,"Minnesota Vikings",19,13,21,363,255,108,1,14,210,111,99,2,2008-11-16,1,1,"tam",6
"12","Sun","November 23","W","","8-3",FALSE,"Detroit Lions",38,20,15,255,139,116,3,9,207,99,108,3,2008-11-23,0,1,"tam",18
"13","Sun","November 30","W","","9-3",TRUE,"New Orleans Saints",23,20,11,254,105,149,1,18,332,288,44,3,2008-11-30,2,1,"tam",3
"14","Mon","December 8","L","","9-4",FALSE,"Carolina Panthers",23,38,21,384,298,86,0,26,464,165,299,2,2008-12-08,2,0,"tam",-15
"15","Sun","December 14","L","OT","9-5",FALSE,"Atlanta Falcons",10,13,19,325,226,99,1,18,373,198,175,3,2008-12-14,2,0,"tam",-3
"16","Sun","December 21","L","","9-6",TRUE,"San Diego Chargers",24,41,20,342,231,111,3,8,370,280,90,0,2008-12-21,-3,0,"tam",-17
"17","Sun","December 28","L","","9-7",TRUE,"Oakland Raiders",24,31,15,380,255,125,1,18,337,145,192,1,2008-12-28,0,0,"tam",-7
"1","Sun","September 13","L","","0-1",TRUE,"Dallas Cowboys",21,34,26,450,276,174,0,18,462,344,118,0,2009-09-13,0,0,"tam",-13
"2","Sun","September 20","L","","0-2",FALSE,"Buffalo Bills",20,33,19,353,296,57,2,25,438,220,218,2,2009-09-20,0,0,"tam",-13
"3","Sun","September 27","L","","0-3",TRUE,"New York Giants",0,24,5,86,58,28,1,27,397,171,226,0,2009-09-27,-1,0,"tam",-24
"4","Sun","October 4","L","","0-4",FALSE,"Washington Redskins",13,16,12,229,100,129,2,14,277,152,125,4,2009-10-04,2,0,"tam",-3
"5","Sun","October 11","L","","0-5",FALSE,"Philadelphia Eagles",14,33,22,303,218,85,3,16,325,249,76,0,2009-10-11,-3,0,"tam",-19
"6","Sun","October 18","L","","0-6",TRUE,"Carolina Panthers",21,28,12,245,121,124,2,22,322,55,267,3,2009-10-18,1,0,"tam",-7
"7","Sun","October 25","L","","0-7",TRUE,"New England Patriots",7,35,10,240,151,89,3,18,414,307,107,2,2009-10-25,-1,0,"tam",-28
"9","Sun","November 8","W","","1-7",TRUE,"Green Bay Packers",38,28,17,279,198,81,1,20,404,234,170,3,2009-11-08,2,1,"tam",10
"10","Sun","November 15","L","","1-8",FALSE,"Miami Dolphins",23,25,16,301,180,121,2,23,374,175,199,2,2009-11-15,0,0,"tam",-2
"11","Sun","November 22","L","","1-9",TRUE,"New Orleans Saints",7,38,14,219,100,119,4,21,370,187,183,0,2009-11-22,-4,0,"tam",-31
"12","Sun","November 29","L","","1-10",FALSE,"Atlanta Falcons",17,20,13,318,245,73,1,21,297,222,75,1,2009-11-29,0,0,"tam",-3
"13","Sun","December 6","L","","1-11",FALSE,"Carolina Panthers",6,16,22,469,315,154,5,15,309,152,157,2,2009-12-06,-3,0,"tam",-10
"14","Sun","December 13","L","","1-12",TRUE,"New York Jets",3,26,6,124,81,43,3,14,310,135,175,1,2009-12-13,-2,0,"tam",-23
"15","Sun","December 20","W","","2-12",FALSE,"Seattle Seahawks",24,7,15,339,205,134,1,23,380,252,128,5,2009-12-20,4,1,"tam",17
"16","Sun","December 27","W","OT","3-12",FALSE,"New Orleans Saints",20,17,24,439,263,176,2,23,373,249,124,1,2009-12-27,-1,1,"tam",3
"17","Sun","January 3","L","","3-13",TRUE,"Atlanta Falcons",10,20,13,206,166,40,2,24,397,214,183,3,2010-01-03,1,0,"tam",-10
"1","Sun","September 12","W","","1-0",TRUE,"Cleveland Browns",17,14,13,288,169,119,2,15,340,236,104,3,2010-09-12,1,1,"tam",3
"2","Sun","September 19","W","","2-0",FALSE,"Carolina Panthers",20,7,14,273,178,95,0,16,278,159,119,3,2010-09-19,3,1,"tam",13
"3","Sun","September 26","L","","2-1",TRUE,"Pittsburgh Steelers",13,38,18,303,228,75,2,17,387,186,201,2,2010-09-26,0,0,"tam",-25
"5","Sun","October 10","W","","3-1",FALSE,"Cincinnati Bengals",24,21,21,391,266,125,3,20,358,209,149,4,2010-10-10,1,1,"tam",3
"6","Sun","October 17","L","","3-2",TRUE,"New Orleans Saints",6,31,21,277,235,42,1,27,475,263,212,1,2010-10-17,0,0,"tam",-25
"7","Sun","October 24","W","","4-2",TRUE,"St. Louis Rams",18,17,17,313,189,124,0,19,285,124,161,1,2010-10-24,1,1,"tam",1
"8","Sun","October 31","W","","5-2",FALSE,"Arizona Cardinals",38,35,19,407,253,154,2,22,396,296,100,4,2010-10-31,2,1,"tam",3
"9","Sun","November 7","L","","5-3",FALSE,"Atlanta Falcons",21,27,14,278,182,96,2,26,365,235,130,0,2010-11-07,-2,0,"tam",-6
"10","Sun","November 14","W","","6-3",TRUE,"Carolina Panthers",31,16,21,421,235,186,2,18,300,182,118,1,2010-11-14,-1,1,"tam",15
"11","Sun","November 21","W","","7-3",FALSE,"San Francisco 49ers",21,0,20,299,137,162,0,11,189,118,71,2,2010-11-21,2,1,"tam",21
"12","Sun","November 28","L","","7-4",FALSE,"Baltimore Ravens",10,17,14,263,162,101,0,18,349,257,92,1,2010-11-28,1,0,"tam",-7
"13","Sun","December 5","L","","7-5",TRUE,"Atlanta Falcons",24,28,19,325,174,151,1,20,290,205,85,2,2010-12-05,1,0,"tam",-4
"14","Sun","December 12","W","","8-5",FALSE,"Washington Redskins",17,16,15,365,262,103,2,22,399,211,188,1,2010-12-12,-1,1,"tam",1
"15","Sun","December 19","L","OT","8-6",TRUE,"Detroit Lions",20,23,22,403,227,176,0,26,433,252,181,0,2010-12-19,0,0,"tam",-3
"16","Sun","December 26","W","","9-6",TRUE,"Seattle Seahawks",38,15,22,439,231,208,0,10,174,84,90,0,2010-12-26,0,1,"tam",23
"17","Sun","January 2","W","","10-6",FALSE,"New Orleans Saints",23,13,18,317,233,84,2,20,305,199,106,3,2011-01-02,1,1,"tam",10
"1","Sun","September 11","L","","0-1",TRUE,"Detroit Lions",20,27,17,315,259,56,2,25,431,305,126,1,2011-09-11,-1,0,"tam",-7
"2","Sun","September 18","W","","1-1",FALSE,"Minnesota Vikings",24,20,19,335,230,105,1,25,398,212,186,1,2011-09-18,0,1,"tam",4
"3","Sun","September 25","W","","2-1",TRUE,"Atlanta Falcons",16,13,20,295,180,115,2,21,325,295,30,3,2011-09-25,1,1,"tam",3
"4","Mon","October 3","W","","3-1",TRUE,"Indianapolis Colts",24,17,25,466,274,192,0,13,318,256,62,1,2011-10-03,1,1,"tam",7
"5","Sun","October 9","L","","3-2",FALSE,"San Francisco 49ers",3,48,14,272,186,86,3,28,418,205,213,1,2011-10-09,-2,0,"tam",-45
"6","Sun","October 16","W","","4-2",TRUE,"New Orleans Saints",26,20,21,420,303,117,0,20,453,383,70,4,2011-10-16,4,1,"tam",6
"7","Sun","October 23","L","","4-3",TRUE,"Chicago Bears",18,24,16,280,250,30,4,19,395,218,177,2,2011-10-23,-2,0,"tam",-6
"9","Sun","November 6","L","","4-4",FALSE,"New Orleans Saints",16,27,18,365,281,84,0,25,453,258,195,1,2011-11-06,1,0,"tam",-11
"10","Sun","November 13","L","","4-5",TRUE,"Houston Texans",9,37,12,231,141,90,4,21,420,235,185,0,2011-11-13,-4,0,"tam",-28
"11","Sun","November 20","L","","4-6",FALSE,"Green Bay Packers",26,35,22,455,334,121,2,24,378,287,91,1,2011-11-20,-1,0,"tam",-9
"12","Sun","November 27","L","","4-7",FALSE,"Tennessee Titans",17,23,15,308,186,122,5,18,352,150,202,4,2011-11-27,-1,0,"tam",-6
"13","Sun","December 4","L","","4-8",TRUE,"Carolina Panthers",19,38,15,285,207,78,1,26,385,222,163,0,2011-12-04,-1,0,"tam",-19
"14","Sun","December 11","L","","4-9",FALSE,"Jacksonville Jaguars",14,41,15,280,170,110,7,21,325,209,116,2,2011-12-11,-5,0,"tam",-27
"15","Sat","December 17","L","","4-10",TRUE,"Dallas Cowboys",15,31,7,190,132,58,1,28,399,239,160,1,2011-12-17,0,0,"tam",-16
"16","Sat","December 24","L","","4-11",FALSE,"Carolina Panthers",16,48,23,317,258,59,4,20,433,163,270,0,2011-12-24,-4,0,"tam",-32
"17","Sun","January 1","L","","4-12",FALSE,"Atlanta Falcons",24,45,18,294,259,35,4,22,428,177,251,2,2012-01-01,-2,0,"tam",-21
"1","Sun","September 8","L","","0-1",TRUE,"Kansas City Chiefs",27,47,19,304,168,136,4,22,504,395,109,3,1985-09-08,-1,0,"nor",-20
"2","Sun","September 15","L","","0-2",FALSE,"Denver Broncos",23,34,17,342,235,107,1,22,432,327,105,2,1985-09-15,1,0,"nor",-11
"3","Sun","September 22","W","","1-2",TRUE,"Tampa Bay Buccaneers",20,13,18,338,226,112,2,20,334,220,114,3,1985-09-22,1,1,"nor",7
"4","Sun","September 29","W","","2-2",FALSE,"San Francisco 49ers",20,17,19,354,179,175,3,15,231,81,150,3,1985-09-29,0,1,"nor",3
"5","Sun","October 6","W","","3-2",TRUE,"Philadelphia Eagles",23,21,12,217,146,71,2,24,363,256,107,5,1985-10-06,3,1,"nor",2
"6","Sun","October 13","L","","3-3",FALSE,"Los Angeles Raiders",13,23,15,277,163,114,4,16,278,165,113,1,1985-10-13,-3,0,"nor",-10
"7","Sun","October 20","L","","3-4",FALSE,"Atlanta Falcons",24,31,18,365,287,78,5,23,377,248,129,4,1985-10-20,-1,0,"nor",-7
"8","Sun","October 27","L","","3-5",TRUE,"New York Giants",13,21,12,232,101,131,4,27,388,154,234,2,1985-10-27,-2,0,"nor",-8
"9","Sun","November 3","L","","3-6",FALSE,"Los Angeles Rams",10,28,13,187,122,65,3,20,366,236,130,3,1985-11-03,0,0,"nor",-18
"10","Sun","November 10","L","","3-7",TRUE,"Seattle Seahawks",3,27,12,183,96,87,1,17,346,256,90,1,1985-11-10,0,0,"nor",-24
"11","Sun","November 17","L","","3-8",FALSE,"Green Bay Packers",14,38,12,207,132,75,0,26,433,296,137,2,1985-11-17,2,0,"nor",-24
"12","Sun","November 24","W","","4-8",FALSE,"Minnesota Vikings",30,23,19,371,137,234,3,17,284,225,59,3,1985-11-24,0,1,"nor",7
"13","Sun","December 1","W","","5-8",TRUE,"Los Angeles Rams",29,3,14,280,196,84,0,13,164,59,105,4,1985-12-01,4,1,"nor",26
"14","Sun","December 8","L","","5-9",FALSE,"St. Louis Cardinals",16,28,21,287,216,71,2,24,383,197,186,0,1985-12-08,-2,0,"nor",-12
"15","Sun","December 15","L","","5-10",TRUE,"San Francisco 49ers",19,31,14,289,214,75,0,27,500,349,151,1,1985-12-15,1,0,"nor",-12
"16","Sun","December 22","L","","5-11",TRUE,"Atlanta Falcons",10,16,15,246,178,68,2,22,432,189,243,0,1985-12-22,-2,0,"nor",-6
"1","Sun","September 7","L","","0-1",TRUE,"Atlanta Falcons",10,31,14,176,101,75,2,28,442,197,245,2,1986-09-07,0,0,"nor",-21
"2","Sun","September 14","W","","1-1",TRUE,"Green Bay Packers",24,10,13,289,191,98,3,20,358,295,63,7,1986-09-14,4,1,"nor",14
"3","Sun","September 21","L","","1-2",FALSE,"San Francisco 49ers",17,26,10,229,110,119,1,30,461,325,136,1,1986-09-21,0,0,"nor",-9
"4","Sun","September 28","L","","1-3",FALSE,"New York Giants",17,20,10,196,131,65,1,26,388,274,114,3,1986-09-28,2,0,"nor",-3
"5","Sun","October 5","L","","1-4",TRUE,"Washington Redskins",6,14,18,237,129,108,1,22,299,169,130,0,1986-10-05,-1,0,"nor",-8
"6","Sun","October 12","W","","2-4",FALSE,"Indianapolis Colts",17,14,19,305,144,161,3,22,382,287,95,4,1986-10-12,1,1,"nor",3
"7","Sun","October 19","W","","3-4",TRUE,"Tampa Bay Buccaneers",38,7,28,450,185,265,2,16,220,160,60,5,1986-10-19,3,1,"nor",31
"8","Sun","October 26","L","","3-5",FALSE,"New York Jets",23,28,21,304,243,61,5,20,281,226,55,2,1986-10-26,-3,0,"nor",-5
"9","Sun","November 2","W","","4-5",TRUE,"San Francisco 49ers",23,10,14,291,137,154,1,18,349,297,52,4,1986-11-02,3,1,"nor",13
"10","Sun","November 9","W","","5-5",TRUE,"Los Angeles Rams",6,0,9,236,134,102,5,10,176,123,53,4,1986-11-09,-1,1,"nor",6
"11","Sun","November 16","W","","6-5",FALSE,"St. Louis Cardinals",16,7,15,258,76,182,0,21,282,168,114,3,1986-11-16,3,1,"nor",9
"12","Sun","November 23","L","","6-6",FALSE,"Los Angeles Rams",13,26,23,312,223,89,5,18,239,50,189,2,1986-11-23,-3,0,"nor",-13
"13","Sun","November 30","L","","6-7",TRUE,"New England Patriots",20,21,25,425,247,178,5,14,231,229,2,2,1986-11-30,-3,0,"nor",-1
"14","Sun","December 7","L","","6-8",TRUE,"Miami Dolphins",27,31,26,526,269,257,2,25,352,241,111,0,1986-12-07,-2,0,"nor",-4
"15","Sun","December 14","W","","7-8",FALSE,"Atlanta Falcons",14,9,14,241,161,80,1,18,247,185,62,3,1986-12-14,2,1,"nor",5
"16","Sun","December 21","L","","7-9",FALSE,"Minnesota Vikings",17,33,16,267,187,80,6,23,395,317,78,1,1986-12-21,-5,0,"nor",-16
"1","Sun","September 13","W","","1-0",TRUE,"Cleveland Browns",28,21,21,338,147,191,0,25,387,294,93,2,1987-09-13,2,1,"nor",7
"2","Sun","September 20","L","","1-1",FALSE,"Philadelphia Eagles",17,27,14,220,188,32,5,19,336,175,161,3,1987-09-20,-2,0,"nor",-10
"3","Sun","October 4","W","","2-1",TRUE,"Los Angeles Rams",37,10,19,349,195,154,1,12,207,135,72,2,1987-10-04,1,1,"nor",27
"4","Sun","October 11","L","","2-2",FALSE,"St. Louis Cardinals",19,24,30,368,155,213,4,9,143,4,139,1,1987-10-11,-3,0,"nor",-5
"5","Sun","October 18","W","","3-2",FALSE,"Chicago Bears",19,17,18,291,179,112,3,11,133,66,67,4,1987-10-18,1,1,"nor",2
"6","Sun","October 25","L","","3-3",TRUE,"San Francisco 49ers",22,24,20,379,202,177,2,23,303,228,75,2,1987-10-25,0,0,"nor",-2
"7","Sun","November 1","W","","4-3",FALSE,"Atlanta Falcons",38,0,29,410,166,244,0,12,183,128,55,5,1987-11-01,5,1,"nor",38
"8","Sun","November 8","W","","5-3",FALSE,"Los Angeles Rams",31,14,20,443,211,232,2,18,304,202,102,3,1987-11-08,1,1,"nor",17
"9","Sun","November 15","W","","6-3",FALSE,"San Francisco 49ers",26,24,16,261,156,105,1,20,402,258,144,2,1987-11-15,1,1,"nor",2
"10","Sun","November 22","W","","7-3",TRUE,"New York Giants",23,14,16,278,175,103,2,16,298,223,75,7,1987-11-22,5,1,"nor",9
"11","Sun","November 29","W","","8-3",FALSE,"Pittsburgh Steelers",20,16,15,258,144,114,2,17,284,172,112,6,1987-11-29,4,1,"nor",4
"12","Sun","December 6","W","","9-3",TRUE,"Tampa Bay Buccaneers",44,34,19,365,248,117,1,27,449,352,97,4,1987-12-06,3,1,"nor",10
"13","Sun","December 13","W","","10-3",TRUE,"Houston Oilers",24,10,21,391,240,151,2,20,354,244,110,0,1987-12-13,-2,1,"nor",14
"14","Sun","December 20","W","","11-3",FALSE,"Cincinnati Bengals",41,24,24,321,220,101,0,24,237,112,125,4,1987-12-20,4,1,"nor",17
"15","Sun","December 27","W","","12-3",TRUE,"Green Bay Packers",33,24,22,292,148,144,3,17,330,207,123,3,1987-12-27,0,1,"nor",9
"WildCard","Sun","January 3","L","","12-4",TRUE,"Minnesota Vikings",10,44,9,149,96,53,6,28,417,207,210,2,1988-01-03,-4,0,"nor",-34
"1","Sun","September 4","L","","0-1",TRUE,"San Francisco 49ers",33,34,23,344,197,147,3,21,289,165,124,2,1988-09-04,-1,0,"nor",-1
"2","Sun","September 11","W","","1-1",FALSE,"Atlanta Falcons",29,21,25,434,222,212,4,19,307,146,161,4,1988-09-11,0,1,"nor",8
"3","Sun","September 18","W","","2-1",FALSE,"Detroit Lions",22,14,22,401,282,119,2,18,272,232,40,2,1988-09-18,0,1,"nor",8
"4","Sun","September 25","W","","3-1",TRUE,"Tampa Bay Buccaneers",13,9,18,268,151,117,1,19,296,204,92,1,1988-09-25,0,1,"nor",4
"5","Mon","October 3","W","","4-1",TRUE,"Dallas Cowboys",20,17,17,333,268,65,1,28,457,271,186,3,1988-10-03,2,1,"nor",3
"6","Sun","October 9","W","","5-1",FALSE,"San Diego Chargers",23,17,24,365,231,134,1,12,206,113,93,2,1988-10-09,1,1,"nor",6
"7","Sun","October 16","W","","6-1",FALSE,"Seattle Seahawks",20,19,20,318,177,141,3,23,434,341,93,2,1988-10-16,-1,1,"nor",1
"8","Sun","October 23","W","","7-1",TRUE,"Los Angeles Raiders",20,6,14,317,127,190,0,16,367,182,185,3,1988-10-23,3,1,"nor",14
"9","Sun","October 30","L","","7-2",TRUE,"Los Angeles Rams",10,12,14,242,209,33,2,16,332,236,96,0,1988-10-30,-2,0,"nor",-2
"10","Sun","November 6","L","","7-3",FALSE,"Washington Redskins",24,27,20,322,272,50,0,21,412,299,113,1,1988-11-06,1,0,"nor",-3
"11","Sun","November 13","W","","8-3",FALSE,"Los Angeles Rams",14,10,19,337,249,88,3,15,256,196,60,2,1988-11-13,-1,1,"nor",4
"12","Sun","November 20","W","","9-3",TRUE,"Denver Broncos",42,0,28,385,189,196,0,17,258,206,52,1,1988-11-20,1,1,"nor",42
"13","Sun","November 27","L","","9-4",TRUE,"New York Giants",12,13,16,255,100,155,5,8,219,205,14,5,1988-11-27,0,0,"nor",-1
"14","Sun","December 4","L","","9-5",FALSE,"Minnesota Vikings",3,45,13,233,107,126,3,20,426,217,209,1,1988-12-04,-2,0,"nor",-42
"15","Sun","December 11","L","","9-6",FALSE,"San Francisco 49ers",17,30,15,252,182,70,2,20,373,221,152,2,1988-12-11,0,0,"nor",-13
"16","Sun","December 18","W","","10-6",TRUE,"Atlanta Falcons",10,9,18,325,122,203,2,13,202,93,109,1,1988-12-18,-1,1,"nor",1
"1","Sun","September 10","W","","1-0",TRUE,"Dallas Cowboys",28,0,26,344,145,199,1,10,174,154,20,2,1989-09-10,1,1,"nor",28
"2","Sun","September 17","L","","1-1",FALSE,"Green Bay Packers",34,35,21,367,282,85,2,29,490,341,149,2,1989-09-17,0,0,"nor",-1
"3","Sun","September 24","L","","1-2",FALSE,"Tampa Bay Buccaneers",10,20,25,325,211,114,2,20,336,218,118,3,1989-09-24,1,0,"nor",-10
"4","Sun","October 1","L","","1-3",TRUE,"Washington Redskins",14,16,20,381,245,136,4,13,308,216,92,1,1989-10-01,-3,0,"nor",-2
"5","Sun","October 8","L","","1-4",TRUE,"San Francisco 49ers",20,24,18,334,299,35,0,18,358,282,76,1,1989-10-08,1,0,"nor",-4
"6","Sun","October 15","W","","2-4",TRUE,"New York Jets",29,14,20,418,266,152,4,15,251,199,52,4,1989-10-15,0,1,"nor",15
"7","Sun","October 22","W","","3-4",FALSE,"Los Angeles Rams",40,21,16,373,267,106,1,22,313,260,53,3,1989-10-22,2,1,"nor",19
"8","Sun","October 29","W","","4-4",TRUE,"Atlanta Falcons",20,13,17,392,261,131,2,11,148,91,57,3,1989-10-29,1,1,"nor",7
"9","Mon","November 6","L","","4-5",FALSE,"San Francisco 49ers",13,31,16,243,160,83,2,21,397,302,95,0,1989-11-06,-2,0,"nor",-18
"10","Sun","November 12","W","","5-5",FALSE,"New England Patriots",28,24,14,211,82,129,1,28,354,272,82,4,1989-11-12,3,1,"nor",4
"11","Sun","November 19","W","","6-5",FALSE,"Atlanta Falcons",26,17,21,354,148,206,4,15,267,190,77,1,1989-11-19,-3,1,"nor",9
"12","Sun","November 26","L","OT","6-6",TRUE,"Los Angeles Rams",17,20,14,301,163,138,2,23,472,415,57,3,1989-11-26,1,0,"nor",-3
"13","Sun","December 3","L","","6-7",FALSE,"Detroit Lions",14,21,11,169,99,70,2,17,401,316,85,2,1989-12-03,0,0,"nor",-7
"14","Sun","December 10","W","","7-7",FALSE,"Buffalo Bills",22,19,21,436,286,150,2,16,279,204,75,4,1989-12-10,2,1,"nor",3
"15","Mon","December 18","W","","8-7",TRUE,"Philadelphia Eagles",30,20,21,291,205,86,1,22,408,281,127,4,1989-12-18,3,1,"nor",10
"16","Sun","December 24","W","","9-7",TRUE,"Indianapolis Colts",41,6,23,389,261,128,1,13,230,119,111,2,1989-12-24,1,1,"nor",35
"1","Mon","September 10","L","","0-1",TRUE,"San Francisco 49ers",12,13,11,268,180,88,5,17,237,184,53,2,1990-09-10,-3,0,"nor",-1
"2","Sun","September 16","L","","0-2",FALSE,"Minnesota Vikings",3,32,11,253,135,118,5,17,310,191,119,0,1990-09-16,-5,0,"nor",-29
"3","Sun","September 23","W","","1-2",TRUE,"Phoenix Cardinals",28,7,21,297,146,151,1,15,297,186,111,2,1990-09-23,1,1,"nor",21
"5","Sun","October 7","L","","1-3",FALSE,"Atlanta Falcons",27,28,15,293,218,75,1,25,457,366,91,2,1990-10-07,1,0,"nor",-1
"6","Sun","October 14","W","","2-3",TRUE,"Cleveland Browns",25,20,19,348,259,89,1,20,238,157,81,1,1990-10-14,0,1,"nor",5
"7","Sun","October 21","L","","2-4",FALSE,"Houston Oilers",10,23,19,320,259,61,3,21,305,202,103,2,1990-10-21,-1,0,"nor",-13
"8","Sun","October 28","L","","2-5",TRUE,"Detroit Lions",10,27,15,269,138,131,8,12,262,214,48,1,1990-10-28,-7,0,"nor",-17
"9","Sun","November 4","W","","3-5",FALSE,"Cincinnati Bengals",21,7,21,350,101,249,1,13,261,125,136,1,1990-11-04,0,1,"nor",14
"10","Sun","November 11","W","","4-5",TRUE,"Tampa Bay Buccaneers",35,7,17,295,84,211,2,15,199,110,89,3,1990-11-11,1,1,"nor",28
"11","Sun","November 18","L","","4-6",FALSE,"Washington Redskins",17,31,24,367,274,93,4,24,423,311,112,1,1990-11-18,-3,0,"nor",-14
"12","Sun","November 25","W","","5-6",TRUE,"Atlanta Falcons",10,7,19,258,173,85,1,9,226,167,59,1,1990-11-25,0,1,"nor",3
"13","Sun","December 2","L","","5-7",FALSE,"Dallas Cowboys",13,17,14,283,170,113,1,17,274,161,113,1,1990-12-02,0,0,"nor",-4
"14","Sun","December 9","W","","6-7",FALSE,"Los Angeles Rams",24,20,9,218,110,108,3,24,444,341,103,4,1990-12-09,1,1,"nor",4
"15","Sun","December 16","L","","6-8",TRUE,"Pittsburgh Steelers",6,9,12,195,95,100,1,14,232,154,78,1,1990-12-16,0,0,"nor",-3
"16","Sun","December 23","W","","7-8",FALSE,"San Francisco 49ers",13,10,12,194,110,84,2,20,334,175,159,4,1990-12-23,2,1,"nor",3
"17","Mon","December 31","W","","8-8",TRUE,"Los Angeles Rams",20,17,14,268,174,94,0,16,379,275,104,1,1990-12-31,1,1,"nor",3
"WildCard","Sun","January 6","L","","8-9",FALSE,"Chicago Bears",6,16,11,193,128,65,3,18,365,176,189,1,1991-01-06,-2,0,"nor",-10
"1","Sun","September 1","W","","1-0",TRUE,"Seattle Seahawks",27,24,13,244,201,43,3,19,348,302,46,4,1991-09-01,1,1,"nor",3
"2","Sun","September 8","W","","2-0",FALSE,"Kansas City Chiefs",17,10,15,259,187,72,1,17,272,205,67,2,1991-09-08,1,1,"nor",7
"3","Sun","September 15","W","","3-0",TRUE,"Los Angeles Rams",24,7,18,334,181,153,1,6,120,43,77,1,1991-09-15,0,1,"nor",17
"4","Sun","September 22","W","","4-0",TRUE,"Minnesota Vikings",26,0,16,343,147,196,2,6,151,108,43,3,1991-09-22,1,1,"nor",26
"5","Sun","September 29","W","","5-0",FALSE,"Atlanta Falcons",27,6,17,367,197,170,1,8,162,129,33,2,1991-09-29,1,1,"nor",21
"7","Sun","October 13","W","","6-0",FALSE,"Philadelphia Eagles",13,6,10,162,98,64,2,11,204,151,53,6,1991-10-13,4,1,"nor",7
"8","Sun","October 20","W","","7-0",TRUE,"Tampa Bay Buccaneers",23,7,17,284,205,79,2,12,219,173,46,3,1991-10-20,1,1,"nor",16
"9","Sun","October 27","L","","7-1",TRUE,"Chicago Bears",17,20,13,313,262,51,3,11,178,36,142,2,1991-10-27,-1,0,"nor",-3
"10","Sun","November 3","W","","8-1",FALSE,"Los Angeles Rams",24,17,19,359,269,90,1,16,381,326,55,5,1991-11-03,4,1,"nor",7
"11","Sun","November 10","W","","9-1",TRUE,"San Francisco 49ers",10,3,10,191,109,82,1,15,216,102,114,3,1991-11-10,2,1,"nor",7
"12","Sun","November 17","L","","9-2",FALSE,"San Diego Chargers",21,24,17,285,193,92,4,15,305,159,146,2,1991-11-17,-2,0,"nor",-3
"13","Sun","November 24","L","OT","9-3",TRUE,"Atlanta Falcons",20,23,20,419,255,164,3,12,331,240,91,4,1991-11-24,1,0,"nor",-3
"14","Sun","December 1","L","","9-4",FALSE,"San Francisco 49ers",24,38,22,415,317,98,3,22,383,343,40,2,1991-12-01,-1,0,"nor",-14
"15","Sun","December 8","L","","9-5",FALSE,"Dallas Cowboys",14,23,22,328,229,99,1,20,301,184,117,0,1991-12-08,-1,0,"nor",-9
"16","Mon","December 16","W","","10-5",TRUE,"Los Angeles Raiders",27,0,26,475,314,161,1,6,117,46,71,2,1991-12-16,1,1,"nor",27
"17","Sun","December 22","W","","11-5",FALSE,"Phoenix Cardinals",27,3,12,190,95,95,1,18,245,173,72,7,1991-12-22,6,1,"nor",24
"WildCard","Sat","December 28","L","","11-6",TRUE,"Atlanta Falcons",20,27,23,330,265,65,3,20,334,255,79,2,1991-12-28,-1,0,"nor",-7
"1","Sun","September 6","L","","0-1",FALSE,"Philadelphia Eagles",13,15,8,202,147,55,2,21,320,136,184,4,1992-09-06,2,0,"nor",-2
"2","Sun","September 13","W","","1-1",TRUE,"Chicago Bears",28,6,15,345,251,94,2,19,381,240,141,3,1992-09-13,1,1,"nor",22
"3","Sun","September 20","W","","2-1",FALSE,"Atlanta Falcons",10,7,13,229,108,121,0,19,278,181,97,2,1992-09-20,2,1,"nor",3
"4","Sun","September 27","L","","2-2",TRUE,"San Francisco 49ers",10,16,19,336,259,77,5,19,333,179,154,2,1992-09-27,-3,0,"nor",-6
"5","Sun","October 4","W","","3-2",FALSE,"Detroit Lions",13,7,19,285,152,133,0,12,187,145,42,1,1992-10-04,1,1,"nor",6
"6","Sun","October 11","W","","4-2",TRUE,"Los Angeles Rams",13,10,19,301,166,135,2,13,196,143,53,1,1992-10-11,-1,1,"nor",3
"7","Sun","October 18","W","","5-2",FALSE,"Phoenix Cardinals",30,21,20,399,349,50,1,15,254,194,60,1,1992-10-18,0,1,"nor",9
"9","Sun","November 1","W","","6-2",TRUE,"Tampa Bay Buccaneers",23,21,18,309,164,145,4,10,154,70,84,1,1992-11-01,-3,1,"nor",2
"10","Sun","November 8","W","","7-2",FALSE,"New England Patriots",31,14,17,316,198,118,2,6,122,38,84,4,1992-11-08,2,1,"nor",17
"11","Sun","November 15","L","","7-3",FALSE,"San Francisco 49ers",20,21,16,336,293,43,0,24,367,191,176,1,1992-11-15,1,0,"nor",-1
"12","Mon","November 23","W","","8-3",TRUE,"Washington Redskins",20,3,12,224,142,82,0,14,227,169,58,1,1992-11-23,1,1,"nor",17
"13","Sun","November 29","W","","9-3",TRUE,"Miami Dolphins",24,13,15,252,125,127,1,17,281,223,58,3,1992-11-29,2,1,"nor",11
"14","Thu","December 3","W","","10-3",TRUE,"Atlanta Falcons",22,14,22,388,244,144,2,10,168,92,76,3,1992-12-03,1,1,"nor",8
"15","Sun","December 13","W","","11-3",FALSE,"Los Angeles Rams",37,14,25,399,238,161,1,18,328,226,102,6,1992-12-13,5,1,"nor",23
"16","Sun","December 20","L","","11-4",TRUE,"Buffalo Bills",16,20,12,205,157,48,3,19,307,126,181,2,1992-12-20,-1,0,"nor",-4
"17","Sat","December 26","W","","12-4",FALSE,"New York Jets",20,0,17,280,185,95,4,10,172,117,55,3,1992-12-26,-1,1,"nor",20
"WildCard","Sun","January 3","L","","12-5",TRUE,"Philadelphia Eagles",20,36,20,360,284,76,4,19,349,213,136,1,1993-01-03,-3,0,"nor",-16
"1","Sun","September 5","W","","1-0",TRUE,"Houston Oilers",33,21,21,346,204,142,1,21,405,335,70,5,1993-09-05,4,1,"nor",12
"2","Sun","September 12","W","","2-0",FALSE,"Atlanta Falcons",34,31,24,557,330,227,1,20,375,297,78,2,1993-09-12,1,1,"nor",3
"3","Sun","September 19","W","","3-0",TRUE,"Detroit Lions",14,3,16,258,86,172,1,9,170,86,84,2,1993-09-19,1,1,"nor",11
"4","Sun","September 26","W","","4-0",TRUE,"San Francisco 49ers",16,13,17,264,161,103,0,19,339,163,176,2,1993-09-26,2,1,"nor",3
"5","Sun","October 3","W","","5-0",FALSE,"Los Angeles Rams",37,6,17,359,205,154,1,17,256,129,127,3,1993-10-03,2,1,"nor",31
"7","Sun","October 17","L","","5-1",FALSE,"Pittsburgh Steelers",14,37,11,264,215,49,5,22,393,192,201,3,1993-10-17,-2,0,"nor",-23
"8","Sun","October 24","L","","5-2",TRUE,"Atlanta Falcons",15,26,16,321,274,47,2,17,279,156,123,0,1993-10-24,-2,0,"nor",-11
"9","Sun","October 31","W","","6-2",FALSE,"Phoenix Cardinals",20,17,18,272,176,96,2,10,143,54,89,2,1993-10-31,0,1,"nor",3
"11","Sun","November 14","L","","6-3",TRUE,"Green Bay Packers",17,19,19,329,172,157,5,13,194,125,69,1,1993-11-14,-4,0,"nor",-2
"12","Mon","November 22","L","","6-4",FALSE,"San Francisco 49ers",7,42,17,261,142,119,4,25,455,236,219,1,1993-11-22,-3,0,"nor",-35
"13","Sun","November 28","W","","7-4",FALSE,"Minnesota Vikings",17,14,15,254,100,154,3,16,288,182,106,1,1993-11-28,-2,1,"nor",3
"14","Sun","December 5","L","","7-5",FALSE,"Cleveland Browns",13,17,12,127,48,79,0,15,314,183,131,4,1993-12-05,4,0,"nor",-4
"15","Sun","December 12","L","","7-6",TRUE,"Los Angeles Rams",20,23,24,364,267,97,3,16,306,40,266,1,1993-12-12,-2,0,"nor",-3
"16","Mon","December 20","L","","7-7",TRUE,"New York Giants",14,24,15,304,293,11,2,20,277,144,133,1,1993-12-20,-1,0,"nor",-10
"17","Sun","December 26","L","","7-8",FALSE,"Philadelphia Eagles",26,37,7,158,75,83,3,20,314,180,134,1,1993-12-26,-2,0,"nor",-11
"18","Sun","January 2","W","","8-8",TRUE,"Cincinnati Bengals",20,13,15,269,193,76,1,13,188,104,84,1,1994-01-02,0,1,"nor",7
"1","Sun","September 4","L","","0-1",TRUE,"Kansas City Chiefs",17,30,22,349,312,37,4,28,460,308,152,0,1994-09-04,-4,0,"nor",-13
"2","Sun","September 11","L","","0-2",TRUE,"Washington Redskins",24,38,27,408,380,28,3,22,343,190,153,1,1994-09-11,-2,0,"nor",-14
"3","Sun","September 18","W","","1-2",FALSE,"Tampa Bay Buccaneers",9,7,12,233,176,57,0,16,232,147,85,1,1994-09-18,1,1,"nor",2
"4","Sun","September 25","L","","1-3",FALSE,"San Francisco 49ers",13,24,17,340,291,49,2,18,298,224,74,2,1994-09-25,0,0,"nor",-11
"5","Sun","October 2","W","","2-3",TRUE,"New York Giants",27,22,15,314,247,67,3,11,202,152,50,2,1994-10-02,-1,1,"nor",5
"6","Sun","October 9","L","","2-4",FALSE,"Chicago Bears",7,17,17,316,209,107,2,16,305,174,131,1,1994-10-09,-1,0,"nor",-10
"7","Sun","October 16","L","","2-5",TRUE,"San Diego Chargers",22,36,24,284,180,104,2,25,378,180,198,0,1994-10-16,-2,0,"nor",-14
"8","Sun","October 23","W","","3-5",TRUE,"Los Angeles Rams",37,34,18,314,196,118,1,13,242,157,85,3,1994-10-23,2,1,"nor",3
"10","Sun","November 6","L","","3-6",FALSE,"Minnesota Vikings",20,21,17,313,241,72,1,28,494,410,84,3,1994-11-06,2,0,"nor",-1
"11","Sun","November 13","W","","4-6",TRUE,"Atlanta Falcons",33,32,30,429,276,153,5,21,389,317,72,1,1994-11-13,-4,1,"nor",1
"12","Sun","November 20","L","","4-7",FALSE,"Los Angeles Raiders",19,24,16,246,230,16,1,22,428,307,121,4,1994-11-20,3,0,"nor",-5
"13","Mon","November 28","L","","4-8",TRUE,"San Francisco 49ers",14,35,13,222,139,83,3,28,461,270,191,2,1994-11-28,-1,0,"nor",-21
"14","Sun","December 4","W","","5-8",FALSE,"Los Angeles Rams",31,15,20,328,191,137,1,20,333,258,75,4,1994-12-04,3,1,"nor",16
"15","Sun","December 11","W","","6-8",FALSE,"Atlanta Falcons",29,20,19,402,264,138,0,23,376,284,92,1,1994-12-11,1,1,"nor",9
"16","Mon","December 19","L","","6-9",TRUE,"Dallas Cowboys",16,24,19,237,147,90,3,23,280,175,105,2,1994-12-19,-1,0,"nor",-8
"17","Sat","December 24","W","","7-9",FALSE,"Denver Broncos",30,28,22,447,367,80,1,23,348,258,90,4,1994-12-24,3,1,"nor",2
"1","Sun","September 3","L","","0-1",TRUE,"San Francisco 49ers",22,24,15,278,252,26,2,26,436,282,154,3,1995-09-03,1,0,"nor",-2
"2","Sun","September 10","L","","0-2",FALSE,"St. Louis Rams",13,17,19,308,211,97,2,19,322,171,151,0,1995-09-10,-2,0,"nor",-4
"3","Sun","September 17","L","OT","0-3",TRUE,"Atlanta Falcons",24,27,18,410,360,50,1,24,461,337,124,1,1995-09-17,0,0,"nor",-3
"4","Sun","September 24","L","","0-4",FALSE,"New York Giants",29,45,18,322,235,87,2,31,474,256,218,1,1995-09-24,-1,0,"nor",-16
"5","Sun","October 1","L","","0-5",TRUE,"Philadelphia Eagles",10,15,9,200,81,119,1,20,302,147,155,1,1995-10-01,0,0,"nor",-5
"7","Sun","October 15","W","","1-5",TRUE,"Miami Dolphins",33,30,18,335,255,80,2,23,381,353,28,5,1995-10-15,3,1,"nor",3
"8","Sun","October 22","L","","1-6",FALSE,"Carolina Panthers",3,20,17,302,238,64,5,10,155,29,126,0,1995-10-22,-5,0,"nor",-17
"9","Sun","October 29","W","","2-6",FALSE,"San Francisco 49ers",11,7,17,252,144,108,0,19,286,231,55,3,1995-10-29,3,1,"nor",4
"10","Sun","November 5","W","","3-6",TRUE,"St. Louis Rams",19,10,24,321,168,153,2,12,224,144,80,2,1995-11-05,0,1,"nor",9
"11","Sun","November 12","W","","4-6",TRUE,"Indianapolis Colts",17,14,18,294,225,69,1,15,300,180,120,1,1995-11-12,0,1,"nor",3
"12","Sun","November 19","L","","4-7",FALSE,"Minnesota Vikings",24,43,20,387,319,68,0,32,544,398,146,0,1995-11-19,0,0,"nor",-19
"13","Sun","November 26","W","","5-7",TRUE,"Carolina Panthers",34,26,24,352,172,180,4,17,409,329,80,6,1995-11-26,2,1,"nor",8
"14","Sun","December 3","W","","6-7",FALSE,"New England Patriots",31,17,17,432,293,139,1,21,331,191,140,3,1995-12-03,2,1,"nor",14
"15","Sun","December 10","L","","6-8",FALSE,"Atlanta Falcons",14,19,21,342,287,55,1,18,333,242,91,0,1995-12-10,-1,0,"nor",-5
"16","Sat","December 16","L","","6-9",TRUE,"Green Bay Packers",23,34,26,404,349,55,1,22,397,294,103,0,1995-12-16,-1,0,"nor",-11
"17","Sun","December 24","W","","7-9",FALSE,"New York Jets",12,0,13,239,199,40,0,11,206,139,67,3,1995-12-24,3,1,"nor",12
"1","Sun","September 1","L","","0-1",FALSE,"San Francisco 49ers",11,27,14,231,175,56,2,23,338,181,157,0,1996-09-01,-2,0,"nor",-16
"2","Sun","September 8","L","","0-2",TRUE,"Carolina Panthers",20,22,14,338,244,94,2,15,225,142,83,1,1996-09-08,-1,0,"nor",-2
"3","Sun","September 15","L","","0-3",FALSE,"Cincinnati Bengals",15,30,15,314,287,27,4,24,319,218,101,0,1996-09-15,-4,0,"nor",-15
"4","Sun","September 22","L","","0-4",TRUE,"Arizona Cardinals",14,28,15,218,142,76,3,20,432,165,267,2,1996-09-22,-1,0,"nor",-14
"5","Sun","September 29","L","","0-5",FALSE,"Baltimore Ravens",10,17,18,298,202,96,0,16,343,178,165,0,1996-09-29,0,0,"nor",-7
"6","Sun","October 6","W","","1-5",TRUE,"Jacksonville Jaguars",17,13,11,197,161,36,1,22,382,241,141,2,1996-10-06,1,1,"nor",4
"7","Sun","October 13","W","","2-5",TRUE,"Chicago Bears",27,24,23,423,218,205,4,18,327,222,105,1,1996-10-13,-3,1,"nor",3
"8","Sun","October 20","L","","2-6",FALSE,"Carolina Panthers",7,19,10,174,103,71,2,21,314,155,159,0,1996-10-20,-2,0,"nor",-12
"10","Sun","November 3","L","","2-7",TRUE,"San Francisco 49ers",17,24,18,293,229,64,3,17,306,115,191,0,1996-11-03,-3,0,"nor",-7
"11","Sun","November 10","L","","2-8",TRUE,"Houston Oilers",14,31,14,227,154,73,2,20,309,161,148,1,1996-11-10,-1,0,"nor",-17
"12","Sun","November 17","L","","2-9",FALSE,"Atlanta Falcons",15,17,15,270,235,35,3,18,293,219,74,1,1996-11-17,-2,0,"nor",-2
"13","Sun","November 24","L","","2-10",FALSE,"Tampa Bay Buccaneers",7,13,14,242,184,58,4,15,381,251,130,2,1996-11-24,-2,0,"nor",-6
"14","Sun","December 1","L","","2-11",TRUE,"St. Louis Rams",10,26,14,228,142,86,1,15,312,220,92,2,1996-12-01,1,0,"nor",-16
"15","Sun","December 8","L","","2-12",TRUE,"Atlanta Falcons",15,31,14,251,168,83,2,19,304,182,122,3,1996-12-08,1,0,"nor",-16
"16","Sun","December 15","W","","3-12",FALSE,"New York Giants",17,3,11,261,106,155,3,10,138,48,90,4,1996-12-15,1,1,"nor",14
"17","Sat","December 21","L","","3-13",FALSE,"St. Louis Rams",13,14,12,241,148,93,1,14,187,136,51,3,1996-12-21,2,0,"nor",-1
"1","Sun","August 31","L","","0-1",FALSE,"St. Louis Rams",24,38,13,241,159,82,5,20,403,214,189,1,1997-08-31,-4,0,"nor",-14
"2","Sun","September 7","L","","0-2",TRUE,"San Diego Chargers",6,20,14,243,178,65,6,11,230,171,59,2,1997-09-07,-4,0,"nor",-14
"3","Sun","September 14","L","","0-3",FALSE,"San Francisco 49ers",7,33,12,260,176,84,8,17,304,213,91,1,1997-09-14,-7,0,"nor",-26
"4","Sun","September 21","W","","1-3",TRUE,"Detroit Lions",35,17,21,385,213,172,0,22,355,237,118,4,1997-09-21,4,1,"nor",18
"5","Sun","September 28","L","","1-4",FALSE,"New York Giants",9,14,14,266,193,73,2,18,264,159,105,2,1997-09-28,0,0,"nor",-5
"6","Sun","October 5","W","","2-4",FALSE,"Chicago Bears",20,17,11,322,185,137,3,19,266,165,101,0,1997-10-05,-3,1,"nor",3
"7","Sun","October 12","L","","2-5",TRUE,"Atlanta Falcons",17,23,13,179,99,80,4,14,166,77,89,2,1997-10-12,-2,0,"nor",-6
"8","Sun","October 19","L","","2-6",TRUE,"Carolina Panthers",0,13,15,200,89,111,2,15,269,196,73,1,1997-10-19,-1,0,"nor",-13
"9","Sun","October 26","L","","2-7",TRUE,"San Francisco 49ers",0,23,6,142,87,55,2,21,347,210,137,0,1997-10-26,-2,0,"nor",-23
"11","Sun","November 9","W","","3-7",FALSE,"Oakland Raiders",13,10,17,213,154,59,1,12,221,189,32,2,1997-11-09,1,1,"nor",3
"12","Sun","November 16","W","OT","4-7",TRUE,"Seattle Seahawks",20,17,14,177,102,75,5,19,340,229,111,4,1997-11-16,-1,1,"nor",3
"13","Sun","November 23","L","","4-8",FALSE,"Atlanta Falcons",3,20,11,173,118,55,5,16,269,177,92,1,1997-11-23,-4,0,"nor",-17
"14","Sun","November 30","W","","5-8",FALSE,"Carolina Panthers",16,13,18,326,190,136,2,21,427,241,186,4,1997-11-30,2,1,"nor",3
"15","Sun","December 7","L","","5-9",TRUE,"St. Louis Rams",27,34,16,284,240,44,4,23,343,229,114,3,1997-12-07,-1,0,"nor",-7
"16","Sun","December 14","W","","6-9",TRUE,"Arizona Cardinals",27,10,17,382,252,130,1,18,265,154,111,4,1997-12-14,3,1,"nor",17
"17","Sun","December 21","L","","6-10",FALSE,"Kansas City Chiefs",13,25,17,252,149,103,5,14,176,20,156,0,1997-12-21,-5,0,"nor",-12
"1","Sun","September 6","W","","1-0",FALSE,"St. Louis Rams",24,17,15,232,197,35,1,23,314,267,47,2,1998-09-06,1,1,"nor",7
"2","Sun","September 13","W","","2-0",TRUE,"Carolina Panthers",19,14,18,311,104,207,0,20,375,238,137,3,1998-09-13,3,1,"nor",5
"4","Sun","September 27","W","OT","3-0",FALSE,"Indianapolis Colts",19,13,14,320,137,183,1,16,357,292,65,3,1998-09-27,2,1,"nor",6
"5","Sun","October 4","L","","3-1",TRUE,"New England Patriots",27,30,19,276,237,39,2,20,388,291,97,4,1998-10-04,2,0,"nor",-3
"6","Sun","October 11","L","","3-2",TRUE,"San Francisco 49ers",0,31,10,167,135,32,1,30,459,319,140,0,1998-10-11,-1,0,"nor",-31
"7","Sun","October 18","L","","3-3",FALSE,"Atlanta Falcons",23,31,15,322,255,67,4,19,297,163,134,0,1998-10-18,-4,0,"nor",-8
"8","Sun","October 25","W","","4-3",TRUE,"Tampa Bay Buccaneers",9,3,12,266,210,56,1,11,238,180,58,3,1998-10-25,2,1,"nor",6
"9","Sun","November 1","L","","4-4",FALSE,"Carolina Panthers",17,31,21,354,301,53,4,16,216,110,106,2,1998-11-01,-2,0,"nor",-14
"10","Sun","November 8","L","","4-5",FALSE,"Minnesota Vikings",24,31,11,190,138,52,1,23,465,303,162,2,1998-11-08,1,0,"nor",-7
"11","Sun","November 15","W","","5-5",TRUE,"St. Louis Rams",24,3,13,237,135,102,0,17,234,179,55,3,1998-11-15,3,1,"nor",21
"12","Sun","November 22","L","","5-6",FALSE,"San Francisco 49ers",20,31,23,401,311,90,4,23,443,289,154,3,1998-11-22,-1,0,"nor",-11
"13","Sun","November 29","L","","5-7",FALSE,"Miami Dolphins",10,30,11,157,70,87,4,24,375,255,120,1,1998-11-29,-3,0,"nor",-20
"14","Sun","December 6","W","","6-7",TRUE,"Dallas Cowboys",22,3,17,328,215,113,2,10,182,174,8,0,1998-12-06,-2,1,"nor",19
"15","Sun","December 13","L","","6-8",TRUE,"Atlanta Falcons",17,27,15,216,164,52,4,25,504,322,182,3,1998-12-13,-1,0,"nor",-10
"16","Sun","December 20","L","","6-9",FALSE,"Arizona Cardinals",17,19,18,320,238,82,1,28,513,394,119,3,1998-12-20,2,0,"nor",-2
"17","Sun","December 27","L","","6-10",TRUE,"Buffalo Bills",33,45,26,366,291,75,3,21,308,192,116,0,1998-12-27,-3,0,"nor",-12
"1","Sun","September 12","W","","1-0",TRUE,"Carolina Panthers",19,10,13,255,108,147,0,12,246,161,85,3,1999-09-12,3,1,"nor",9
"2","Sun","September 19","L","","1-1",FALSE,"San Francisco 49ers",21,28,17,324,223,101,3,21,311,223,88,1,1999-09-19,-2,0,"nor",-7
"4","Sun","October 3","L","","1-2",FALSE,"Chicago Bears",10,14,17,269,132,137,1,20,324,212,112,5,1999-10-03,4,0,"nor",-4
"5","Sun","October 10","L","","1-3",TRUE,"Atlanta Falcons",17,20,18,390,319,71,2,12,251,147,104,2,1999-10-10,0,0,"nor",-3
"6","Sun","October 17","L","","1-4",TRUE,"Tennessee Titans",21,24,22,409,354,55,4,15,278,113,165,3,1999-10-17,-1,0,"nor",-3
"7","Sun","October 24","L","","1-5",FALSE,"New York Giants",3,31,12,270,163,107,3,19,321,215,106,2,1999-10-24,-1,0,"nor",-28
"8","Sun","October 31","L","","1-6",TRUE,"Cleveland Browns",16,21,25,351,120,231,5,9,243,181,62,1,1999-10-31,-4,0,"nor",-5
"9","Sun","November 7","L","","1-7",TRUE,"Tampa Bay Buccaneers",16,31,21,303,205,98,3,18,381,225,156,2,1999-11-07,-1,0,"nor",-15
"10","Sun","November 14","W","","2-7",TRUE,"San Francisco 49ers",24,6,20,365,222,143,0,16,234,140,94,1,1999-11-14,1,1,"nor",18
"11","Sun","November 21","L","","2-8",FALSE,"Jacksonville Jaguars",23,41,21,339,233,106,1,30,494,355,139,1,1999-11-21,0,0,"nor",-18
"12","Sun","November 28","L","","2-9",FALSE,"St. Louis Rams",12,43,20,365,263,102,2,24,324,195,129,0,1999-11-28,-2,0,"nor",-31
"13","Sun","December 5","L","","2-10",FALSE,"Atlanta Falcons",12,35,21,240,91,149,2,21,361,233,128,3,1999-12-05,1,0,"nor",-23
"14","Sun","December 12","L","","2-11",TRUE,"St. Louis Rams",14,30,13,210,144,66,3,23,492,336,156,2,1999-12-12,-1,0,"nor",-16
"15","Sun","December 19","L","","2-12",FALSE,"Baltimore Ravens",8,31,8,248,237,11,4,15,335,274,61,4,1999-12-19,0,0,"nor",-23
"16","Fri","December 24","W","","3-12",TRUE,"Dallas Cowboys",31,24,18,310,249,61,2,24,368,246,122,3,1999-12-24,1,1,"nor",7
"17","Sun","January 2","L","","3-13",FALSE,"Carolina Panthers",13,45,22,335,230,105,4,18,355,288,67,1,2000-01-02,-3,0,"nor",-32
"1","Sun","September 3","L","","0-1",TRUE,"Detroit Lions",10,14,13,252,146,106,3,10,187,89,98,2,2000-09-03,-1,0,"nor",-4
"2","Sun","September 10","W","","1-1",FALSE,"San Diego Chargers",28,27,28,323,259,64,3,15,188,116,72,2,2000-09-10,-1,1,"nor",1
"3","Sun","September 17","L","","1-2",FALSE,"Seattle Seahawks",10,20,13,263,147,116,0,22,295,169,126,1,2000-09-17,1,0,"nor",-10
"4","Sun","September 24","L","","1-3",TRUE,"Philadelphia Eagles",7,21,17,287,141,146,4,14,268,201,67,2,2000-09-24,-2,0,"nor",-14
"6","Sun","October 8","W","","2-3",FALSE,"Chicago Bears",31,10,24,403,217,186,1,13,245,173,72,3,2000-10-08,2,1,"nor",21
"7","Sun","October 15","W","","3-3",TRUE,"Carolina Panthers",24,6,21,397,182,215,3,8,141,131,10,2,2000-10-15,-1,1,"nor",18
"8","Sun","October 22","W","","4-3",FALSE,"Atlanta Falcons",21,19,25,402,206,196,1,13,278,203,75,0,2000-10-22,-1,1,"nor",2
"9","Sun","October 29","W","","5-3",FALSE,"Arizona Cardinals",21,10,17,247,158,89,1,24,394,269,125,4,2000-10-29,3,1,"nor",11
"10","Sun","November 5","W","","6-3",TRUE,"San Francisco 49ers",31,15,25,360,249,111,0,19,346,262,84,2,2000-11-05,2,1,"nor",16
"11","Sun","November 12","W","","7-3",FALSE,"Carolina Panthers",20,10,16,322,165,157,2,21,311,258,53,5,2000-11-12,3,1,"nor",10
"12","Sun","November 19","L","","7-4",TRUE,"Oakland Raiders",22,31,19,333,200,133,1,19,293,134,159,1,2000-11-19,0,0,"nor",-9
"13","Sun","November 26","W","","8-4",FALSE,"St. Louis Rams",31,24,23,332,185,147,2,21,279,251,28,4,2000-11-26,2,1,"nor",7
"14","Sun","December 3","L","","8-5",TRUE,"Denver Broncos",23,38,19,446,425,21,3,24,483,200,283,0,2000-12-03,-3,0,"nor",-15
"15","Sun","December 10","W","","9-5",FALSE,"San Francisco 49ers",31,27,21,388,172,216,0,21,398,288,110,3,2000-12-10,3,1,"nor",4
"16","Sun","December 17","W","","10-5",TRUE,"Atlanta Falcons",23,7,19,373,281,92,1,9,163,99,64,3,2000-12-17,2,1,"nor",16
"17","Sun","December 24","L","","10-6",TRUE,"St. Louis Rams",21,26,12,269,196,73,1,26,474,228,246,1,2000-12-24,0,0,"nor",-5
"WildCard","Sat","December 30","W","","11-6",TRUE,"St. Louis Rams",31,28,17,301,251,50,2,17,384,350,34,5,2000-12-30,3,1,"nor",3
"Division","Sat","January 6","L","","11-7",FALSE,"Minnesota Vikings",16,34,19,355,286,69,2,18,429,302,127,0,2001-01-06,-2,0,"nor",-18
"1","Sun","September 9","W","","1-0",FALSE,"Buffalo Bills",24,6,17,301,192,109,0,12,251,126,125,3,2001-09-09,3,1,"nor",18
"3","Sun","September 30","L","","1-1",FALSE,"New York Giants",13,21,20,330,256,74,1,13,253,100,153,1,2001-09-30,0,0,"nor",-8
"4","Sun","October 7","W","","2-1",TRUE,"Minnesota Vikings",28,15,20,370,210,160,1,16,340,306,34,3,2001-10-07,2,1,"nor",13
"5","Sun","October 14","W","","3-1",FALSE,"Carolina Panthers",27,25,21,358,160,198,3,13,218,184,34,3,2001-10-14,0,1,"nor",2
"6","Sun","October 21","L","","3-2",TRUE,"Atlanta Falcons",13,20,16,276,213,63,1,12,297,173,124,2,2001-10-21,1,0,"nor",-7
"7","Sun","October 28","W","","4-2",FALSE,"St. Louis Rams",34,31,15,320,238,82,2,25,474,426,48,8,2001-10-28,6,1,"nor",3
"8","Sun","November 4","L","","4-3",TRUE,"New York Jets",9,16,13,246,138,108,4,12,272,130,142,2,2001-11-04,-2,0,"nor",-7
"9","Sun","November 11","L","","4-4",FALSE,"San Francisco 49ers",27,28,24,488,336,152,1,21,415,251,164,0,2001-11-11,-1,0,"nor",-1
"10","Sun","November 18","W","","5-4",TRUE,"Indianapolis Colts",34,20,25,378,221,157,0,18,339,262,77,1,2001-11-18,1,1,"nor",14
"11","Sun","November 25","L","","5-5",FALSE,"New England Patriots",17,34,23,428,307,121,2,26,432,241,191,0,2001-11-25,-2,0,"nor",-17
"12","Sun","December 2","W","","6-5",TRUE,"Carolina Panthers",27,23,25,432,307,125,2,11,150,101,49,1,2001-12-02,-1,1,"nor",4
"13","Sun","December 9","W","","7-5",FALSE,"Atlanta Falcons",28,10,19,379,265,114,2,20,230,180,50,2,2001-12-09,0,1,"nor",18
"14","Mon","December 17","L","","7-6",TRUE,"St. Louis Rams",21,34,17,310,242,68,2,21,365,309,56,2,2001-12-17,0,0,"nor",-13
"15","Sun","December 23","L","","7-7",FALSE,"Tampa Bay Buccaneers",21,48,16,271,230,41,4,23,364,207,157,0,2001-12-23,-4,0,"nor",-27
"16","Sun","December 30","L","","7-8",TRUE,"Washington Redskins",10,40,12,213,113,100,4,19,263,90,173,1,2001-12-30,-3,0,"nor",-30
"17","Sun","January 6","L","","7-9",TRUE,"San Francisco 49ers",0,38,11,126,86,40,6,22,407,269,138,1,2002-01-06,-5,0,"nor",-38
"1","Sun","September 8","W","OT","1-0",FALSE,"Tampa Bay Buccaneers",26,20,21,368,250,118,1,19,333,261,72,1,2002-09-08,0,1,"nor",6
"2","Sun","September 15","W","","2-0",TRUE,"Green Bay Packers",35,20,16,357,211,146,2,18,357,262,95,4,2002-09-15,2,1,"nor",15
"3","Sun","September 22","W","","3-0",FALSE,"Chicago Bears",29,23,18,302,229,73,3,21,353,228,125,2,2002-09-22,-1,1,"nor",6
"4","Sun","September 29","L","","3-1",FALSE,"Detroit Lions",21,26,24,357,247,110,3,16,352,267,85,0,2002-09-29,-3,0,"nor",-5
"5","Sun","October 6","W","","4-1",TRUE,"Pittsburgh Steelers",32,29,17,315,194,121,0,23,364,244,120,2,2002-10-06,2,1,"nor",3
"6","Sun","October 13","W","","5-1",FALSE,"Washington Redskins",43,27,16,311,192,119,1,20,318,264,54,5,2002-10-13,4,1,"nor",16
"7","Sun","October 20","W","","6-1",TRUE,"San Francisco 49ers",35,27,27,422,243,179,1,26,418,275,143,2,2002-10-20,1,1,"nor",8
"8","Sun","October 27","L","","6-2",TRUE,"Atlanta Falcons",35,37,22,351,192,159,3,28,446,186,260,2,2002-10-27,-1,0,"nor",-2
"10","Sun","November 10","W","","7-2",FALSE,"Carolina Panthers",34,24,17,345,248,97,0,21,396,296,100,2,2002-11-10,2,1,"nor",10
"11","Sun","November 17","L","","7-3",FALSE,"Atlanta Falcons",17,24,16,344,264,80,2,22,292,137,155,1,2002-11-17,-1,0,"nor",-7
"12","Sun","November 24","L","","7-4",TRUE,"Cleveland Browns",15,24,19,383,309,74,6,17,339,176,163,2,2002-11-24,-4,0,"nor",-9
"13","Sun","December 1","W","","8-4",TRUE,"Tampa Bay Buccaneers",23,20,14,238,136,102,1,17,283,249,34,3,2002-12-01,2,1,"nor",3
"14","Sun","December 8","W","","9-4",FALSE,"Baltimore Ravens",37,25,22,359,209,150,2,19,410,296,114,5,2002-12-08,3,1,"nor",12
"15","Sun","December 15","L","","9-5",TRUE,"Minnesota Vikings",31,32,18,299,221,78,0,22,439,293,146,0,2002-12-15,0,0,"nor",-1
"16","Sun","December 22","L","","9-6",FALSE,"Cincinnati Bengals",13,20,11,210,177,33,2,25,423,183,240,4,2002-12-22,2,0,"nor",-7
"17","Sun","December 29","L","","9-7",TRUE,"Carolina Panthers",6,10,13,244,119,125,3,13,273,188,85,3,2002-12-29,0,0,"nor",-4
"1","Sun","September 7","L","","0-1",FALSE,"Seattle Seahawks",10,27,20,359,263,96,4,17,270,119,151,0,2003-09-07,-4,0,"nor",-17
"2","Sun","September 14","W","","1-1",TRUE,"Houston Texans",31,10,12,292,182,110,0,16,258,183,75,2,2003-09-14,2,1,"nor",21
"3","Sun","September 21","L","","1-2",FALSE,"Tennessee Titans",12,27,11,188,165,23,2,28,385,280,105,1,2003-09-21,-1,0,"nor",-15
"4","Sun","September 28","L","","1-3",TRUE,"Indianapolis Colts",21,55,20,363,208,155,4,20,418,318,100,0,2003-09-28,-4,0,"nor",-34
"5","Sun","October 5","L","","1-4",FALSE,"Carolina Panthers",13,19,17,344,189,155,1,21,309,124,185,1,2003-10-05,0,0,"nor",-6
"6","Sun","October 12","W","","2-4",TRUE,"Chicago Bears",20,13,18,283,153,130,0,16,271,131,140,2,2003-10-12,2,1,"nor",7
"7","Sun","October 19","W","","3-4",FALSE,"Atlanta Falcons",45,17,27,506,342,164,1,11,238,108,130,1,2003-10-19,0,1,"nor",28
"8","Sun","October 26","L","OT","3-5",TRUE,"Carolina Panthers",20,23,19,294,190,104,3,20,368,145,223,0,2003-10-26,-3,0,"nor",-3
"9","Sun","November 2","W","","4-5",FALSE,"Tampa Bay Buccaneers",17,14,10,257,133,124,1,21,352,296,56,6,2003-11-02,5,1,"nor",3
"11","Sun","November 16","W","OT","5-5",TRUE,"Atlanta Falcons",23,20,23,403,193,210,4,11,244,76,168,3,2003-11-16,-1,1,"nor",3
"12","Sun","November 23","L","","5-6",FALSE,"Philadelphia Eagles",20,33,27,466,267,199,3,22,448,247,201,0,2003-11-23,-3,0,"nor",-13
"13","Sun","November 30","W","","6-6",FALSE,"Washington Redskins",24,20,23,310,121,189,0,20,392,231,161,3,2003-11-30,3,1,"nor",4
"14","Sun","December 7","L","","6-7",TRUE,"Tampa Bay Buccaneers",7,14,16,292,202,90,3,16,314,207,107,1,2003-12-07,-2,0,"nor",-7
"15","Sun","December 14","W","","7-7",TRUE,"New York Giants",45,7,26,440,308,132,1,16,241,130,111,2,2003-12-14,1,1,"nor",38
"16","Sun","December 21","L","","7-8",FALSE,"Jacksonville Jaguars",19,20,20,350,289,61,1,22,374,131,243,2,2003-12-21,1,0,"nor",-1
"17","Sun","December 28","W","","8-8",TRUE,"Dallas Cowboys",13,7,13,291,233,58,0,21,352,267,85,3,2003-12-28,3,1,"nor",6
"1","Sun","September 12","L","","0-1",TRUE,"Seattle Seahawks",7,21,12,281,207,74,3,21,415,246,169,2,2004-09-12,-1,0,"nor",-14
"2","Sun","September 19","W","","1-1",TRUE,"San Francisco 49ers",30,27,17,302,256,46,1,22,370,190,180,3,2004-09-19,2,1,"nor",3
"3","Sun","September 26","W","OT","2-1",FALSE,"St. Louis Rams",28,25,27,462,316,146,0,25,403,325,78,1,2004-09-26,1,1,"nor",3
"4","Sun","October 3","L","","2-2",FALSE,"Arizona Cardinals",10,34,14,279,238,41,2,19,373,162,211,1,2004-10-03,-1,0,"nor",-24
"5","Sun","October 10","L","","2-3",TRUE,"Tampa Bay Buccaneers",17,20,16,251,106,145,2,16,319,238,81,1,2004-10-10,-1,0,"nor",-3
"6","Sun","October 17","L","","2-4",TRUE,"Minnesota Vikings",31,38,25,385,226,159,1,29,605,417,188,3,2004-10-17,2,0,"nor",-7
"7","Sun","October 24","W","","3-4",FALSE,"Oakland Raiders",31,26,20,322,280,42,0,20,432,350,82,2,2004-10-24,2,1,"nor",5
"9","Sun","November 7","L","","3-5",FALSE,"San Diego Chargers",17,43,18,220,165,55,2,28,402,250,152,0,2004-11-07,-2,0,"nor",-26
"10","Sun","November 14","W","","4-5",TRUE,"Kansas City Chiefs",27,20,20,374,240,134,1,28,497,297,200,4,2004-11-14,3,1,"nor",7
"11","Sun","November 21","L","","4-6",TRUE,"Denver Broncos",13,34,20,411,362,49,4,18,389,224,165,0,2004-11-21,-4,0,"nor",-21
"12","Sun","November 28","L","","4-7",FALSE,"Atlanta Falcons",21,24,19,306,165,141,2,21,396,210,186,2,2004-11-28,0,0,"nor",-3
"13","Sun","December 5","L","","4-8",TRUE,"Carolina Panthers",21,32,15,280,250,30,3,25,401,269,132,0,2004-12-05,-3,0,"nor",-11
"14","Sun","December 12","W","","5-8",FALSE,"Dallas Cowboys",27,13,21,344,239,105,2,18,269,148,121,4,2004-12-12,2,1,"nor",14
"15","Sun","December 19","W","","6-8",FALSE,"Tampa Bay Buccaneers",21,17,15,247,132,115,1,17,283,114,169,4,2004-12-19,3,1,"nor",4
"16","Sun","December 26","W","","7-8",TRUE,"Atlanta Falcons",26,13,17,369,209,160,2,15,267,174,93,3,2004-12-26,1,1,"nor",13
"17","Sun","January 2","W","","8-8",FALSE,"Carolina Panthers",21,18,15,360,196,164,0,21,320,274,46,3,2005-01-02,3,1,"nor",3
"1","Sun","September 11","W","","1-0",FALSE,"Carolina Panthers",23,20,21,291,190,101,2,20,350,209,141,4,2005-09-11,2,1,"nor",3
"2","Mon","September 19","L","","1-1",TRUE,"New York Giants",10,27,23,422,350,72,6,15,257,165,92,1,2005-09-19,-5,0,"nor",-17
"3","Sun","September 25","L","","1-2",FALSE,"Minnesota Vikings",16,33,15,296,182,114,4,21,420,274,146,0,2005-09-25,-4,0,"nor",-17
"4","Sun","October 2","W","","2-2",TRUE,"Buffalo Bills",19,7,23,333,166,167,0,13,208,67,141,2,2005-10-02,2,1,"nor",12
"5","Sun","October 9","L","","2-3",FALSE,"Green Bay Packers",3,52,14,254,159,95,5,21,309,215,94,0,2005-10-09,-5,0,"nor",-49
"6","Sun","October 16","L","","2-4",TRUE,"Atlanta Falcons",31,34,32,456,245,211,2,21,266,106,160,1,2005-10-16,-1,0,"nor",-3
"7","Sun","October 23","L","","2-5",FALSE,"St. Louis Rams",17,28,24,332,213,119,2,16,298,189,109,1,2005-10-23,-1,0,"nor",-11
"8","Sun","October 30","L","","2-6",TRUE,"Miami Dolphins",6,21,14,203,113,90,2,20,342,154,188,2,2005-10-30,0,0,"nor",-15
"9","Sun","November 6","L","","2-7",TRUE,"Chicago Bears",17,20,15,283,150,133,4,15,314,131,183,3,2005-11-06,-1,0,"nor",-3
"11","Sun","November 20","L","","2-8",FALSE,"New England Patriots",17,24,23,425,338,87,1,20,326,194,132,1,2005-11-20,0,0,"nor",-7
"12","Sun","November 27","W","","3-8",FALSE,"New York Jets",21,19,18,269,172,97,0,19,360,242,118,0,2005-11-27,0,1,"nor",2
"13","Sun","December 4","L","","3-9",TRUE,"Tampa Bay Buccaneers",3,10,16,279,214,65,4,14,248,115,133,0,2005-12-04,-4,0,"nor",-7
"14","Mon","December 12","L","","3-10",FALSE,"Atlanta Falcons",17,36,22,332,207,125,1,19,406,279,127,1,2005-12-12,0,0,"nor",-19
"15","Sun","December 18","L","","3-11",TRUE,"Carolina Panthers",10,27,15,277,183,94,6,19,326,165,161,2,2005-12-18,-4,0,"nor",-17
"16","Sat","December 24","L","","3-12",TRUE,"Detroit Lions",12,13,19,273,226,47,1,14,279,208,71,1,2005-12-24,0,0,"nor",-1
"17","Sun","January 1","L","","3-13",FALSE,"Tampa Bay Buccaneers",13,27,18,306,235,71,3,14,285,136,149,0,2006-01-01,-3,0,"nor",-14
"1","Sun","September 10","W","","1-0",FALSE,"Cleveland Browns",19,14,17,326,170,156,2,15,186,101,85,3,2006-09-10,1,1,"nor",5
"2","Sun","September 17","W","","2-0",FALSE,"Green Bay Packers",34,27,20,380,332,48,3,21,385,322,63,2,2006-09-17,-1,1,"nor",7
"3","Mon","September 25","W","","3-0",TRUE,"Atlanta Falcons",23,3,19,326,180,146,0,10,229,112,117,0,2006-09-25,0,1,"nor",20
"4","Sun","October 1","L","","3-1",FALSE,"Carolina Panthers",18,21,22,407,344,63,1,20,324,157,167,0,2006-10-01,-1,0,"nor",-3
"5","Sun","October 8","W","","4-1",TRUE,"Tampa Bay Buccaneers",24,21,15,314,171,143,0,18,406,219,187,1,2006-10-08,1,1,"nor",3
"6","Sun","October 15","W","","5-1",TRUE,"Philadelphia Eagles",27,24,22,373,275,98,2,20,325,226,99,2,2006-10-15,0,1,"nor",3
"8","Sun","October 29","L","","5-2",TRUE,"Baltimore Ravens",22,35,17,403,368,35,5,21,293,156,137,1,2006-10-29,-4,0,"nor",-13
"9","Sun","November 5","W","","6-2",FALSE,"Tampa Bay Buccaneers",31,14,19,363,314,49,0,11,226,158,68,1,2006-11-05,1,1,"nor",17
"10","Sun","November 12","L","","6-3",FALSE,"Pittsburgh Steelers",31,38,29,513,393,120,3,19,467,250,217,0,2006-11-12,-3,0,"nor",-7
"11","Sun","November 19","L","","6-4",TRUE,"Cincinnati Bengals",16,31,29,595,504,91,4,15,385,266,119,1,2006-11-19,-3,0,"nor",-15
"12","Sun","November 26","W","","7-4",FALSE,"Atlanta Falcons",31,13,20,427,332,95,0,21,333,52,281,0,2006-11-26,0,1,"nor",18
"13","Sun","December 3","W","","8-4",TRUE,"San Francisco 49ers",34,10,23,375,185,190,0,10,202,145,57,3,2006-12-03,3,1,"nor",24
"14","Sun","December 10","W","","9-4",FALSE,"Dallas Cowboys",42,17,28,536,377,159,0,16,347,231,116,2,2006-12-10,2,1,"nor",25
"15","Sun","December 17","L","","9-5",TRUE,"Washington Redskins",10,16,15,270,199,71,1,19,354,193,161,0,2006-12-17,-1,0,"nor",-6
"16","Sun","December 24","W","","10-5",FALSE,"New York Giants",30,7,22,359,123,236,0,6,142,59,83,3,2006-12-24,3,1,"nor",23
"17","Sun","December 31","L","","10-6",TRUE,"Carolina Panthers",21,31,13,297,236,61,2,20,313,207,106,0,2006-12-31,-2,0,"nor",-10
"Division","Sat","January 13","W","","11-6",TRUE,"Philadelphia Eagles",27,24,27,435,227,208,1,14,355,232,123,0,2007-01-13,-1,1,"nor",3
"ConfChamp","Sun","January 21","L","","11-7",FALSE,"Chicago Bears",14,39,15,375,319,56,4,18,340,144,196,0,2007-01-21,-4,0,"nor",-25
"1","Thu","September 6","L","","0-1",FALSE,"Indianapolis Colts",10,41,18,293,187,106,3,20,452,288,164,1,2007-09-06,-2,0,"nor",-31
"2","Sun","September 16","L","","0-2",FALSE,"Tampa Bay Buccaneers",14,31,19,343,244,99,2,14,330,243,87,0,2007-09-16,-2,0,"nor",-17
"3","Mon","September 24","L","","0-3",TRUE,"Tennessee Titans",14,31,18,252,218,34,5,19,284,186,98,1,2007-09-24,-4,0,"nor",-17
"5","Sun","October 7","L","","0-4",TRUE,"Carolina Panthers",13,16,23,341,252,89,2,12,243,155,88,1,2007-10-07,-1,0,"nor",-3
"6","Sun","October 14","W","","1-4",FALSE,"Seattle Seahawks",28,17,22,367,246,121,1,25,425,333,92,2,2007-10-14,1,1,"nor",11
"7","Sun","October 21","W","","2-4",TRUE,"Atlanta Falcons",22,16,14,310,219,91,1,18,334,259,75,0,2007-10-21,-1,1,"nor",6
"8","Sun","October 28","W","","3-4",FALSE,"San Francisco 49ers",31,10,26,438,336,102,1,15,260,177,83,1,2007-10-28,0,1,"nor",21
"9","Sun","November 4","W","","4-4",TRUE,"Jacksonville Jaguars",41,24,32,538,435,103,1,18,432,344,88,3,2007-11-04,2,1,"nor",17
"10","Sun","November 11","L","","4-5",TRUE,"St. Louis Rams",29,37,22,299,256,43,2,26,409,276,133,0,2007-11-11,-2,0,"nor",-8
"11","Sun","November 18","L","","4-6",FALSE,"Houston Texans",10,23,20,327,280,47,3,19,390,287,103,2,2007-11-18,-1,0,"nor",-13
"12","Sun","November 25","W","","5-6",FALSE,"Carolina Panthers",31,6,22,373,260,113,1,11,195,152,43,4,2007-11-25,3,1,"nor",25
"13","Sun","December 2","L","","5-7",TRUE,"Tampa Bay Buccaneers",23,27,13,246,162,84,1,24,466,294,172,1,2007-12-02,0,0,"nor",-4
"14","Mon","December 10","W","","6-7",FALSE,"Atlanta Falcons",34,14,23,473,328,145,1,13,323,286,37,1,2007-12-10,0,1,"nor",20
"15","Sun","December 16","W","","7-7",TRUE,"Arizona Cardinals",31,24,24,421,307,114,2,17,317,214,103,2,2007-12-16,0,1,"nor",7
"16","Sun","December 23","L","","7-8",TRUE,"Philadelphia Eagles",23,38,22,346,276,70,1,24,435,251,184,1,2007-12-23,0,0,"nor",-15
"17","Sun","December 30","L","","7-9",FALSE,"Chicago Bears",25,33,28,413,308,105,3,13,275,179,96,3,2007-12-30,0,0,"nor",-8
"1","Sun","September 7","W","","1-0",TRUE,"Tampa Bay Buccaneers",24,20,16,438,337,101,1,18,352,206,146,1,2008-09-07,0,1,"nor",4
"2","Sun","September 14","L","","1-1",FALSE,"Washington Redskins",24,29,16,250,195,55,3,25,455,306,149,1,2008-09-14,-2,0,"nor",-5
"3","Sun","September 21","L","","1-2",FALSE,"Denver Broncos",32,34,27,502,414,88,1,20,369,264,105,2,2008-09-21,1,0,"nor",-2
"4","Sun","September 28","W","","2-2",TRUE,"San Francisco 49ers",31,17,24,467,363,104,2,20,312,221,91,3,2008-09-28,1,1,"nor",14
"5","Mon","October 6","L","","2-3",TRUE,"Minnesota Vikings",27,30,17,375,320,55,4,16,270,226,44,0,2008-10-06,-4,0,"nor",-3
"6","Sun","October 12","W","","3-3",TRUE,"Oakland Raiders",34,3,23,441,319,122,0,12,226,141,85,2,2008-10-12,2,1,"nor",31
"7","Sun","October 19","L","","3-4",FALSE,"Carolina Panthers",7,30,17,343,228,115,2,19,336,193,143,0,2008-10-19,-2,0,"nor",-23
"8","Sun","October 26","W","","4-4",TRUE,"San Diego Chargers",37,32,28,409,339,70,0,22,451,341,110,2,2008-10-26,2,1,"nor",5
"10","Sun","November 9","L","","4-5",FALSE,"Atlanta Falcons",20,34,25,521,416,105,3,18,361,248,113,0,2008-11-09,-3,0,"nor",-14
"11","Sun","November 16","W","","5-5",FALSE,"Kansas City Chiefs",30,20,22,369,266,103,1,21,330,206,124,1,2008-11-16,0,1,"nor",10
"12","Mon","November 24","W","","6-5",TRUE,"Green Bay Packers",51,29,21,416,318,98,1,22,343,234,109,3,2008-11-24,2,1,"nor",22
"13","Sun","November 30","L","","6-6",FALSE,"Tampa Bay Buccaneers",20,23,18,332,288,44,3,11,254,105,149,1,2008-11-30,-2,0,"nor",-3
"14","Sun","December 7","W","","7-6",TRUE,"Atlanta Falcons",29,25,24,414,230,184,0,22,414,315,99,1,2008-12-07,1,1,"nor",4
"15","Thu","December 11","L","OT","7-7",FALSE,"Chicago Bears",24,27,22,345,226,119,2,16,226,171,55,3,2008-12-11,1,0,"nor",-3
"16","Sun","December 21","W","","8-7",FALSE,"Detroit Lions",42,7,32,532,351,181,1,15,255,126,129,2,2008-12-21,1,1,"nor",35
"17","Sun","December 28","L","","8-8",TRUE,"Carolina Panthers",31,33,22,417,367,50,2,23,478,244,234,0,2008-12-28,-2,0,"nor",-2
"1","Sun","September 13","W","","1-0",TRUE,"Detroit Lions",45,27,28,515,358,157,3,14,231,198,33,3,2009-09-13,0,1,"nor",18
"2","Sun","September 20","W","","2-0",FALSE,"Philadelphia Eagles",48,22,23,421,288,133,1,23,463,384,79,4,2009-09-20,3,1,"nor",26
"3","Sun","September 27","W","","3-0",FALSE,"Buffalo Bills",27,7,21,378,156,222,1,13,243,154,89,2,2009-09-27,1,1,"nor",20
"4","Sun","October 4","W","","4-0",TRUE,"New York Jets",24,10,18,343,190,153,1,14,244,112,132,4,2009-10-04,3,1,"nor",14
"6","Sun","October 18","W","","5-0",TRUE,"New York Giants",48,27,28,493,369,124,0,17,325,241,84,2,2009-10-18,2,1,"nor",21
"7","Sun","October 25","W","","6-0",FALSE,"Miami Dolphins",46,34,22,414,276,138,4,17,334,197,137,3,2009-10-25,-1,1,"nor",12
"8","Mon","November 2","W","","7-0",TRUE,"Atlanta Falcons",35,27,23,437,291,146,4,21,442,281,161,3,2009-11-02,-1,1,"nor",8
"9","Sun","November 8","W","","8-0",TRUE,"Carolina Panthers",30,20,18,414,330,84,2,21,371,189,182,3,2009-11-08,1,1,"nor",10
"10","Sun","November 15","W","","9-0",FALSE,"St. Louis Rams",28,23,19,420,217,203,3,23,434,293,141,1,2009-11-15,-2,1,"nor",5
"11","Sun","November 22","W","","10-0",FALSE,"Tampa Bay Buccaneers",38,7,21,370,187,183,0,14,219,100,119,4,2009-11-22,4,1,"nor",31
"12","Mon","November 30","W","","11-0",TRUE,"New England Patriots",38,17,18,480,367,113,1,23,366,244,122,3,2009-11-30,2,1,"nor",21
"13","Sun","December 6","W","OT","12-0",FALSE,"Washington Redskins",33,30,25,463,408,55,1,28,455,367,88,4,2009-12-06,3,1,"nor",3
"14","Sun","December 13","W","","13-0",FALSE,"Atlanta Falcons",26,23,24,391,296,95,0,19,392,303,89,1,2009-12-13,1,1,"nor",3
"15","Sat","December 19","L","","13-1",TRUE,"Dallas Cowboys",17,24,23,336,271,65,3,24,439,294,145,0,2009-12-19,-3,0,"nor",-7
"16","Sun","December 27","L","OT","13-2",TRUE,"Tampa Bay Buccaneers",17,20,23,373,249,124,1,24,439,263,176,2,2009-12-27,1,0,"nor",-3
"17","Sun","January 3","L","","13-3",FALSE,"Carolina Panthers",10,23,14,213,102,111,3,15,327,149,178,0,2010-01-03,-3,0,"nor",-13
"Division","Sat","January 16","W","","14-3",TRUE,"Arizona Cardinals",45,14,27,418,247,171,0,15,359,258,101,2,2010-01-16,2,1,"nor",31
"ConfChamp","Sun","January 24","W","OT","15-3",TRUE,"Minnesota Vikings",31,28,15,257,189,68,1,31,475,310,165,5,2010-01-24,4,1,"nor",3
"SuperBowl","Sun","February 7","W","","16-3",TRUE,"Indianapolis Colts",31,17,20,332,281,51,0,23,432,333,99,1,2010-02-07,1,1,"nor",14
"1","Thu","September 9","W","","1-0",TRUE,"Minnesota Vikings",14,9,18,308,229,79,0,12,253,162,91,1,2010-09-09,1,1,"nor",5
"2","Mon","September 20","W","","2-0",FALSE,"San Francisco 49ers",25,22,17,287,237,50,0,24,417,275,142,4,2010-09-20,4,1,"nor",3
"3","Sun","September 26","L","OT","2-1",TRUE,"Atlanta Falcons",24,27,20,398,355,43,3,25,417,215,202,1,2010-09-26,-2,0,"nor",-3
"4","Sun","October 3","W","","3-1",TRUE,"Carolina Panthers",16,14,27,383,262,121,2,10,251,133,118,1,2010-10-03,-1,1,"nor",2
"5","Sun","October 10","L","","3-2",FALSE,"Arizona Cardinals",20,30,19,358,273,85,4,12,194,153,41,1,2010-10-10,-3,0,"nor",-10
"6","Sun","October 17","W","","4-2",FALSE,"Tampa Bay Buccaneers",31,6,27,475,263,212,1,21,277,235,42,1,2010-10-17,0,1,"nor",25
"7","Sun","October 24","L","","4-3",TRUE,"Cleveland Browns",17,30,25,394,336,58,4,12,210,85,125,0,2010-10-24,-4,0,"nor",-13
"8","Sun","October 31","W","","5-3",TRUE,"Pittsburgh Steelers",20,10,19,318,288,30,2,13,279,171,108,2,2010-10-31,0,1,"nor",10
"9","Sun","November 7","W","","6-3",FALSE,"Carolina Panthers",34,3,27,408,243,165,1,15,195,68,127,2,2010-11-07,1,1,"nor",31
"11","Sun","November 21","W","","7-3",TRUE,"Seattle Seahawks",34,19,26,494,382,112,2,21,424,366,58,2,2010-11-21,0,1,"nor",15
"12","Thu","November 25","W","","8-3",FALSE,"Dallas Cowboys",30,27,21,414,333,81,2,24,457,313,144,3,2010-11-25,1,1,"nor",3
"13","Sun","December 5","W","","9-3",FALSE,"Cincinnati Bengals",34,30,19,436,290,146,1,21,311,215,96,0,2010-12-05,-1,1,"nor",4
"14","Sun","December 12","W","","10-3",TRUE,"St. Louis Rams",31,13,22,345,213,132,3,14,327,191,136,3,2010-12-12,0,1,"nor",18
"15","Sun","December 19","L","","10-4",FALSE,"Baltimore Ravens",24,30,21,269,242,27,1,17,356,148,208,0,2010-12-19,-1,0,"nor",-6
"16","Mon","December 27","W","","11-4",FALSE,"Atlanta Falcons",17,14,23,368,296,72,2,14,215,140,75,2,2010-12-27,0,1,"nor",3
"17","Sun","January 2","L","","11-5",TRUE,"Tampa Bay Buccaneers",13,23,20,305,199,106,3,18,317,233,84,2,2011-01-02,-1,0,"nor",-10
"WildCard","Sat","January 8","L","","11-6",FALSE,"Seattle Seahawks",36,41,32,474,397,77,1,19,415,265,150,1,2011-01-08,0,0,"nor",-5
"1","Thu","September 8","L","","0-1",FALSE,"Green Bay Packers",34,42,27,477,396,81,1,27,399,296,103,0,2011-09-08,-1,0,"nor",-8
"2","Sun","September 18","W","","1-1",TRUE,"Chicago Bears",30,13,16,382,264,118,1,18,246,186,60,1,2011-09-18,0,1,"nor",17
"3","Sun","September 25","W","","2-1",TRUE,"Houston Texans",40,33,27,454,354,100,2,21,473,364,109,1,2011-09-25,-1,1,"nor",7
"4","Sun","October 2","W","","3-1",FALSE,"Jacksonville Jaguars",23,10,30,503,326,177,2,15,274,170,104,1,2011-10-02,-1,1,"nor",13
"5","Sun","October 9","W","","4-1",FALSE,"Carolina Panthers",30,27,27,444,343,101,1,20,381,219,162,1,2011-10-09,0,1,"nor",3
"6","Sun","October 16","L","","4-2",FALSE,"Tampa Bay Buccaneers",20,26,20,453,383,70,4,21,420,303,117,0,2011-10-16,-4,0,"nor",-6
"7","Sun","October 23","W","","5-2",TRUE,"Indianapolis Colts",62,7,36,557,321,236,0,11,252,97,155,3,2011-10-23,3,1,"nor",55
"8","Sun","October 30","L","","5-3",FALSE,"St. Louis Rams",21,31,8,283,227,56,2,21,323,140,183,1,2011-10-30,-1,0,"nor",-10
"9","Sun","November 6","W","","6-3",TRUE,"Tampa Bay Buccaneers",27,16,25,453,258,195,1,18,365,281,84,0,2011-11-06,-1,1,"nor",11
"10","Sun","November 13","W","OT","7-3",FALSE,"Atlanta Falcons",26,23,18,363,322,41,0,30,481,343,138,1,2011-11-13,1,1,"nor",3
"12","Mon","November 28","W","","8-3",TRUE,"New York Giants",49,24,31,577,372,205,0,29,465,392,73,2,2011-11-28,2,1,"nor",25
"13","Sun","December 4","W","","9-3",TRUE,"Detroit Lions",31,17,21,438,338,100,0,25,466,379,87,1,2011-12-04,1,1,"nor",14
"14","Sun","December 11","W","","10-3",FALSE,"Tennessee Titans",22,17,24,437,323,114,0,17,373,314,59,0,2011-12-11,0,1,"nor",5
"15","Sun","December 18","W","","11-3",FALSE,"Minnesota Vikings",42,20,36,573,412,161,2,12,207,102,105,1,2011-12-18,-1,1,"nor",22
"16","Mon","December 26","W","","12-3",TRUE,"Atlanta Falcons",45,16,26,463,299,164,2,23,469,434,35,1,2011-12-26,-1,1,"nor",29
"17","Sun","January 1","W","","13-3",TRUE,"Carolina Panthers",45,17,33,617,409,208,1,21,301,137,164,2,2012-01-01,1,1,"nor",28
"WildCard","Sat","January 7","W","","14-3",TRUE,"Detroit Lions",45,28,34,626,459,167,2,22,412,380,32,2,2012-01-07,0,1,"nor",17
"Division","Sat","January 14","L","","14-4",FALSE,"San Francisco 49ers",32,36,26,472,435,37,5,17,407,264,143,1,2012-01-14,-4,0,"nor",-4
"1","Sun","September 3","L","OT","0-1",FALSE,"Atlanta Falcons",20,23,17,312,261,51,1,20,391,274,117,3,1995-09-03,2,0,"car",-3
"2","Sun","September 10","L","","0-2",FALSE,"Buffalo Bills",9,31,6,113,12,101,1,16,348,176,172,3,1995-09-10,2,0,"car",-22
"3","Sun","September 17","L","","0-3",TRUE,"St. Louis Rams",10,31,21,294,205,89,7,14,318,202,116,0,1995-09-17,-7,0,"car",-21
"5","Sun","October 1","L","","0-4",TRUE,"Tampa Bay Buccaneers",13,20,20,393,234,159,4,16,310,252,58,0,1995-10-01,-4,0,"car",-7
"6","Sun","October 8","L","","0-5",FALSE,"Chicago Bears",27,31,10,297,228,69,1,27,390,249,141,1,1995-10-08,0,0,"car",-4
"7","Sun","October 15","W","","1-5",TRUE,"New York Jets",26,15,15,265,132,133,3,7,138,113,25,3,1995-10-15,0,1,"car",11
"8","Sun","October 22","W","","2-5",TRUE,"New Orleans Saints",20,3,10,155,29,126,0,17,302,238,64,5,1995-10-22,5,1,"car",17
"9","Sun","October 29","W","OT","3-5",FALSE,"New England Patriots",20,17,23,434,291,143,2,23,326,228,98,2,1995-10-29,0,1,"car",3
"10","Sun","November 5","W","","4-5",FALSE,"San Francisco 49ers",13,7,13,204,132,72,2,19,404,339,65,5,1995-11-05,3,1,"car",6
"11","Sun","November 12","L","","4-6",FALSE,"St. Louis Rams",17,28,17,323,246,77,6,18,315,191,124,3,1995-11-12,-3,0,"car",-11
"12","Sun","November 19","W","","5-6",TRUE,"Arizona Cardinals",27,7,23,370,182,188,1,7,96,62,34,2,1995-11-19,1,1,"car",20
"13","Sun","November 26","L","","5-7",FALSE,"New Orleans Saints",26,34,17,409,329,80,6,24,352,172,180,4,1995-11-26,-2,0,"car",-8
"14","Sun","December 3","W","","6-7",TRUE,"Indianapolis Colts",13,10,12,255,170,85,2,12,200,135,65,2,1995-12-03,0,1,"car",3
"15","Sun","December 10","L","","6-8",TRUE,"San Francisco 49ers",10,31,12,195,119,76,1,26,401,322,79,2,1995-12-10,1,0,"car",-21
"16","Sun","December 17","W","","7-8",TRUE,"Atlanta Falcons",21,17,15,328,283,45,2,25,419,332,87,2,1995-12-17,0,1,"car",4
"17","Sun","December 24","L","","7-9",FALSE,"Washington Redskins",17,20,19,272,193,79,2,17,317,166,151,0,1995-12-24,-2,0,"car",-3
"1","Sun","September 1","W","","1-0",TRUE,"Atlanta Falcons",29,6,23,315,186,129,1,12,281,162,119,1,1996-09-01,0,1,"car",23
"2","Sun","September 8","W","","2-0",FALSE,"New Orleans Saints",22,20,15,225,142,83,1,14,338,244,94,2,1996-09-08,1,1,"car",2
"4","Sun","September 22","W","","3-0",TRUE,"San Francisco 49ers",23,7,21,389,272,117,1,15,300,252,48,1,1996-09-22,0,1,"car",16
"5","Sun","September 29","L","","3-1",FALSE,"Jacksonville Jaguars",14,24,21,272,215,57,2,22,378,199,179,2,1996-09-29,0,0,"car",-10
"6","Sun","October 6","L","","3-2",FALSE,"Minnesota Vikings",12,14,15,256,155,101,6,16,293,192,101,2,1996-10-06,-4,0,"car",-2
"7","Sun","October 13","W","","4-2",TRUE,"St. Louis Rams",45,13,21,361,177,184,1,15,219,141,78,3,1996-10-13,2,1,"car",32
"8","Sun","October 20","W","","5-2",TRUE,"New Orleans Saints",19,7,21,314,155,159,0,10,174,103,71,2,1996-10-20,2,1,"car",12
"9","Sun","October 27","L","","5-3",FALSE,"Philadelphia Eagles",9,20,10,300,239,61,2,16,359,329,30,1,1996-10-27,-1,0,"car",-11
"10","Sun","November 3","L","","5-4",FALSE,"Atlanta Falcons",17,20,17,347,243,104,3,16,313,189,124,2,1996-11-03,-1,0,"car",-3
"11","Sun","November 10","W","","6-4",TRUE,"New York Giants",27,17,23,350,208,142,1,14,289,215,74,4,1996-11-10,3,1,"car",10
"12","Sun","November 17","W","","7-4",FALSE,"St. Louis Rams",20,10,22,255,108,147,2,15,243,121,122,1,1996-11-17,-1,1,"car",10
"13","Sun","November 24","W","","8-4",FALSE,"Houston Oilers",31,6,12,254,160,94,1,17,271,186,85,4,1996-11-24,3,1,"car",25
"14","Sun","December 1","W","","9-4",TRUE,"Tampa Bay Buccaneers",24,0,13,215,83,132,0,17,284,206,78,4,1996-12-01,4,1,"car",24
"15","Sun","December 8","W","","10-4",FALSE,"San Francisco 49ers",30,24,22,382,324,58,0,23,450,375,75,4,1996-12-08,4,1,"car",6
"16","Sun","December 15","W","","11-4",TRUE,"Baltimore Ravens",27,16,21,350,268,82,2,17,319,220,99,3,1996-12-15,1,1,"car",11
"17","Sun","December 22","W","","12-4",TRUE,"Pittsburgh Steelers",18,14,15,227,148,79,2,12,265,80,185,2,1996-12-22,0,1,"car",4
"Division","Sun","January 5","W","","13-4",TRUE,"Dallas Cowboys",26,17,18,227,100,127,2,21,244,148,96,3,1997-01-05,1,1,"car",9
"ConfChamp","Sun","January 12","L","","13-5",FALSE,"Green Bay Packers",13,30,12,251,206,45,3,22,479,278,201,2,1997-01-12,-1,0,"car",-17
"1","Sun","August 31","L","","0-1",TRUE,"Washington Redskins",10,24,16,262,104,158,4,23,323,125,198,0,1997-08-31,-4,0,"car",-14
"2","Sun","September 7","W","","1-1",FALSE,"Atlanta Falcons",9,6,21,321,228,93,2,8,210,162,48,2,1997-09-07,0,1,"car",3
"3","Sun","September 14","W","","2-1",FALSE,"San Diego Chargers",26,7,21,279,138,141,1,17,251,155,96,4,1997-09-14,3,1,"car",19
"4","Sun","September 21","L","","2-2",TRUE,"Kansas City Chiefs",14,35,24,364,278,86,5,18,331,214,117,1,1997-09-21,-4,0,"car",-21
"5","Mon","September 29","L","","2-3",TRUE,"San Francisco 49ers",21,34,16,254,210,44,4,27,368,149,219,1,1997-09-29,-3,0,"car",-13
"7","Sun","October 12","L","","2-4",FALSE,"Minnesota Vikings",14,21,15,277,197,80,2,17,361,203,158,1,1997-10-12,-1,0,"car",-7
"8","Sun","October 19","W","","3-4",FALSE,"New Orleans Saints",13,0,15,269,196,73,1,15,200,89,111,2,1997-10-19,1,1,"car",13
"9","Sun","October 26","W","","4-4",TRUE,"Atlanta Falcons",21,12,14,228,91,137,3,17,301,233,68,3,1997-10-26,0,1,"car",9
"10","Sun","November 2","W","","5-4",TRUE,"Oakland Raiders",38,14,27,408,192,216,0,20,357,319,38,2,1997-11-02,2,1,"car",24
"11","Sun","November 9","L","","5-5",FALSE,"Denver Broncos",0,34,7,147,113,34,4,20,393,233,160,1,1997-11-09,-3,0,"car",-34
"12","Sun","November 16","L","","5-6",FALSE,"San Francisco 49ers",19,27,18,254,169,85,3,20,320,221,99,0,1997-11-16,-3,0,"car",-8
"13","Sun","November 23","W","","6-6",FALSE,"St. Louis Rams",16,10,17,302,254,48,1,12,268,187,81,1,1997-11-23,0,1,"car",6
"14","Sun","November 30","L","","6-7",TRUE,"New Orleans Saints",13,16,21,427,241,186,4,18,326,190,136,2,1997-11-30,-2,0,"car",-3
"15","Mon","December 8","W","","7-7",FALSE,"Dallas Cowboys",23,13,22,324,169,155,1,9,216,138,78,1,1997-12-08,0,1,"car",10
"16","Sun","December 14","L","","7-8",TRUE,"Green Bay Packers",10,31,9,172,32,140,1,26,458,240,218,1,1997-12-14,0,0,"car",-21
"17","Sat","December 20","L","","7-9",TRUE,"St. Louis Rams",18,30,21,327,233,94,3,23,297,149,148,0,1997-12-20,-3,0,"car",-12
"1","Sun","September 6","L","","0-1",TRUE,"Atlanta Falcons",14,19,16,317,263,54,2,19,323,230,93,1,1998-09-06,-1,0,"car",-5
"2","Sun","September 13","L","","0-2",FALSE,"New Orleans Saints",14,19,20,375,238,137,3,18,311,104,207,0,1998-09-13,-3,0,"car",-5
"4","Sun","September 27","L","","0-3",TRUE,"Green Bay Packers",30,37,13,230,170,60,1,26,487,378,109,4,1998-09-27,3,0,"car",-7
"5","Sun","October 4","L","","0-4",FALSE,"Atlanta Falcons",23,51,16,346,289,57,6,18,323,193,130,2,1998-10-04,-4,0,"car",-28
"6","Sun","October 11","L","","0-5",FALSE,"Dallas Cowboys",20,27,16,304,267,37,3,22,428,277,151,2,1998-10-11,-1,0,"car",-7
"7","Sun","October 18","L","","0-6",FALSE,"Tampa Bay Buccaneers",13,16,17,290,223,67,0,21,349,213,136,2,1998-10-18,2,0,"car",-3
"8","Sun","October 25","L","","0-7",TRUE,"Buffalo Bills",14,30,21,360,279,81,3,18,426,282,144,1,1998-10-25,-2,0,"car",-16
"9","Sun","November 1","W","","1-7",TRUE,"New Orleans Saints",31,17,16,216,110,106,2,21,354,301,53,4,1998-11-01,2,1,"car",14
"10","Sun","November 8","L","","1-8",FALSE,"San Francisco 49ers",23,25,16,287,237,50,2,22,366,261,105,6,1998-11-08,4,0,"car",-2
"11","Sun","November 15","L","","1-9",TRUE,"Miami Dolphins",9,13,12,210,148,62,2,15,315,131,184,1,1998-11-15,-1,0,"car",-4
"12","Sun","November 22","W","","2-9",FALSE,"St. Louis Rams",24,20,17,257,184,73,1,17,281,239,42,2,1998-11-22,1,1,"car",4
"13","Sun","November 29","L","","2-10",FALSE,"New York Jets",21,48,15,216,134,82,1,21,456,255,201,0,1998-11-29,-1,0,"car",-27
"14","Sun","December 6","L","OT","2-11",TRUE,"San Francisco 49ers",28,31,22,429,226,203,3,22,474,238,236,2,1998-12-06,-1,0,"car",-3
"15","Sun","December 13","L","","2-12",TRUE,"Washington Redskins",25,28,16,365,241,124,3,27,409,249,160,0,1998-12-13,-3,0,"car",-3
"16","Sun","December 20","W","","3-12",TRUE,"St. Louis Rams",20,13,11,246,164,82,1,16,261,151,110,4,1998-12-20,3,1,"car",7
"17","Sun","December 27","W","","4-12",FALSE,"Indianapolis Colts",27,19,17,332,149,183,2,12,279,207,72,2,1998-12-27,0,1,"car",8
"1","Sun","September 12","L","","0-1",FALSE,"New Orleans Saints",10,19,12,246,161,85,3,13,255,108,147,0,1999-09-12,-3,0,"car",-9
"2","Sun","September 19","L","","0-2",TRUE,"Jacksonville Jaguars",20,22,16,283,196,87,1,27,414,200,214,1,1999-09-19,0,0,"car",-2
"3","Sun","September 26","W","","1-2",TRUE,"Cincinnati Bengals",27,3,13,343,197,146,2,20,372,243,129,1,1999-09-26,-1,1,"car",24
"4","Sun","October 3","L","","1-3",FALSE,"Washington Redskins",36,38,23,483,328,155,1,22,418,308,110,1,1999-10-03,0,0,"car",-2
"6","Sun","October 17","W","","2-3",FALSE,"San Francisco 49ers",31,29,18,383,282,101,4,23,333,209,124,3,1999-10-17,-1,1,"car",2
"7","Sun","October 24","L","","2-4",TRUE,"Detroit Lions",9,24,22,320,259,61,2,20,300,210,90,2,1999-10-24,0,0,"car",-15
"8","Sun","October 31","L","","2-5",FALSE,"Atlanta Falcons",20,27,19,290,227,63,5,20,283,176,107,0,1999-10-31,-5,0,"car",-7
"9","Sun","November 7","W","","3-5",TRUE,"Philadelphia Eagles",33,7,24,381,270,111,0,17,249,81,168,5,1999-11-07,5,1,"car",26
"10","Sun","November 14","L","","3-6",FALSE,"St. Louis Rams",10,35,18,377,260,117,3,16,363,284,79,2,1999-11-14,-1,0,"car",-25
"11","Sun","November 21","W","","4-6",FALSE,"Cleveland Browns",31,17,22,330,201,129,1,22,306,257,49,2,1999-11-21,1,1,"car",14
"12","Sun","November 28","W","","5-6",TRUE,"Atlanta Falcons",34,28,25,380,254,126,1,22,343,279,64,1,1999-11-28,0,1,"car",6
"13","Sun","December 5","L","","5-7",TRUE,"St. Louis Rams",21,34,14,307,252,55,3,22,480,358,122,3,1999-12-05,0,0,"car",-13
"14","Sun","December 12","W","","6-7",FALSE,"Green Bay Packers",33,31,21,381,368,13,4,26,362,283,79,2,1999-12-12,-2,1,"car",2
"15","Sat","December 18","W","","7-7",TRUE,"San Francisco 49ers",41,24,25,452,362,90,0,18,397,297,100,1,1999-12-18,1,1,"car",17
"16","Sun","December 26","L","","7-8",FALSE,"Pittsburgh Steelers",20,30,17,375,256,119,3,21,293,82,211,1,1999-12-26,-2,0,"car",-10
"17","Sun","January 2","W","","8-8",TRUE,"New Orleans Saints",45,13,18,355,288,67,1,22,335,230,105,4,2000-01-02,3,1,"car",32
"1","Sun","September 3","L","","0-1",FALSE,"Washington Redskins",17,20,12,236,124,112,1,23,396,234,162,0,2000-09-03,-1,0,"car",-3
"2","Sun","September 10","W","","1-1",FALSE,"San Francisco 49ers",38,22,27,450,352,98,1,21,391,301,90,2,2000-09-10,1,1,"car",16
"3","Sun","September 17","L","","1-2",TRUE,"Atlanta Falcons",10,15,17,284,225,59,4,10,262,154,108,2,2000-09-17,-2,0,"car",-5
"5","Sun","October 1","L","OT","1-3",TRUE,"Dallas Cowboys",13,16,13,272,153,119,2,20,291,118,173,2,2000-10-01,0,0,"car",-3
"6","Sun","October 8","W","","2-3",TRUE,"Seattle Seahawks",26,3,26,447,322,125,1,10,209,146,63,0,2000-10-08,-1,1,"car",23
"7","Sun","October 15","L","","2-4",FALSE,"New Orleans Saints",6,24,8,141,131,10,2,21,397,182,215,3,2000-10-15,1,0,"car",-18
"8","Sun","October 22","W","","3-4",TRUE,"San Francisco 49ers",34,16,26,390,292,98,0,20,411,283,128,2,2000-10-22,2,1,"car",18
"9","Sun","October 29","L","","3-5",FALSE,"Atlanta Falcons",12,13,16,209,179,30,4,16,281,184,97,3,2000-10-29,-1,0,"car",-1
"10","Sun","November 5","W","","4-5",FALSE,"St. Louis Rams",27,24,18,268,178,90,2,20,426,395,31,2,2000-11-05,0,1,"car",3
"11","Sun","November 12","L","","4-6",TRUE,"New Orleans Saints",10,20,21,311,258,53,5,16,322,165,157,2,2000-11-12,-3,0,"car",-10
"12","Sun","November 19","L","","4-7",FALSE,"Minnesota Vikings",17,31,23,330,252,78,3,19,446,329,117,2,2000-11-19,-1,0,"car",-14
"13","Mon","November 27","W","","5-7",TRUE,"Green Bay Packers",31,14,24,356,223,133,2,20,326,239,87,5,2000-11-27,3,1,"car",17
"14","Sun","December 3","W","","6-7",TRUE,"St. Louis Rams",16,3,20,237,169,68,2,15,278,179,99,7,2000-12-03,5,1,"car",13
"15","Sun","December 10","L","","6-8",FALSE,"Kansas City Chiefs",14,15,21,257,234,23,1,26,453,315,138,4,2000-12-10,3,0,"car",-1
"16","Sun","December 17","W","","7-8",TRUE,"San Diego Chargers",30,22,13,169,158,11,1,19,358,258,100,2,2000-12-17,1,1,"car",8
"17","Sun","December 24","L","","7-9",FALSE,"Oakland Raiders",9,52,19,297,218,79,4,28,409,230,179,0,2000-12-24,-4,0,"car",-43
"1","Sun","September 9","W","","1-0",FALSE,"Minnesota Vikings",24,13,15,291,200,91,2,19,343,234,109,5,2001-09-09,3,1,"car",11
"2","Sun","September 23","L","","1-1",FALSE,"Atlanta Falcons",16,24,18,359,270,89,1,16,377,256,121,2,2001-09-23,1,0,"car",-8
"3","Sun","September 30","L","","1-2",TRUE,"Green Bay Packers",7,28,9,169,133,36,3,22,383,308,75,2,2001-09-30,-1,0,"car",-21
"4","Sun","October 7","L","","1-3",FALSE,"San Francisco 49ers",14,24,17,336,275,61,3,21,353,203,150,1,2001-10-07,-2,0,"car",-10
"5","Sun","October 14","L","","1-4",TRUE,"New Orleans Saints",25,27,13,218,184,34,3,21,358,160,198,3,2001-10-14,0,0,"car",-2
"6","Sun","October 21","L","OT","1-5",FALSE,"Washington Redskins",14,17,19,342,218,124,4,16,443,345,98,2,2001-10-21,-2,0,"car",-3
"7","Sun","October 28","L","","1-6",TRUE,"New York Jets",12,13,7,162,70,92,1,17,358,172,186,4,2001-10-28,3,0,"car",-1
"8","Sun","November 4","L","","1-7",FALSE,"Miami Dolphins",6,23,12,281,178,103,1,17,337,278,59,1,2001-11-04,0,0,"car",-17
"9","Sun","November 11","L","","1-8",FALSE,"St. Louis Rams",14,48,8,146,115,31,3,20,493,156,337,4,2001-11-11,1,0,"car",-34
"10","Sun","November 18","L","OT","1-9",TRUE,"San Francisco 49ers",22,25,14,280,177,103,0,26,417,296,121,3,2001-11-18,3,0,"car",-3
"11","Sun","November 25","L","","1-10",TRUE,"Atlanta Falcons",7,10,14,247,151,96,2,13,239,94,145,0,2001-11-25,-2,0,"car",-3
"12","Sun","December 2","L","","1-11",FALSE,"New Orleans Saints",23,27,11,150,101,49,1,25,432,307,125,2,2001-12-02,1,0,"car",-4
"13","Sun","December 9","L","","1-12",FALSE,"Buffalo Bills",24,25,17,231,153,78,2,18,369,267,102,1,2001-12-09,-1,0,"car",-1
"15","Sun","December 23","L","","1-13",TRUE,"St. Louis Rams",32,38,24,402,305,97,1,21,412,197,215,3,2001-12-23,2,0,"car",-6
"16","Sun","December 30","L","","1-14",TRUE,"Arizona Cardinals",7,30,20,318,223,95,2,16,331,173,158,0,2001-12-30,-2,0,"car",-23
"17","Sun","January 6","L","","1-15",TRUE,"New England Patriots",6,38,18,322,129,193,6,16,298,196,102,3,2002-01-06,-3,0,"car",-32
"1","Sun","September 8","W","","1-0",TRUE,"Baltimore Ravens",10,7,15,265,120,145,0,15,289,212,77,1,2002-09-08,1,1,"car",3
"2","Sun","September 15","W","","2-0",TRUE,"Detroit Lions",31,7,20,385,310,75,0,12,122,49,73,3,2002-09-15,3,1,"car",24
"3","Sun","September 22","W","","3-0",FALSE,"Minnesota Vikings",21,14,20,370,206,164,2,13,250,177,73,5,2002-09-22,3,1,"car",7
"4","Sun","September 29","L","","3-1",FALSE,"Green Bay Packers",14,17,18,332,193,139,3,17,298,199,99,1,2002-09-29,-2,0,"car",-3
"5","Sun","October 6","L","","3-2",TRUE,"Arizona Cardinals",13,16,12,244,186,58,4,18,312,221,91,1,2002-10-06,-3,0,"car",-3
"6","Sun","October 13","L","","3-3",FALSE,"Dallas Cowboys",13,14,14,308,198,110,0,17,311,174,137,2,2002-10-13,2,0,"car",-1
"7","Sun","October 20","L","","3-4",FALSE,"Atlanta Falcons",0,30,12,205,104,101,1,25,393,206,187,0,2002-10-20,-1,0,"car",-30
"8","Sun","October 27","L","","3-5",TRUE,"Tampa Bay Buccaneers",9,12,9,130,20,110,4,14,226,155,71,2,2002-10-27,-2,0,"car",-3
"10","Sun","November 10","L","","3-6",TRUE,"New Orleans Saints",24,34,21,396,296,100,2,17,345,248,97,0,2002-11-10,-2,0,"car",-10
"11","Sun","November 17","L","","3-7",FALSE,"Tampa Bay Buccaneers",10,23,14,231,168,63,4,19,314,247,67,2,2002-11-17,-2,0,"car",-13
"12","Sun","November 24","L","","3-8",TRUE,"Atlanta Falcons",0,41,10,122,51,71,6,25,426,277,149,1,2002-11-24,-5,0,"car",-41
"13","Sun","December 1","W","","4-8",FALSE,"Cleveland Browns",13,6,11,234,89,145,2,14,258,118,140,5,2002-12-01,3,1,"car",7
"14","Sun","December 8","W","","5-8",TRUE,"Cincinnati Bengals",52,31,23,401,319,82,3,25,340,257,83,1,2002-12-08,-2,1,"car",21
"15","Sun","December 15","L","","5-9",FALSE,"Pittsburgh Steelers",14,30,11,131,81,50,4,19,332,203,129,2,2002-12-15,-2,0,"car",-16
"16","Sun","December 22","W","","6-9",TRUE,"Chicago Bears",24,14,15,253,165,88,2,8,186,131,55,4,2002-12-22,2,1,"car",10
"17","Sun","December 29","W","","7-9",FALSE,"New Orleans Saints",10,6,13,273,188,85,3,13,244,119,125,3,2002-12-29,0,1,"car",4
"1","Sun","September 7","W","","1-0",TRUE,"Jacksonville Jaguars",24,23,17,242,120,122,2,17,331,256,75,1,2003-09-07,-1,1,"car",1
"2","Sun","September 14","W","OT","2-0",FALSE,"Tampa Bay Buccaneers",12,9,14,258,87,171,2,25,397,337,60,1,2003-09-14,-1,1,"car",3
"4","Sun","September 28","W","","3-0",TRUE,"Atlanta Falcons",23,3,19,361,168,193,1,11,267,123,144,1,2003-09-28,0,1,"car",20
"5","Sun","October 5","W","","4-0",TRUE,"New Orleans Saints",19,13,21,309,124,185,1,17,344,189,155,1,2003-10-05,0,1,"car",6
"6","Sun","October 12","W","OT","5-0",FALSE,"Indianapolis Colts",23,20,17,341,152,189,2,20,369,293,76,3,2003-10-12,1,1,"car",3
"7","Sun","October 19","L","","5-1",TRUE,"Tennessee Titans",17,37,19,383,339,44,4,15,348,214,134,0,2003-10-19,-4,0,"car",-20
"8","Sun","October 26","W","OT","6-1",FALSE,"New Orleans Saints",23,20,20,368,145,223,0,19,294,190,104,3,2003-10-26,3,1,"car",3
"9","Sun","November 2","L","","6-2",FALSE,"Houston Texans",10,14,21,367,193,174,1,14,267,149,118,0,2003-11-02,-1,0,"car",-4
"10","Sun","November 9","W","","7-2",TRUE,"Tampa Bay Buccaneers",27,24,18,341,263,78,2,18,347,258,89,1,2003-11-09,-1,1,"car",3
"11","Sun","November 16","W","","8-2",TRUE,"Washington Redskins",20,17,17,427,317,110,4,13,181,127,54,2,2003-11-16,-2,1,"car",3
"12","Sun","November 23","L","","8-3",FALSE,"Dallas Cowboys",20,24,15,244,169,75,2,19,319,254,65,1,2003-11-23,-1,0,"car",-4
"13","Sun","November 30","L","","8-4",TRUE,"Philadelphia Eagles",16,25,19,336,200,136,1,17,283,159,124,2,2003-11-30,1,0,"car",-9
"14","Sun","December 7","L","OT","8-5",FALSE,"Atlanta Falcons",14,20,13,231,141,90,3,24,380,156,224,2,2003-12-07,-1,0,"car",-6
"15","Sun","December 14","W","","9-5",FALSE,"Arizona Cardinals",20,17,17,298,231,67,2,23,317,146,171,2,2003-12-14,0,1,"car",3
"16","Sun","December 21","W","","10-5",TRUE,"Detroit Lions",20,14,22,384,260,124,2,8,106,53,53,1,2003-12-21,-1,1,"car",6
"17","Sun","December 28","W","","11-5",FALSE,"New York Giants",37,24,15,251,141,110,2,14,175,99,76,5,2003-12-28,3,1,"car",13
"WildCard","Sat","January 3","W","","12-5",TRUE,"Dallas Cowboys",29,10,16,380,273,107,0,10,204,132,72,2,2004-01-03,2,1,"car",19
"Division","Sat","January 10","W","OT","13-5",FALSE,"St. Louis Rams",29,23,24,485,269,216,1,23,380,316,64,3,2004-01-10,2,1,"car",6
"ConfChamp","Sun","January 18","W","","14-5",FALSE,"Philadelphia Eagles",14,3,14,256,101,155,0,18,289,152,137,4,2004-01-18,4,1,"car",11
"SuperBowl","Sun","February 1","L","","14-6",TRUE,"New England Patriots",29,32,17,387,295,92,1,29,481,354,127,1,2004-02-01,0,0,"car",-3
"1","Mon","September 13","L","","0-1",TRUE,"Green Bay Packers",14,24,17,300,262,38,2,22,279,127,152,0,2004-09-13,-2,0,"car",-10
"2","Sun","September 19","W","","1-1",FALSE,"Kansas City Chiefs",28,17,23,358,175,183,2,17,281,172,109,2,2004-09-19,0,1,"car",11
"4","Sun","October 3","L","","1-2",TRUE,"Atlanta Falcons",10,27,19,360,293,67,3,20,313,148,165,0,2004-10-03,-3,0,"car",-17
"5","Sun","October 10","L","","1-3",FALSE,"Denver Broncos",17,20,12,227,163,64,0,23,434,224,210,2,2004-10-10,2,0,"car",-3
"6","Sun","October 17","L","","1-4",FALSE,"Philadelphia Eagles",8,30,21,344,186,158,4,10,283,202,81,1,2004-10-17,-3,0,"car",-22
"7","Sun","October 24","L","","1-5",TRUE,"San Diego Chargers",6,17,20,263,147,116,1,19,302,188,114,1,2004-10-24,0,0,"car",-11
"8","Sun","October 31","L","","1-6",FALSE,"Seattle Seahawks",17,23,16,342,248,94,1,24,433,196,237,2,2004-10-31,1,0,"car",-6
"9","Sun","November 7","L","","1-7",TRUE,"Oakland Raiders",24,27,24,304,267,37,0,21,297,228,69,1,2004-11-07,1,0,"car",-3
"10","Sun","November 14","W","","2-7",FALSE,"San Francisco 49ers",37,27,17,358,301,57,2,23,357,247,110,5,2004-11-14,3,1,"car",10
"11","Sun","November 21","W","","3-7",TRUE,"Arizona Cardinals",35,10,16,317,160,157,1,23,399,314,85,4,2004-11-21,3,1,"car",25
"12","Sun","November 28","W","","4-7",TRUE,"Tampa Bay Buccaneers",21,14,15,300,188,112,1,20,398,336,62,3,2004-11-28,2,1,"car",7
"13","Sun","December 5","W","","5-7",FALSE,"New Orleans Saints",32,21,25,401,269,132,0,15,280,250,30,3,2004-12-05,3,1,"car",11
"14","Sun","December 12","W","","6-7",TRUE,"St. Louis Rams",20,7,18,308,189,119,2,11,292,226,66,7,2004-12-12,5,1,"car",13
"15","Sat","December 18","L","OT","6-8",FALSE,"Atlanta Falcons",31,34,22,375,314,61,4,22,329,125,204,4,2004-12-18,0,0,"car",-3
"16","Sun","December 26","W","","7-8",FALSE,"Tampa Bay Buccaneers",37,20,22,348,207,141,0,22,345,299,46,3,2004-12-26,3,1,"car",17
"17","Sun","January 2","L","","7-9",TRUE,"New Orleans Saints",18,21,21,320,274,46,3,15,360,196,164,0,2005-01-02,-3,0,"car",-3
"1","Sun","September 11","L","","0-1",TRUE,"New Orleans Saints",20,23,20,350,209,141,4,21,291,190,101,2,2005-09-11,-2,0,"car",-3
"2","Sun","September 18","W","","1-1",TRUE,"New England Patriots",27,17,17,250,146,104,1,14,288,249,39,3,2005-09-18,2,1,"car",10
"3","Sun","September 25","L","","1-2",FALSE,"Miami Dolphins",24,27,23,299,238,61,3,16,315,171,144,1,2005-09-25,-2,0,"car",-3
"4","Mon","October 3","W","","2-2",TRUE,"Green Bay Packers",32,29,17,286,196,90,1,22,352,294,58,2,2005-10-03,1,1,"car",3
"5","Sun","October 9","W","","3-2",FALSE,"Arizona Cardinals",24,20,15,330,243,87,2,19,468,396,72,4,2005-10-09,2,1,"car",4
"6","Sun","October 16","W","","4-2",FALSE,"Detroit Lions",21,20,14,317,263,54,4,11,209,157,52,4,2005-10-16,0,1,"car",1
"8","Sun","October 30","W","","5-2",TRUE,"Minnesota Vikings",38,13,27,449,338,111,0,14,253,171,82,0,2005-10-30,0,1,"car",25
"9","Sun","November 6","W","","6-2",FALSE,"Tampa Bay Buccaneers",34,14,15,287,210,77,0,18,270,226,44,4,2005-11-06,4,1,"car",20
"10","Sun","November 13","W","","7-2",TRUE,"New York Jets",30,3,15,220,119,101,2,15,214,77,137,6,2005-11-13,4,1,"car",27
"11","Sun","November 20","L","","7-3",FALSE,"Chicago Bears",3,13,13,238,183,55,2,15,258,136,122,1,2005-11-20,-1,0,"car",-10
"12","Sun","November 27","W","","8-3",FALSE,"Buffalo Bills",13,9,19,295,182,113,1,14,216,161,55,1,2005-11-27,0,1,"car",4
"13","Sun","December 4","W","","9-3",TRUE,"Atlanta Falcons",24,6,14,306,164,142,1,14,259,148,111,2,2005-12-04,1,1,"car",18
"14","Sun","December 11","L","","9-4",TRUE,"Tampa Bay Buccaneers",10,20,14,276,194,82,1,17,247,133,114,0,2005-12-11,-1,0,"car",-10
"15","Sun","December 18","W","","10-4",FALSE,"New Orleans Saints",27,10,19,326,165,161,2,15,277,183,94,6,2005-12-18,4,1,"car",17
"16","Sat","December 24","L","","10-5",TRUE,"Dallas Cowboys",20,24,13,318,247,71,2,22,394,180,214,2,2005-12-24,0,0,"car",-4
"17","Sun","January 1","W","","11-5",FALSE,"Atlanta Falcons",44,11,23,403,174,229,0,15,211,185,26,4,2006-01-01,4,1,"car",33
"WildCard","Sun","January 8","W","","12-5",FALSE,"New York Giants",23,0,23,335,112,223,0,9,132,91,41,5,2006-01-08,5,1,"car",23
"Division","Sun","January 15","W","","13-5",FALSE,"Chicago Bears",29,21,21,434,311,123,1,23,282,185,97,1,2006-01-15,0,1,"car",8
"ConfChamp","Sun","January 22","L","","13-6",FALSE,"Seattle Seahawks",14,34,11,212,176,36,4,27,393,203,190,0,2006-01-22,-4,0,"car",-20
"1","Sun","September 10","L","","0-1",TRUE,"Atlanta Falcons",6,20,15,215,150,65,2,24,385,133,252,0,2006-09-10,-2,0,"car",-14
"2","Sun","September 17","L","OT","0-2",FALSE,"Minnesota Vikings",13,16,14,271,164,107,1,17,365,225,140,1,2006-09-17,0,0,"car",-3
"3","Sun","September 24","W","","1-2",FALSE,"Tampa Bay Buccaneers",26,24,22,350,249,101,3,13,209,145,64,2,2006-09-24,-1,1,"car",2
"4","Sun","October 1","W","","2-2",TRUE,"New Orleans Saints",21,18,20,324,157,167,0,22,407,344,63,1,2006-10-01,1,1,"car",3
"5","Sun","October 8","W","","3-2",TRUE,"Cleveland Browns",20,12,15,288,169,119,0,17,248,157,91,3,2006-10-08,3,1,"car",8
"6","Sun","October 15","W","","4-2",FALSE,"Baltimore Ravens",23,21,20,414,356,58,3,16,292,212,80,3,2006-10-15,0,1,"car",2
"7","Sun","October 22","L","","4-3",FALSE,"Cincinnati Bengals",14,17,17,277,217,60,1,22,342,230,112,0,2006-10-22,-1,0,"car",-3
"8","Sun","October 29","L","","4-4",TRUE,"Dallas Cowboys",14,35,16,204,128,76,3,27,414,258,156,1,2006-10-29,-2,0,"car",-21
"10","Mon","November 13","W","","5-4",TRUE,"Tampa Bay Buccaneers",24,10,17,318,240,78,2,13,222,153,69,4,2006-11-13,2,1,"car",14
"11","Sun","November 19","W","","6-4",TRUE,"St. Louis Rams",15,0,20,411,169,242,3,8,111,80,31,2,2006-11-19,-1,1,"car",15
"12","Sun","November 26","L","","6-5",FALSE,"Washington Redskins",13,17,15,264,163,101,2,14,253,110,143,1,2006-11-26,-1,0,"car",-4
"13","Mon","December 4","L","","6-6",FALSE,"Philadelphia Eagles",24,27,18,377,269,108,2,18,402,304,98,0,2006-12-04,-2,0,"car",-3
"14","Sun","December 10","L","","6-7",TRUE,"New York Giants",13,27,22,463,418,45,3,15,307,172,135,0,2006-12-10,-3,0,"car",-14
"15","Sun","December 17","L","","6-8",TRUE,"Pittsburgh Steelers",3,37,12,240,197,43,2,20,306,147,159,0,2006-12-17,-2,0,"car",-34
"16","Sun","December 24","W","","7-8",FALSE,"Atlanta Falcons",10,3,15,194,11,183,0,8,177,94,83,2,2006-12-24,2,1,"car",7
"17","Sun","December 31","W","","8-8",FALSE,"New Orleans Saints",31,21,20,313,207,106,0,13,297,236,61,2,2006-12-31,2,1,"car",10
"1","Sun","September 9","W","","1-0",FALSE,"St. Louis Rams",27,13,21,385,199,186,2,16,238,162,76,2,2007-09-09,0,1,"car",14
"2","Sun","September 16","L","","1-1",TRUE,"Houston Texans",21,34,17,353,287,66,3,19,346,227,119,1,2007-09-16,-2,0,"car",-13
"3","Sun","September 23","W","","2-1",FALSE,"Atlanta Falcons",27,20,24,313,138,175,0,21,442,351,91,2,2007-09-23,2,1,"car",7
"4","Sun","September 30","L","","2-2",TRUE,"Tampa Bay Buccaneers",7,20,13,236,137,99,2,22,365,176,189,1,2007-09-30,-1,0,"car",-13
"5","Sun","October 7","W","","3-2",FALSE,"New Orleans Saints",16,13,12,243,155,88,1,23,341,252,89,2,2007-10-07,1,1,"car",3
"6","Sun","October 14","W","","4-2",FALSE,"Arizona Cardinals",25,10,14,374,193,181,0,10,255,159,96,5,2007-10-14,5,1,"car",15
"8","Sun","October 28","L","","4-3",TRUE,"Indianapolis Colts",7,31,20,293,185,108,3,23,395,264,131,1,2007-10-28,-2,0,"car",-24
"9","Sun","November 4","L","","4-4",FALSE,"Tennessee Titans",7,20,15,191,113,78,2,20,236,96,140,4,2007-11-04,2,0,"car",-13
"10","Sun","November 11","L","","4-5",TRUE,"Atlanta Falcons",13,20,10,235,145,90,2,12,277,189,88,1,2007-11-11,-1,0,"car",-7
"11","Sun","November 18","L","","4-6",FALSE,"Green Bay Packers",17,31,21,382,251,131,3,18,317,214,103,0,2007-11-18,-3,0,"car",-14
"12","Sun","November 25","L","","4-7",TRUE,"New Orleans Saints",6,31,11,195,152,43,4,22,373,260,113,1,2007-11-25,-3,0,"car",-25
"13","Sun","December 2","W","","5-7",TRUE,"San Francisco 49ers",31,14,20,323,157,166,2,12,195,136,59,6,2007-12-02,4,1,"car",17
"14","Sun","December 9","L","","5-8",FALSE,"Jacksonville Jaguars",6,37,10,149,99,50,2,24,427,249,178,1,2007-12-09,-1,0,"car",-31
"15","Sun","December 16","W","","6-8",TRUE,"Seattle Seahawks",13,10,15,322,208,114,0,18,282,238,44,1,2007-12-16,1,1,"car",3
"16","Sat","December 22","L","","6-9",TRUE,"Dallas Cowboys",13,20,12,216,147,69,1,25,405,257,148,1,2007-12-22,0,0,"car",-7
"17","Sun","December 30","W","","7-9",FALSE,"Tampa Bay Buccaneers",31,23,20,349,169,180,2,17,303,196,107,1,2007-12-30,-1,1,"car",8
"1","Sun","September 7","W","","1-0",FALSE,"San Diego Chargers",26,24,20,388,246,142,1,17,316,211,105,1,2008-09-07,0,1,"car",2
"2","Sun","September 14","W","","2-0",TRUE,"Chicago Bears",20,17,12,216,102,114,1,12,256,141,115,2,2008-09-14,1,1,"car",3
"3","Sun","September 21","L","","2-1",FALSE,"Minnesota Vikings",10,20,14,204,157,47,2,17,305,186,119,1,2008-09-21,-1,0,"car",-10
"4","Sun","September 28","W","","3-1",TRUE,"Atlanta Falcons",24,9,19,401,294,107,0,17,268,150,118,0,2008-09-28,0,1,"car",15
"5","Sun","October 5","W","","4-1",TRUE,"Kansas City Chiefs",34,0,20,441,236,205,2,8,127,92,35,3,2008-10-05,1,1,"car",34
"6","Sun","October 12","L","","4-2",FALSE,"Tampa Bay Buccaneers",3,27,14,282,242,40,3,17,315,173,142,0,2008-10-12,-3,0,"car",-24
"7","Sun","October 19","W","","5-2",TRUE,"New Orleans Saints",30,7,19,336,193,143,0,17,343,228,115,2,2008-10-19,2,1,"car",23
"8","Sun","October 26","W","","6-2",TRUE,"Arizona Cardinals",27,23,22,351,238,113,1,25,425,375,50,2,2008-10-26,1,1,"car",4
"10","Sun","November 9","W","","7-2",FALSE,"Oakland Raiders",17,6,10,219,57,162,4,17,259,112,147,3,2008-11-09,-1,1,"car",11
"11","Sun","November 16","W","","8-2",TRUE,"Detroit Lions",31,22,16,362,98,264,1,20,316,186,130,4,2008-11-16,3,1,"car",9
"12","Sun","November 23","L","","8-3",FALSE,"Atlanta Falcons",28,45,22,408,274,134,0,21,392,259,133,1,2008-11-23,1,0,"car",-17
"13","Sun","November 30","W","","9-3",FALSE,"Green Bay Packers",35,31,15,298,170,128,1,25,438,293,145,2,2008-11-30,1,1,"car",4
"14","Mon","December 8","W","","10-3",TRUE,"Tampa Bay Buccaneers",38,23,26,464,165,299,2,21,384,298,86,0,2008-12-08,-2,1,"car",15
"15","Sun","December 14","W","","11-3",TRUE,"Denver Broncos",30,10,18,400,253,147,1,15,279,158,121,2,2008-12-14,1,1,"car",20
"16","Sun","December 21","L","OT","11-4",FALSE,"New York Giants",28,34,16,343,185,158,0,25,459,158,301,0,2008-12-21,0,0,"car",-6
"17","Sun","December 28","W","","12-4",FALSE,"New Orleans Saints",33,31,23,478,244,234,0,22,417,367,50,2,2008-12-28,2,1,"car",2
"Division","Sat","January 10","L","","12-5",TRUE,"Arizona Cardinals",13,33,16,269,194,75,6,21,360,215,145,1,2009-01-10,-5,0,"car",-20
"1","Sun","September 13","L","","0-1",TRUE,"Philadelphia Eagles",10,38,14,169,83,86,7,17,267,82,185,2,2009-09-13,-5,0,"car",-28
"2","Sun","September 20","L","","0-2",FALSE,"Atlanta Falcons",20,28,24,440,296,144,2,23,371,220,151,2,2009-09-20,0,0,"car",-8
"3","Mon","September 28","L","","0-3",FALSE,"Dallas Cowboys",7,21,15,271,198,73,3,24,449,237,212,0,2009-09-28,-3,0,"car",-14
"5","Sun","October 11","W","","1-3",TRUE,"Washington Redskins",20,17,16,248,162,86,2,15,198,124,74,1,2009-10-11,-1,1,"car",3
"6","Sun","October 18","W","","2-3",FALSE,"Tampa Bay Buccaneers",28,21,22,322,55,267,3,12,245,121,124,2,2009-10-18,-1,1,"car",7
"7","Sun","October 25","L","","2-4",TRUE,"Buffalo Bills",9,20,20,425,309,116,4,9,167,114,53,0,2009-10-25,-4,0,"car",-11
"8","Sun","November 1","W","","3-4",FALSE,"Arizona Cardinals",34,21,13,355,85,270,0,23,320,226,94,6,2009-11-01,6,1,"car",13
"9","Sun","November 8","L","","3-5",FALSE,"New Orleans Saints",20,30,21,371,189,182,3,18,414,330,84,2,2009-11-08,-1,0,"car",-10
"10","Sun","November 15","W","","4-5",TRUE,"Atlanta Falcons",28,19,19,380,195,185,0,22,400,224,176,2,2009-11-15,2,1,"car",9
"11","Thu","November 19","L","","4-6",TRUE,"Miami Dolphins",17,24,22,383,201,182,1,17,326,172,154,0,2009-11-19,-1,0,"car",-7
"12","Sun","November 29","L","","4-7",FALSE,"New York Jets",6,17,11,179,104,75,4,16,283,144,139,3,2009-11-29,-1,0,"car",-11
"13","Sun","December 6","W","","5-7",TRUE,"Tampa Bay Buccaneers",16,6,15,309,152,157,2,22,469,315,154,5,2009-12-06,3,1,"car",10
"14","Sun","December 13","L","","5-8",FALSE,"New England Patriots",10,20,14,305,179,126,0,26,377,192,185,3,2009-12-13,3,0,"car",-10
"15","Sun","December 20","W","","6-8",TRUE,"Minnesota Vikings",26,7,23,397,273,124,0,10,237,196,41,2,2009-12-20,2,1,"car",19
"16","Sun","December 27","W","","7-8",FALSE,"New York Giants",41,9,25,416,169,247,0,22,317,257,60,4,2009-12-27,4,1,"car",32
"17","Sun","January 3","W","","8-8",TRUE,"New Orleans Saints",23,10,15,327,149,178,0,14,213,102,111,3,2010-01-03,3,1,"car",13
"1","Sun","September 12","L","","0-1",FALSE,"New York Giants",18,31,14,237,148,89,5,21,376,258,118,4,2010-09-12,-1,0,"car",-13
"2","Sun","September 19","L","","0-2",TRUE,"Tampa Bay Buccaneers",7,20,16,278,159,119,3,14,273,178,95,0,2010-09-19,-3,0,"car",-13
"3","Sun","September 26","L","","0-3",TRUE,"Cincinnati Bengals",7,20,17,267,180,87,4,21,305,185,120,2,2010-09-26,-2,0,"car",-13
"4","Sun","October 3","L","","0-4",FALSE,"New Orleans Saints",14,16,10,251,133,118,1,27,383,262,121,2,2010-10-03,1,0,"car",-2
"5","Sun","October 10","L","","0-5",TRUE,"Chicago Bears",6,23,8,147,62,85,3,13,247,29,218,4,2010-10-10,1,0,"car",-17
"7","Sun","October 24","W","","1-5",TRUE,"San Francisco 49ers",23,20,22,379,303,76,3,15,282,183,99,1,2010-10-24,-2,1,"car",3
"8","Sun","October 31","L","","1-6",FALSE,"St. Louis Rams",10,20,14,201,176,25,4,15,246,184,62,0,2010-10-31,-4,0,"car",-10
"9","Sun","November 7","L","","1-7",TRUE,"New Orleans Saints",3,34,15,195,68,127,2,27,408,243,165,1,2010-11-07,-1,0,"car",-31
"10","Sun","November 14","L","","1-8",FALSE,"Tampa Bay Buccaneers",16,31,18,300,182,118,1,21,421,235,186,2,2010-11-14,1,0,"car",-15
"11","Sun","November 21","L","","1-9",TRUE,"Baltimore Ravens",13,37,9,270,150,120,2,22,378,278,100,2,2010-11-21,0,0,"car",-24
"12","Sun","November 28","L","","1-10",FALSE,"Cleveland Browns",23,24,16,326,175,151,1,26,379,227,152,3,2010-11-28,2,0,"car",-1
"13","Sun","December 5","L","","1-11",FALSE,"Seattle Seahawks",14,31,18,283,152,131,1,25,371,210,161,2,2010-12-05,1,0,"car",-17
"14","Sun","December 12","L","","1-12",TRUE,"Atlanta Falcons",10,31,13,288,76,212,2,24,327,200,127,1,2010-12-12,-1,0,"car",-21
"15","Sun","December 19","W","","2-12",TRUE,"Arizona Cardinals",19,12,16,303,126,177,1,11,218,175,43,2,2010-12-19,1,1,"car",7
"16","Thu","December 23","L","","2-13",FALSE,"Pittsburgh Steelers",3,27,7,119,45,74,2,22,408,293,115,2,2010-12-23,0,0,"car",-24
"17","Sun","January 2","L","","2-14",FALSE,"Atlanta Falcons",10,31,12,291,154,137,2,24,352,253,99,1,2011-01-02,-1,0,"car",-21
"1","Sun","September 11","L","","0-1",FALSE,"Arizona Cardinals",21,28,26,477,403,74,1,15,394,295,99,1,2011-09-11,0,0,"car",-7
"2","Sun","September 18","L","","0-2",TRUE,"Green Bay Packers",23,30,26,475,404,71,4,16,419,295,124,1,2011-09-18,-3,0,"car",-7
"3","Sun","September 25","W","","1-2",TRUE,"Jacksonville Jaguars",16,10,16,265,158,107,0,13,257,129,128,1,2011-09-25,1,1,"car",6
"4","Sun","October 2","L","","1-3",FALSE,"Chicago Bears",29,34,24,543,374,169,1,15,317,93,224,1,2011-10-02,0,0,"car",-5
"5","Sun","October 9","L","","1-4",TRUE,"New Orleans Saints",27,30,20,381,219,162,1,27,444,343,101,1,2011-10-09,0,0,"car",-3
"6","Sun","October 16","L","","1-5",FALSE,"Atlanta Falcons",17,31,24,368,229,139,3,24,325,159,166,0,2011-10-16,-3,0,"car",-14
"7","Sun","October 23","W","","2-5",TRUE,"Washington Redskins",33,20,20,407,232,175,0,22,353,261,92,3,2011-10-23,3,1,"car",13
"8","Sun","October 30","L","","2-6",TRUE,"Minnesota Vikings",21,24,21,405,265,140,2,22,361,229,132,1,2011-10-30,-1,0,"car",-3
"10","Sun","November 13","L","","2-7",TRUE,"Tennessee Titans",3,30,16,279,166,113,2,22,383,211,172,1,2011-11-13,-1,0,"car",-27
"11","Sun","November 20","L","","2-8",FALSE,"Detroit Lions",35,49,24,409,272,137,4,29,495,326,169,3,2011-11-20,-1,0,"car",-14
"12","Sun","November 27","W","","3-8",FALSE,"Indianapolis Colts",27,19,22,377,176,201,1,17,323,218,105,2,2011-11-27,1,1,"car",8
"13","Sun","December 4","W","","4-8",FALSE,"Tampa Bay Buccaneers",38,19,26,385,222,163,0,15,285,207,78,1,2011-12-04,1,1,"car",19
"14","Sun","December 11","L","","4-9",TRUE,"Atlanta Falcons",23,31,19,416,259,157,2,18,394,308,86,0,2011-12-11,-2,0,"car",-8
"15","Sun","December 18","W","","5-9",FALSE,"Houston Texans",28,13,20,316,150,166,0,18,358,208,150,3,2011-12-18,3,1,"car",15
"16","Sat","December 24","W","","6-9",TRUE,"Tampa Bay Buccaneers",48,16,20,433,163,270,0,23,317,258,59,4,2011-12-24,4,1,"car",32
"17","Sun","January 1","L","","6-10",FALSE,"New Orleans Saints",17,45,21,301,137,164,2,33,617,409,208,1,2012-01-01,-1,0,"car",-28
"1","Sun","September 8","L","","0-1",FALSE,"Minnesota Vikings",21,28,29,489,272,217,7,15,268,182,86,1,1985-09-08,-6,0,"sfo",-7
"2","Sun","September 15","W","","1-1",TRUE,"Atlanta Falcons",35,16,23,380,184,196,1,18,253,130,123,1,1985-09-15,0,1,"sfo",19
"3","Sun","September 22","W","","2-1",FALSE,"Los Angeles Raiders",34,10,17,352,237,115,2,20,280,197,83,3,1985-09-22,1,1,"sfo",24
"4","Sun","September 29","L","","2-2",TRUE,"New Orleans Saints",17,20,15,231,81,150,3,19,354,179,175,3,1985-09-29,0,0,"sfo",-3
"5","Sun","October 6","W","","3-2",FALSE,"Atlanta Falcons",38,17,30,499,420,79,0,22,386,271,115,2,1985-10-06,2,1,"sfo",21
"6","Sun","October 13","L","","3-3",TRUE,"Chicago Bears",10,26,11,183,116,67,2,22,372,183,189,1,1985-10-13,-1,0,"sfo",-16
"7","Sun","October 20","L","","3-4",FALSE,"Detroit Lions",21,23,21,304,96,208,1,15,292,130,162,1,1985-10-20,0,0,"sfo",-2
"8","Sun","October 27","W","","4-4",FALSE,"Los Angeles Rams",28,14,23,429,290,139,1,25,401,319,82,4,1985-10-27,3,1,"sfo",14
"9","Sun","November 3","W","","5-4",TRUE,"Philadelphia Eagles",24,13,24,364,227,137,3,20,427,366,61,5,1985-11-03,2,1,"sfo",11
"10","Mon","November 11","L","","5-5",FALSE,"Denver Broncos",16,17,16,341,203,138,0,18,336,215,121,1,1985-11-11,1,0,"sfo",-1
"11","Sun","November 17","W","","6-5",TRUE,"Kansas City Chiefs",31,3,24,417,254,163,2,12,200,125,75,1,1985-11-17,-1,1,"sfo",28
"12","Mon","November 25","W","","7-5",TRUE,"Seattle Seahawks",19,6,21,376,230,146,4,15,252,177,75,2,1985-11-25,-2,1,"sfo",13
"13","Sun","December 1","W","","8-5",FALSE,"Washington Redskins",35,8,15,224,117,107,1,21,398,311,87,5,1985-12-01,4,1,"sfo",27
"14","Mon","December 9","L","","8-6",TRUE,"Los Angeles Rams",20,27,22,410,300,110,3,12,264,150,114,1,1985-12-09,-2,0,"sfo",-7
"15","Sun","December 15","W","","9-6",FALSE,"New Orleans Saints",31,19,27,500,349,151,1,14,289,214,75,0,1985-12-15,-1,1,"sfo",12
"16","Sun","December 22","W","","10-6",TRUE,"Dallas Cowboys",31,16,22,421,312,109,3,25,419,359,60,4,1985-12-22,1,1,"sfo",15
"WildCard","Sun","December 29","L","","10-7",FALSE,"New York Giants",3,17,19,362,268,94,2,21,355,181,174,1,1985-12-29,-1,0,"sfo",-14
"1","Sun","September 7","W","","1-0",FALSE,"Tampa Bay Buccaneers",31,7,28,453,345,108,2,17,286,195,91,7,1986-09-07,5,1,"sfo",24
"2","Sun","September 14","L","","1-1",FALSE,"Los Angeles Rams",13,16,13,325,247,78,2,14,192,89,103,0,1986-09-14,-2,0,"sfo",-3
"3","Sun","September 21","W","","2-1",TRUE,"New Orleans Saints",26,17,30,461,325,136,1,10,229,110,119,1,1986-09-21,0,1,"sfo",9
"4","Sun","September 28","W","","3-1",FALSE,"Miami Dolphins",31,16,16,314,168,146,1,24,437,365,72,4,1986-09-28,3,1,"sfo",15
"5","Sun","October 5","W","","4-1",TRUE,"Indianapolis Colts",35,14,16,358,248,110,1,17,323,228,95,5,1986-10-05,4,1,"sfo",21
"6","Sun","October 12","L","OT","4-2",TRUE,"Minnesota Vikings",24,27,21,413,348,65,2,21,351,317,34,3,1986-10-12,1,0,"sfo",-3
"7","Sun","October 19","T","OT","4-2-1",FALSE,"Atlanta Falcons",10,10,17,254,139,115,3,21,356,139,217,5,1986-10-19,2,0,"sfo",0
"8","Sun","October 26","W","","5-2-1",FALSE,"Green Bay Packers",31,17,16,222,130,92,3,29,464,312,152,4,1986-10-26,1,1,"sfo",14
"9","Sun","November 2","L","","5-3-1",FALSE,"New Orleans Saints",10,23,18,349,297,52,4,14,291,137,154,1,1986-11-02,-3,0,"sfo",-13
"10","Sun","November 9","W","","6-3-1",TRUE,"St. Louis Cardinals",43,17,23,460,296,164,1,22,364,269,95,4,1986-11-09,3,1,"sfo",26
"11","Mon","November 17","L","","6-4-1",FALSE,"Washington Redskins",6,14,24,501,418,83,4,20,266,130,136,2,1986-11-17,-2,0,"sfo",-8
"12","Sun","November 23","W","","7-4-1",TRUE,"Atlanta Falcons",20,0,21,365,210,155,0,12,229,154,75,1,1986-11-23,1,1,"sfo",20
"13","Mon","December 1","L","","7-5-1",TRUE,"New York Giants",17,21,26,367,251,116,1,20,397,384,13,3,1986-12-01,2,0,"sfo",-4
"14","Sun","December 7","W","","8-5-1",TRUE,"New York Jets",24,10,27,432,234,198,1,16,199,161,38,3,1986-12-07,2,1,"sfo",14
"15","Sun","December 14","W","","9-5-1",FALSE,"New England Patriots",29,24,23,400,202,198,1,16,267,207,60,3,1986-12-14,2,1,"sfo",5
"16","Fri","December 19","W","","10-5-1",TRUE,"Los Angeles Rams",24,14,27,408,238,170,2,12,229,128,101,3,1986-12-19,1,1,"sfo",10
"Division","Sun","January 4","L","","10-6-1",FALSE,"New York Giants",3,49,9,184,155,29,4,21,366,150,216,0,1987-01-04,-4,0,"sfo",-46
"1","Sun","September 13","L","","0-1",FALSE,"Pittsburgh Steelers",17,30,24,356,309,47,4,21,266,83,183,0,1987-09-13,-4,0,"sfo",-13
"2","Sun","September 20","W","","1-1",FALSE,"Cincinnati Bengals",27,26,16,261,205,56,1,19,292,164,128,1,1987-09-20,0,1,"sfo",1
"3","Mon","October 5","W","","2-1",FALSE,"New York Giants",41,21,28,433,191,242,1,14,231,154,77,4,1987-10-05,3,1,"sfo",20
"4","Sun","October 11","W","","3-1",FALSE,"Atlanta Falcons",25,17,20,361,122,239,1,20,238,188,50,2,1987-10-11,1,1,"sfo",8
"5","Sun","October 18","W","","4-1",TRUE,"St. Louis Cardinals",34,28,28,448,327,121,3,18,324,164,160,3,1987-10-18,0,1,"sfo",6
"6","Sun","October 25","W","","5-1",FALSE,"New Orleans Saints",24,22,23,303,228,75,2,20,379,202,177,2,1987-10-25,0,1,"sfo",2
"7","Sun","November 1","W","","6-1",FALSE,"Los Angeles Rams",31,10,23,435,286,149,1,19,280,218,62,1,1987-11-01,0,1,"sfo",21
"8","Sun","November 8","W","","7-1",TRUE,"Houston Oilers",27,20,33,443,280,163,2,15,269,221,48,4,1987-11-08,2,1,"sfo",7
"9","Sun","November 15","L","","7-2",TRUE,"New Orleans Saints",24,26,20,402,258,144,2,16,261,156,105,1,1987-11-15,-1,0,"sfo",-2
"10","Sun","November 22","W","","8-2",FALSE,"Tampa Bay Buccaneers",24,10,28,432,295,137,1,14,256,196,60,2,1987-11-22,1,1,"sfo",14
"11","Sun","November 29","W","","9-2",TRUE,"Cleveland Browns",38,24,23,455,336,119,2,18,360,268,92,1,1987-11-29,-1,1,"sfo",14
"12","Sun","December 6","W","","10-2",FALSE,"Green Bay Packers",23,12,22,439,296,143,4,18,315,127,188,5,1987-12-06,1,1,"sfo",11
"13","Mon","December 14","W","","11-2",TRUE,"Chicago Bears",41,0,20,331,133,198,1,16,263,154,109,6,1987-12-14,5,1,"sfo",41
"14","Sun","December 20","W","","12-2",TRUE,"Atlanta Falcons",35,7,26,461,206,255,1,13,216,165,51,4,1987-12-20,3,1,"sfo",28
"15","Sun","December 27","W","","13-2",TRUE,"Los Angeles Rams",48,0,23,427,278,149,0,9,145,24,121,2,1987-12-27,2,1,"sfo",48
"Division","Sat","January 9","L","","13-3",TRUE,"Minnesota Vikings",24,36,17,358,243,115,2,22,397,280,117,1,1988-01-09,-1,0,"sfo",-12
"1","Sun","September 4","W","","1-0",FALSE,"New Orleans Saints",34,33,21,289,165,124,2,23,344,197,147,3,1988-09-04,1,1,"sfo",1
"2","Sun","September 11","W","","2-0",FALSE,"New York Giants",20,17,25,430,249,181,2,17,309,197,112,0,1988-09-11,-2,1,"sfo",3
"3","Sun","September 18","L","","2-1",TRUE,"Atlanta Falcons",17,34,22,426,322,104,4,19,367,171,196,2,1988-09-18,-2,0,"sfo",-17
"4","Sun","September 25","W","","3-1",FALSE,"Seattle Seahawks",38,7,27,580,341,239,1,8,154,125,29,5,1988-09-25,4,1,"sfo",31
"5","Sun","October 2","W","","4-1",TRUE,"Detroit Lions",20,13,19,339,163,176,1,18,297,248,49,2,1988-10-02,1,1,"sfo",7
"6","Sun","October 9","L","OT","4-2",TRUE,"Denver Broncos",13,16,21,417,171,246,4,24,314,167,147,3,1988-10-09,-1,0,"sfo",-3
"7","Sun","October 16","W","","5-2",FALSE,"Los Angeles Rams",24,21,24,429,184,245,2,14,236,194,42,4,1988-10-16,2,1,"sfo",3
"8","Mon","October 24","L","","5-3",FALSE,"Chicago Bears",9,10,12,213,135,78,1,14,237,115,122,1,1988-10-24,0,0,"sfo",-1
"9","Sun","October 30","W","","6-3",TRUE,"Minnesota Vikings",24,21,16,339,209,130,2,15,321,229,92,3,1988-10-30,1,1,"sfo",3
"10","Sun","November 6","L","","6-4",FALSE,"Phoenix Cardinals",23,24,22,357,117,240,0,21,355,288,67,3,1988-11-06,3,0,"sfo",-1
"11","Sun","November 13","L","","6-5",TRUE,"Los Angeles Raiders",3,9,15,219,136,83,2,17,251,92,159,1,1988-11-13,-1,0,"sfo",-6
"12","Mon","November 21","W","","7-5",TRUE,"Washington Redskins",37,21,18,320,208,112,2,20,327,271,56,4,1988-11-21,2,1,"sfo",16
"13","Sun","November 27","W","","8-5",FALSE,"San Diego Chargers",48,10,24,475,272,203,0,21,312,176,136,3,1988-11-27,3,1,"sfo",38
"14","Sun","December 4","W","","9-5",FALSE,"Atlanta Falcons",13,3,20,378,238,140,0,8,177,134,43,1,1988-12-04,1,1,"sfo",10
"15","Sun","December 11","W","","10-5",TRUE,"New Orleans Saints",30,17,20,373,221,152,2,15,252,182,70,2,1988-12-11,0,1,"sfo",13
"16","Sun","December 18","L","","10-6",TRUE,"Los Angeles Rams",16,38,20,316,246,70,1,23,322,201,121,1,1988-12-18,0,0,"sfo",-22
"Division","Sun","January 1","W","","11-6",TRUE,"Minnesota Vikings",34,9,20,372,171,201,2,20,262,208,54,3,1989-01-01,1,1,"sfo",25
"ConfChamp","Sun","January 8","W","","12-6",FALSE,"Chicago Bears",28,3,21,406,268,138,1,15,267,176,91,2,1989-01-08,1,1,"sfo",25
"SuperBowl","Sun","January 22","W","","13-6",TRUE,"Cincinnati Bengals",20,16,23,452,341,111,2,13,229,123,106,1,1989-01-22,-1,1,"sfo",4
"1","Sun","September 10","W","","1-0",FALSE,"Indianapolis Colts",30,24,24,404,204,200,0,22,344,190,154,1,1989-09-10,1,1,"sfo",6
"2","Sun","September 17","W","","2-0",FALSE,"Tampa Bay Buccaneers",20,16,22,307,244,63,3,13,217,126,91,3,1989-09-17,0,1,"sfo",4
"3","Sun","September 24","W","","3-0",FALSE,"Philadelphia Eagles",38,28,19,444,385,59,3,22,315,161,154,3,1989-09-24,0,1,"sfo",10
"4","Sun","October 1","L","","3-1",TRUE,"Los Angeles Rams",12,13,22,367,215,152,1,11,287,250,37,0,1989-10-01,-1,0,"sfo",-1
"5","Sun","October 8","W","","4-1",FALSE,"New Orleans Saints",24,20,18,358,282,76,1,18,334,299,35,0,1989-10-08,-1,1,"sfo",4
"6","Sun","October 15","W","","5-1",FALSE,"Dallas Cowboys",31,14,17,318,172,146,1,19,330,270,60,3,1989-10-15,2,1,"sfo",17
"7","Sun","October 22","W","","6-1",TRUE,"New England Patriots",37,20,28,494,353,141,0,19,325,231,94,2,1989-10-22,2,1,"sfo",17
"8","Sun","October 29","W","","7-1",FALSE,"New York Jets",23,10,20,399,240,159,1,19,251,121,130,2,1989-10-29,1,1,"sfo",13
"9","Mon","November 6","W","","8-1",TRUE,"New Orleans Saints",31,13,21,397,302,95,0,16,243,160,83,2,1989-11-06,2,1,"sfo",18
"10","Sun","November 12","W","","9-1",TRUE,"Atlanta Falcons",45,3,30,515,280,235,2,11,192,119,73,1,1989-11-12,-1,1,"sfo",42
"11","Sun","November 19","L","","9-2",TRUE,"Green Bay Packers",17,21,22,360,289,71,4,21,248,139,109,1,1989-11-19,-3,0,"sfo",-4
"12","Mon","November 27","W","","10-2",TRUE,"New York Giants",34,24,24,381,285,96,3,23,342,290,52,5,1989-11-27,2,1,"sfo",10
"13","Sun","December 3","W","","11-2",FALSE,"Atlanta Falcons",23,10,23,425,296,129,1,13,263,226,37,2,1989-12-03,1,1,"sfo",13
"14","Mon","December 11","W","","12-2",FALSE,"Los Angeles Rams",30,27,25,502,439,63,2,24,337,231,106,2,1989-12-11,0,1,"sfo",3
"15","Sun","December 17","W","","13-2",TRUE,"Buffalo Bills",21,10,18,283,132,151,2,17,301,255,46,5,1989-12-17,3,1,"sfo",11
"16","Sun","December 24","W","","14-2",TRUE,"Chicago Bears",26,0,17,314,184,130,1,15,289,167,122,5,1989-12-24,4,1,"sfo",26
"Division","Sat","January 6","W","","15-2",TRUE,"Minnesota Vikings",41,13,22,403,241,162,1,25,385,299,86,5,1990-01-06,4,1,"sfo",28
"ConfChamp","Sun","January 14","W","","16-2",TRUE,"Los Angeles Rams",30,3,29,442,263,179,2,9,156,130,26,3,1990-01-14,1,1,"sfo",27
"SuperBowl","Sun","January 28","W","","17-2",TRUE,"Denver Broncos",55,10,28,461,317,144,0,12,167,103,64,4,1990-01-28,4,1,"sfo",45
"1","Mon","September 10","W","","1-0",FALSE,"New Orleans Saints",13,12,17,237,184,53,2,11,268,180,88,5,1990-09-10,3,1,"sfo",1
"2","Sun","September 16","W","","2-0",TRUE,"Washington Redskins",26,13,22,487,390,97,1,16,328,241,87,0,1990-09-16,-1,1,"sfo",13
"3","Sun","September 23","W","","3-0",TRUE,"Atlanta Falcons",19,13,17,445,379,66,1,18,369,320,49,3,1990-09-23,2,1,"sfo",6
"5","Sun","October 7","W","","4-0",FALSE,"Houston Oilers",24,21,17,383,300,83,2,17,256,170,86,1,1990-10-07,-1,1,"sfo",3
"6","Sun","October 14","W","","5-0",FALSE,"Atlanta Falcons",45,35,30,492,442,50,2,21,394,365,29,2,1990-10-14,0,1,"sfo",10
"7","Sun","October 21","W","","6-0",TRUE,"Pittsburgh Steelers",27,7,22,304,154,150,3,14,200,103,97,2,1990-10-21,-1,1,"sfo",20
"8","Sun","October 28","W","","7-0",TRUE,"Cleveland Browns",20,17,20,294,177,117,2,18,274,236,38,3,1990-10-28,1,1,"sfo",3
"9","Sun","November 4","W","","8-0",FALSE,"Green Bay Packers",24,20,17,445,411,34,0,17,321,251,70,1,1990-11-04,1,1,"sfo",4
"10","Sun","November 11","W","","9-0",FALSE,"Dallas Cowboys",24,6,25,388,281,107,2,9,158,80,78,2,1990-11-11,0,1,"sfo",18
"11","Sun","November 18","W","","10-0",TRUE,"Tampa Bay Buccaneers",31,7,22,393,241,152,1,13,180,78,102,1,1990-11-18,0,1,"sfo",24
"12","Sun","November 25","L","","10-1",TRUE,"Los Angeles Rams",17,28,16,291,225,66,6,19,350,239,111,2,1990-11-25,-4,0,"sfo",-11
"13","Mon","December 3","W","","11-1",TRUE,"New York Giants",7,3,11,240,152,88,0,15,221,146,75,1,1990-12-03,1,1,"sfo",4
"14","Sun","December 9","W","OT","12-1",FALSE,"Cincinnati Bengals",20,17,25,372,170,202,1,14,215,102,113,1,1990-12-09,0,1,"sfo",3
"15","Mon","December 17","W","","13-1",FALSE,"Los Angeles Rams",26,10,21,388,215,173,2,17,266,213,53,4,1990-12-17,2,1,"sfo",16
"16","Sun","December 23","L","","13-2",TRUE,"New Orleans Saints",10,13,20,334,175,159,4,12,194,110,84,2,1990-12-23,-2,0,"sfo",-3
"17","Sun","December 30","W","","14-2",FALSE,"Minnesota Vikings",20,17,22,402,281,121,1,19,279,181,98,1,1990-12-30,0,1,"sfo",3
"Division","Sat","January 12","W","","15-2",TRUE,"Washington Redskins",28,10,20,338,292,46,1,25,441,361,80,3,1991-01-12,2,1,"sfo",18
"ConfChamp","Sun","January 20","L","","15-3",TRUE,"New York Giants",13,15,13,240,201,39,1,20,311,159,152,0,1991-01-20,-1,0,"sfo",-2
"1","Mon","September 2","L","","0-1",FALSE,"New York Giants",14,16,14,258,152,106,2,17,331,201,130,0,1991-09-02,-2,0,"sfo",-2
"2","Sun","September 8","W","","1-1",TRUE,"San Diego Chargers",34,14,24,458,344,114,1,19,326,170,156,4,1991-09-08,3,1,"sfo",20
"3","Sun","September 15","L","","1-2",FALSE,"Minnesota Vikings",14,17,20,355,265,90,2,17,299,179,120,1,1991-09-15,-1,0,"sfo",-3
"4","Sun","September 22","W","","2-2",TRUE,"Los Angeles Rams",27,10,20,422,273,149,1,15,272,208,64,1,1991-09-22,0,1,"sfo",17
"5","Sun","September 29","L","","2-3",FALSE,"Los Angeles Raiders",6,12,17,339,213,126,2,18,220,127,93,1,1991-09-29,-1,0,"sfo",-6
"7","Sun","October 13","L","","2-4",TRUE,"Atlanta Falcons",34,39,24,437,343,94,4,19,368,208,160,0,1991-10-13,-4,0,"sfo",-5
"8","Sun","October 20","W","","3-4",TRUE,"Detroit Lions",35,3,29,505,272,233,1,10,207,183,24,2,1991-10-20,1,1,"sfo",32
"9","Sun","October 27","W","","4-4",FALSE,"Philadelphia Eagles",23,7,14,222,85,137,1,16,235,206,29,5,1991-10-27,4,1,"sfo",16
"10","Sun","November 3","L","","4-5",FALSE,"Atlanta Falcons",14,17,19,396,267,129,3,11,202,127,75,1,1991-11-03,-2,0,"sfo",-3
"11","Sun","November 10","L","","4-6",FALSE,"New Orleans Saints",3,10,15,216,102,114,3,10,191,109,82,1,1991-11-10,-2,0,"sfo",-7
"12","Sun","November 17","W","","5-6",TRUE,"Phoenix Cardinals",14,10,22,257,169,88,1,13,176,112,64,0,1991-11-17,-1,1,"sfo",4
"13","Mon","November 25","W","","6-6",FALSE,"Los Angeles Rams",33,10,23,387,306,81,1,18,320,285,35,2,1991-11-25,1,1,"sfo",23
"14","Sun","December 1","W","","7-6",TRUE,"New Orleans Saints",38,24,22,383,343,40,2,22,415,317,98,3,1991-12-01,1,1,"sfo",14
"15","Sun","December 8","W","","8-6",FALSE,"Seattle Seahawks",24,22,19,329,261,68,5,17,278,128,150,2,1991-12-08,-3,1,"sfo",2
"16","Sat","December 14","W","","9-6",TRUE,"Kansas City Chiefs",28,14,24,408,231,177,1,17,310,173,137,2,1991-12-14,1,1,"sfo",14
"17","Mon","December 23","W","","10-6",TRUE,"Chicago Bears",52,14,30,486,371,115,1,21,404,309,95,3,1991-12-23,2,1,"sfo",38
"1","Sun","September 6","W","","1-0",FALSE,"New York Giants",31,14,27,384,212,172,1,21,315,196,119,2,1992-09-06,1,1,"sfo",17
"2","Sun","September 13","L","","1-1",TRUE,"Buffalo Bills",31,34,26,598,439,159,3,25,488,381,107,3,1992-09-13,0,0,"sfo",-3
"3","Sun","September 20","W","","2-1",FALSE,"New York Jets",31,14,19,335,204,131,2,15,311,245,66,1,1992-09-20,-1,1,"sfo",17
"4","Sun","September 27","W","","3-1",FALSE,"New Orleans Saints",16,10,19,333,179,154,2,19,336,259,77,5,1992-09-27,3,1,"sfo",6
"5","Sun","October 4","W","","4-1",TRUE,"Los Angeles Rams",27,24,20,412,238,174,1,15,347,224,123,2,1992-10-04,1,1,"sfo",3
"6","Sun","October 11","W","","5-1",FALSE,"New England Patriots",24,12,24,411,228,183,3,17,227,157,70,3,1992-10-11,0,1,"sfo",12
"7","Sun","October 18","W","","6-1",TRUE,"Atlanta Falcons",56,17,29,590,399,191,1,18,297,250,47,2,1992-10-18,1,1,"sfo",39
"9","Sun","November 1","L","","6-2",FALSE,"Phoenix Cardinals",14,24,19,330,267,63,4,21,342,197,145,2,1992-11-01,-2,0,"sfo",-10
"10","Mon","November 9","W","","7-2",FALSE,"Atlanta Falcons",41,3,16,303,151,152,0,20,304,245,59,6,1992-11-09,6,1,"sfo",38
"11","Sun","November 15","W","","8-2",TRUE,"New Orleans Saints",21,20,24,367,191,176,1,16,336,293,43,0,1992-11-15,-1,1,"sfo",1
"12","Sun","November 22","W","","9-2",FALSE,"Los Angeles Rams",27,10,21,366,153,213,1,14,245,149,96,0,1992-11-22,-1,1,"sfo",17
"13","Sun","November 29","W","","10-2",TRUE,"Philadelphia Eagles",20,14,18,425,329,96,0,18,280,234,46,0,1992-11-29,0,1,"sfo",6
"14","Sun","December 6","W","","11-2",TRUE,"Miami Dolphins",27,3,20,356,220,136,1,15,239,199,40,1,1992-12-06,0,1,"sfo",24
"15","Sun","December 13","W","","12-2",FALSE,"Minnesota Vikings",20,17,21,287,152,135,1,10,185,71,114,1,1992-12-13,0,1,"sfo",3
"16","Sat","December 19","W","","13-2",TRUE,"Tampa Bay Buccaneers",21,14,19,337,255,82,1,18,308,181,127,0,1992-12-19,-1,1,"sfo",7
"17","Mon","December 28","W","","14-2",TRUE,"Detroit Lions",24,6,22,361,263,98,0,15,227,88,139,1,1992-12-28,1,1,"sfo",18
"Division","Sat","January 9","W","","15-2",TRUE,"Washington Redskins",20,13,22,401,214,187,4,20,323,250,73,4,1993-01-09,0,1,"sfo",7
"ConfChamp","Sun","January 17","L","","15-3",TRUE,"Dallas Cowboys",20,30,24,415,301,114,4,24,416,295,121,0,1993-01-17,-4,0,"sfo",-10
"1","Sun","September 5","W","","1-0",FALSE,"Pittsburgh Steelers",24,13,21,326,240,86,3,12,211,109,102,3,1993-09-05,0,1,"sfo",11
"2","Mon","September 13","L","","1-1",FALSE,"Cleveland Browns",13,23,22,396,266,130,4,18,304,176,128,0,1993-09-13,-4,0,"sfo",-10
"3","Sun","September 19","W","","2-1",TRUE,"Atlanta Falcons",37,30,23,478,210,268,2,24,381,187,194,1,1993-09-19,-1,1,"sfo",7
"4","Sun","September 26","L","","2-2",FALSE,"New Orleans Saints",13,16,19,339,163,176,2,17,264,161,103,0,1993-09-26,-2,0,"sfo",-3
"5","Sun","October 3","W","","3-2",TRUE,"Minnesota Vikings",38,19,17,254,204,50,1,15,271,219,52,1,1993-10-03,0,1,"sfo",19
"7","Sun","October 17","L","","3-3",FALSE,"Dallas Cowboys",17,26,25,405,249,156,2,24,353,230,123,1,1993-10-17,-1,0,"sfo",-9
"8","Sun","October 24","W","","4-3",TRUE,"Phoenix Cardinals",28,14,26,428,280,148,1,25,429,322,107,3,1993-10-24,2,1,"sfo",14
"9","Sun","October 31","W","","5-3",TRUE,"Los Angeles Rams",40,17,24,374,245,129,1,16,220,110,110,3,1993-10-31,2,1,"sfo",23
"11","Sun","November 14","W","","6-3",FALSE,"Tampa Bay Buccaneers",45,21,27,448,324,124,0,18,322,228,94,4,1993-11-14,4,1,"sfo",24
"12","Mon","November 22","W","","7-3",TRUE,"New Orleans Saints",42,7,25,455,236,219,1,17,261,142,119,4,1993-11-22,3,1,"sfo",35
"13","Sun","November 28","W","","8-3",FALSE,"Los Angeles Rams",35,10,25,539,475,64,1,17,300,139,161,1,1993-11-28,0,1,"sfo",25
"14","Sun","December 5","W","","9-3",TRUE,"Cincinnati Bengals",21,8,19,284,173,111,2,19,339,195,144,1,1993-12-05,-1,1,"sfo",13
"15","Sat","December 11","L","","9-4",FALSE,"Atlanta Falcons",24,27,22,330,251,79,4,20,362,270,92,1,1993-12-11,-3,0,"sfo",-3
"16","Sun","December 19","W","","10-4",FALSE,"Detroit Lions",55,17,26,565,393,172,0,16,288,207,81,3,1993-12-19,3,1,"sfo",38
"17","Sat","December 25","L","","10-5",TRUE,"Houston Oilers",7,10,20,337,247,90,3,16,311,195,116,3,1993-12-25,0,0,"sfo",-3
"18","Mon","January 3","L","OT","10-6",TRUE,"Philadelphia Eagles",34,37,31,477,346,131,3,23,381,307,74,1,1994-01-03,-2,0,"sfo",-3
"Division","Sat","January 15","W","","11-6",TRUE,"New York Giants",44,3,25,413,235,178,1,12,194,153,41,3,1994-01-15,2,1,"sfo",41
"ConfChamp","Sun","January 23","L","","11-7",FALSE,"Dallas Cowboys",21,38,24,359,275,84,1,24,377,253,124,0,1994-01-23,-1,0,"sfo",-17
"1","Mon","September 5","W","","1-0",TRUE,"Los Angeles Raiders",44,14,24,448,292,156,1,12,181,147,34,2,1994-09-05,1,1,"sfo",30
"2","Sun","September 11","L","","1-1",FALSE,"Kansas City Chiefs",17,24,23,381,271,110,4,18,292,194,98,0,1994-09-11,-4,0,"sfo",-7
"3","Sun","September 18","W","","2-1",FALSE,"Los Angeles Rams",34,19,28,454,349,105,1,22,278,163,115,1,1994-09-18,0,1,"sfo",15
"4","Sun","September 25","W","","3-1",TRUE,"New Orleans Saints",24,13,18,298,224,74,2,17,340,291,49,2,1994-09-25,0,1,"sfo",11
"5","Sun","October 2","L","","3-2",TRUE,"Philadelphia Eagles",8,40,11,189,129,60,3,26,437,246,191,0,1994-10-02,-3,0,"sfo",-32
"6","Sun","October 9","W","","4-2",FALSE,"Detroit Lions",27,21,20,233,143,90,0,21,340,242,98,2,1994-10-09,2,1,"sfo",6
"7","Sun","October 16","W","","5-2",FALSE,"Atlanta Falcons",42,3,16,281,180,101,0,17,254,192,62,6,1994-10-16,6,1,"sfo",39
"8","Sun","October 23","W","","6-2",TRUE,"Tampa Bay Buccaneers",41,16,28,451,270,181,1,17,235,125,110,1,1994-10-23,0,1,"sfo",25
"10","Sun","November 6","W","","7-2",FALSE,"Washington Redskins",37,22,17,421,304,117,2,20,282,206,76,3,1994-11-06,1,1,"sfo",15
"11","Sun","November 13","W","","8-2",TRUE,"Dallas Cowboys",21,14,19,308,161,147,0,19,408,321,87,3,1994-11-13,3,1,"sfo",7
"12","Sun","November 20","W","","9-2",TRUE,"Los Angeles Rams",31,27,32,459,325,134,1,17,358,272,86,0,1994-11-20,-1,1,"sfo",4
"13","Mon","November 28","W","","10-2",FALSE,"New Orleans Saints",35,14,28,461,270,191,2,13,222,139,83,3,1994-11-28,1,1,"sfo",21
"14","Sun","December 4","W","","11-2",TRUE,"Atlanta Falcons",50,14,28,476,315,161,1,12,248,205,43,5,1994-12-04,4,1,"sfo",36
"15","Sun","December 11","W","","12-2",FALSE,"San Diego Chargers",38,15,27,417,298,119,1,20,378,322,56,2,1994-12-11,1,1,"sfo",23
"16","Sat","December 17","W","","13-2",TRUE,"Denver Broncos",42,19,25,488,386,102,1,20,334,286,48,3,1994-12-17,2,1,"sfo",23
"17","Mon","December 26","L","","13-3",FALSE,"Minnesota Vikings",14,21,18,295,246,49,4,14,252,150,102,2,1994-12-26,-2,0,"sfo",-7
"Division","Sat","January 7","W","","14-3",TRUE,"Chicago Bears",44,15,27,330,185,145,1,20,247,208,39,2,1995-01-07,1,1,"sfo",29
"ConfChamp","Sun","January 15","W","","15-3",TRUE,"Dallas Cowboys",38,28,19,294,155,139,1,29,451,352,99,5,1995-01-15,4,1,"sfo",10
"SuperBowl","Sun","January 29","W","","16-3",TRUE,"San Diego Chargers",49,26,28,455,316,139,0,20,354,287,67,3,1995-01-29,3,1,"sfo",23
"1","Sun","September 3","W","","1-0",FALSE,"New Orleans Saints",24,22,26,436,282,154,3,15,278,252,26,2,1995-09-03,-1,1,"sfo",2
"2","Sun","September 10","W","","2-0",TRUE,"Atlanta Falcons",41,10,28,489,331,158,1,15,267,242,25,3,1995-09-10,2,1,"sfo",31
"3","Sun","September 17","W","","3-0",TRUE,"New England Patriots",28,3,21,363,273,90,1,18,302,226,76,4,1995-09-17,3,1,"sfo",25
"4","Mon","September 25","L","","3-1",FALSE,"Detroit Lions",24,27,23,416,338,78,1,23,316,286,30,0,1995-09-25,-1,0,"sfo",-3
"5","Sun","October 1","W","","4-1",TRUE,"New York Giants",20,6,22,311,202,109,1,17,237,204,33,1,1995-10-01,0,1,"sfo",14
"7","Sun","October 15","L","","4-2",FALSE,"Indianapolis Colts",17,18,21,269,207,62,2,14,257,169,88,1,1995-10-15,-1,0,"sfo",-1
"8","Sun","October 22","W","","5-2",FALSE,"St. Louis Rams",44,10,17,257,144,113,0,16,355,284,71,4,1995-10-22,4,1,"sfo",34
"9","Sun","October 29","L","","5-3",TRUE,"New Orleans Saints",7,11,19,286,231,55,3,17,252,144,108,0,1995-10-29,-3,0,"sfo",-4
"10","Sun","November 5","L","","5-4",TRUE,"Carolina Panthers",7,13,19,404,339,65,5,13,204,132,72,2,1995-11-05,-3,0,"sfo",-6
"11","Sun","November 12","W","","6-4",FALSE,"Dallas Cowboys",38,20,21,386,300,86,0,19,296,188,108,4,1995-11-12,4,1,"sfo",18
"12","Mon","November 20","W","","7-4",FALSE,"Miami Dolphins",44,20,27,497,376,121,0,20,308,256,52,2,1995-11-20,2,1,"sfo",24
"13","Sun","November 26","W","","8-4",TRUE,"St. Louis Rams",41,13,23,348,269,79,3,13,229,148,81,5,1995-11-26,2,1,"sfo",28
"14","Sun","December 3","W","","9-4",TRUE,"Buffalo Bills",27,17,18,323,221,102,1,15,275,191,84,5,1995-12-03,4,1,"sfo",10
"15","Sun","December 10","W","","10-4",FALSE,"Carolina Panthers",31,10,26,401,322,79,2,12,195,119,76,1,1995-12-10,-1,1,"sfo",21
"16","Mon","December 18","W","","11-4",TRUE,"Minnesota Vikings",37,30,21,467,425,42,4,17,264,189,75,0,1995-12-18,-4,1,"sfo",7
"17","Sun","December 24","L","","11-5",FALSE,"Atlanta Falcons",27,28,23,434,348,86,1,20,363,307,56,0,1995-12-24,-1,0,"sfo",-1
"Division","Sat","January 6","L","","11-6",TRUE,"Green Bay Packers",17,27,26,395,308,87,4,18,368,294,74,0,1996-01-06,-4,0,"sfo",-10
"1","Sun","September 1","W","","1-0",TRUE,"New Orleans Saints",27,11,23,338,181,157,0,14,231,175,56,2,1996-09-01,2,1,"sfo",16
"2","Sun","September 8","W","","2-0",TRUE,"St. Louis Rams",34,0,23,352,222,130,0,6,105,69,36,4,1996-09-08,4,1,"sfo",34
"4","Sun","September 22","L","","2-1",FALSE,"Carolina Panthers",7,23,15,300,252,48,1,21,389,272,117,1,1996-09-22,0,0,"sfo",-16
"5","Sun","September 29","W","","3-1",TRUE,"Atlanta Falcons",39,17,16,396,246,150,0,18,317,191,126,4,1996-09-29,4,1,"sfo",22
"6","Sun","October 6","W","","4-1",FALSE,"St. Louis Rams",28,11,23,389,235,154,2,15,202,137,65,4,1996-10-06,2,1,"sfo",17
"7","Mon","October 14","L","OT","4-2",FALSE,"Green Bay Packers",20,23,14,253,179,74,2,24,446,378,68,2,1996-10-14,0,0,"sfo",-3
"8","Sun","October 20","W","","5-2",TRUE,"Cincinnati Bengals",28,21,20,418,338,80,5,18,345,196,149,1,1996-10-20,-4,1,"sfo",7
"9","Sun","October 27","W","","6-2",FALSE,"Houston Oilers",10,9,12,238,175,63,0,12,184,77,107,2,1996-10-27,2,1,"sfo",1
"10","Sun","November 3","W","","7-2",FALSE,"New Orleans Saints",24,17,17,306,115,191,0,18,293,229,64,3,1996-11-03,3,1,"sfo",7
"11","Sun","November 10","L","OT","7-3",TRUE,"Dallas Cowboys",17,20,16,267,156,111,3,20,316,222,94,1,1996-11-10,-2,0,"sfo",-3
"12","Sun","November 17","W","","8-3",TRUE,"Baltimore Ravens",38,20,22,372,262,110,4,16,268,159,109,3,1996-11-17,-1,1,"sfo",18
"13","Sun","November 24","W","OT","9-3",FALSE,"Washington Redskins",19,16,27,392,275,117,1,15,360,282,78,0,1996-11-24,-1,1,"sfo",3
"14","Mon","December 2","W","","10-3",FALSE,"Atlanta Falcons",34,10,25,466,264,202,2,9,178,117,61,4,1996-12-02,2,1,"sfo",24
"15","Sun","December 8","L","","10-4",TRUE,"Carolina Panthers",24,30,23,450,375,75,4,22,382,324,58,0,1996-12-08,-4,0,"sfo",-6
"16","Sun","December 15","W","","11-4",FALSE,"Pittsburgh Steelers",25,15,21,288,232,56,0,23,368,248,120,3,1996-12-15,3,1,"sfo",10
"17","Mon","December 23","W","","12-4",TRUE,"Detroit Lions",24,14,18,281,152,129,0,18,277,88,189,0,1996-12-23,0,1,"sfo",10
"WildCard","Sun","December 29","W","","13-4",TRUE,"Philadelphia Eagles",14,0,17,279,161,118,0,16,283,212,71,3,1996-12-29,3,1,"sfo",14
"Division","Sat","January 4","L","","13-5",FALSE,"Green Bay Packers",14,35,12,196,128,68,5,15,210,71,139,1,1997-01-04,-4,0,"sfo",-21
"1","Sun","August 31","L","","0-1",FALSE,"Tampa Bay Buccaneers",6,13,12,191,91,100,1,15,271,156,115,2,1997-08-31,1,0,"sfo",-7
"2","Sun","September 7","W","","1-1",FALSE,"St. Louis Rams",15,12,12,228,93,135,4,11,203,104,99,4,1997-09-07,0,1,"sfo",3
"3","Sun","September 14","W","","2-1",TRUE,"New Orleans Saints",33,7,17,304,213,91,1,12,260,176,84,8,1997-09-14,7,1,"sfo",26
"4","Sun","September 21","W","","3-1",TRUE,"Atlanta Falcons",34,7,18,424,353,71,0,15,211,154,57,1,1997-09-21,1,1,"sfo",27
"5","Mon","September 29","W","","4-1",FALSE,"Carolina Panthers",34,21,27,368,149,219,1,16,254,210,44,4,1997-09-29,3,1,"sfo",13
"7","Sun","October 12","W","","5-1",TRUE,"St. Louis Rams",30,10,21,345,189,156,1,7,113,83,30,3,1997-10-12,2,1,"sfo",20
"8","Sun","October 19","W","","6-1",FALSE,"Atlanta Falcons",35,28,24,438,241,197,1,19,292,253,39,0,1997-10-19,-1,1,"sfo",7
"9","Sun","October 26","W","","7-1",FALSE,"New Orleans Saints",23,0,21,347,210,137,0,6,142,87,55,2,1997-10-26,2,1,"sfo",23
"10","Sun","November 2","W","","8-1",TRUE,"Dallas Cowboys",17,10,18,301,173,128,2,16,271,184,87,2,1997-11-02,0,1,"sfo",7
"11","Mon","November 10","W","","9-1",FALSE,"Philadelphia Eagles",24,12,13,213,96,117,1,18,257,188,69,3,1997-11-10,2,1,"sfo",12
"12","Sun","November 16","W","","10-1",TRUE,"Carolina Panthers",27,19,20,320,221,99,0,18,254,169,85,3,1997-11-16,3,1,"sfo",8
"13","Sun","November 23","W","","11-1",TRUE,"San Diego Chargers",17,10,19,339,228,111,2,8,203,111,92,3,1997-11-23,1,1,"sfo",7
"14","Sun","November 30","L","","11-2",FALSE,"Kansas City Chiefs",9,44,13,279,152,127,3,22,340,187,153,1,1997-11-30,-2,0,"sfo",-35
"15","Sun","December 7","W","","12-2",TRUE,"Minnesota Vikings",28,17,24,368,270,98,0,20,298,161,137,2,1997-12-07,2,1,"sfo",11
"16","Mon","December 15","W","","13-2",TRUE,"Denver Broncos",34,17,18,323,265,58,1,15,237,141,96,3,1997-12-15,2,1,"sfo",17
"17","Sun","December 21","L","","13-3",FALSE,"Seattle Seahawks",9,38,17,324,199,125,2,24,407,283,124,0,1997-12-21,-2,0,"sfo",-29
"Division","Sat","January 3","W","","14-3",TRUE,"Minnesota Vikings",38,22,31,394,219,175,0,16,378,321,57,1,1998-01-03,1,1,"sfo",16
"ConfChamp","Sun","January 11","L","","14-4",TRUE,"Green Bay Packers",10,23,15,257,224,33,2,19,325,219,106,0,1998-01-11,-2,0,"sfo",-13
"1","Sun","September 6","W","OT","1-0",TRUE,"New York Jets",36,30,26,557,350,207,1,25,465,406,59,1,1998-09-06,0,1,"sfo",6
"2","Mon","September 14","W","","2-0",FALSE,"Washington Redskins",45,10,28,504,294,210,0,17,322,182,140,3,1998-09-14,3,1,"sfo",35
"4","Sun","September 27","W","","3-0",TRUE,"Atlanta Falcons",31,20,23,538,377,161,2,19,369,222,147,4,1998-09-27,2,1,"sfo",11
"5","Sun","October 4","L","","3-1",FALSE,"Buffalo Bills",21,26,23,377,312,65,4,21,352,237,115,0,1998-10-04,-4,0,"sfo",-5
"6","Sun","October 11","W","","4-1",FALSE,"New Orleans Saints",31,0,30,459,319,140,0,10,167,135,32,1,1998-10-11,1,1,"sfo",31
"7","Sun","October 18","W","","5-1",TRUE,"Indianapolis Colts",34,31,36,448,321,127,2,15,336,231,105,0,1998-10-18,-2,1,"sfo",3
"8","Sun","October 25","W","","6-1",FALSE,"St. Louis Rams",28,10,16,303,210,93,2,15,168,89,79,4,1998-10-25,2,1,"sfo",18
"9","Sun","November 1","L","","6-2",FALSE,"Green Bay Packers",22,36,19,266,132,134,2,15,372,274,98,3,1998-11-01,1,0,"sfo",-14
"10","Sun","November 8","W","","7-2",TRUE,"Carolina Panthers",25,23,22,366,261,105,6,16,287,237,50,2,1998-11-08,-4,1,"sfo",2
"11","Sun","November 15","L","","7-3",FALSE,"Atlanta Falcons",19,31,18,383,307,76,2,19,298,184,114,1,1998-11-15,-1,0,"sfo",-12
"12","Sun","November 22","W","","8-3",TRUE,"New Orleans Saints",31,20,23,443,289,154,3,23,401,311,90,4,1998-11-22,1,1,"sfo",11
"13","Mon","November 30","W","","9-3",TRUE,"New York Giants",31,7,23,466,229,237,0,18,344,224,120,2,1998-11-30,2,1,"sfo",24
"14","Sun","December 6","W","OT","10-3",FALSE,"Carolina Panthers",31,28,22,474,238,236,2,22,429,226,203,3,1998-12-06,1,1,"sfo",3
"15","Mon","December 14","W","","11-3",TRUE,"Detroit Lions",35,13,29,409,81,328,1,25,380,311,69,2,1998-12-14,1,1,"sfo",22
"16","Sun","December 20","L","","11-4",FALSE,"New England Patriots",21,24,21,410,259,151,3,20,332,200,132,2,1998-12-20,-1,0,"sfo",-3
"17","Sun","December 27","W","","12-4",TRUE,"St. Louis Rams",38,19,22,397,277,120,0,17,321,264,57,1,1998-12-27,1,1,"sfo",19
"WildCard","Sun","January 3","W","","13-4",TRUE,"Green Bay Packers",30,27,20,347,169,178,3,24,403,282,121,4,1999-01-03,1,1,"sfo",3
"Division","Sat","January 9","L","","13-5",FALSE,"Atlanta Falcons",18,20,15,334,288,46,3,16,289,153,136,1,1999-01-09,-2,0,"sfo",-2
"1","Sun","September 12","L","","0-1",FALSE,"Jacksonville Jaguars",3,41,11,203,109,94,5,18,344,247,97,0,1999-09-12,-5,0,"sfo",-38
"2","Sun","September 19","W","","1-1",TRUE,"New Orleans Saints",28,21,21,311,223,88,1,17,324,223,101,3,1999-09-19,2,1,"sfo",7
"3","Mon","September 27","W","","2-1",FALSE,"Arizona Cardinals",24,10,18,322,112,210,1,20,250,149,101,4,1999-09-27,3,1,"sfo",14
"4","Sun","October 3","W","","3-1",TRUE,"Tennessee Titans",24,22,17,329,243,86,0,17,392,337,55,1,1999-10-03,1,1,"sfo",2
"5","Sun","October 10","L","","3-2",FALSE,"St. Louis Rams",20,42,21,305,233,72,3,20,423,314,109,2,1999-10-10,-1,0,"sfo",-22
"6","Sun","October 17","L","","3-3",TRUE,"Carolina Panthers",29,31,23,333,209,124,3,18,383,282,101,4,1999-10-17,1,0,"sfo",-2
"7","Sun","October 24","L","","3-4",FALSE,"Minnesota Vikings",16,40,14,260,178,82,2,25,395,240,155,2,1999-10-24,0,0,"sfo",-24
"9","Sun","November 7","L","","3-5",TRUE,"Pittsburgh Steelers",6,27,16,313,90,223,2,14,271,130,141,0,1999-11-07,-2,0,"sfo",-21
"10","Sun","November 14","L","","3-6",FALSE,"New Orleans Saints",6,24,16,234,140,94,1,20,365,222,143,0,1999-11-14,-1,0,"sfo",-18
"11","Sun","November 21","L","","3-7",TRUE,"St. Louis Rams",7,23,14,251,145,106,5,21,345,181,164,1,1999-11-21,-4,0,"sfo",-16
"12","Mon","November 29","L","","3-8",TRUE,"Green Bay Packers",3,20,14,322,185,137,2,19,308,229,79,0,1999-11-29,-2,0,"sfo",-17
"13","Sun","December 5","L","","3-9",FALSE,"Cincinnati Bengals",30,44,29,542,437,105,3,27,476,325,151,0,1999-12-05,-3,0,"sfo",-14
"14","Sun","December 12","W","","4-9",TRUE,"Atlanta Falcons",26,7,21,334,153,181,0,7,105,67,38,2,1999-12-12,2,1,"sfo",19
"15","Sat","December 18","L","","4-10",FALSE,"Carolina Panthers",24,41,18,397,297,100,1,25,452,362,90,0,1999-12-18,-1,0,"sfo",-17
"16","Sun","December 26","L","OT","4-11",TRUE,"Washington Redskins",20,26,24,418,168,250,2,23,511,454,57,1,1999-12-26,-1,0,"sfo",-6
"17","Mon","January 3","L","","4-12",FALSE,"Atlanta Falcons",29,34,23,506,363,143,1,24,343,306,37,0,2000-01-03,-1,0,"sfo",-5
"1","Sun","September 3","L","","0-1",FALSE,"Atlanta Falcons",28,36,23,339,247,92,1,22,359,264,95,1,2000-09-03,0,0,"sfo",-8
"2","Sun","September 10","L","","0-2",TRUE,"Carolina Panthers",22,38,21,391,301,90,2,27,450,352,98,1,2000-09-10,-1,0,"sfo",-16
"3","Sun","September 17","L","","0-3",FALSE,"St. Louis Rams",24,41,16,401,290,111,2,32,529,389,140,2,2000-09-17,0,0,"sfo",-17
"4","Sun","September 24","W","","1-3",FALSE,"Dallas Cowboys",41,24,27,439,178,261,0,18,298,222,76,3,2000-09-24,3,1,"sfo",17
"5","Sun","October 1","W","","2-3",TRUE,"Arizona Cardinals",27,20,18,345,215,130,1,16,365,239,126,2,2000-10-01,1,1,"sfo",7
"6","Sun","October 8","L","OT","2-4",TRUE,"Oakland Raiders",28,34,28,472,336,136,2,31,471,307,164,2,2000-10-08,0,0,"sfo",-6
"7","Sun","October 15","L","","2-5",FALSE,"Green Bay Packers",28,31,23,414,319,95,0,22,378,246,132,0,2000-10-15,0,0,"sfo",-3
"8","Sun","October 22","L","","2-6",FALSE,"Carolina Panthers",16,34,20,411,283,128,2,26,390,292,98,0,2000-10-22,-2,0,"sfo",-18
"9","Sun","October 29","L","","2-7",TRUE,"St. Louis Rams",24,34,15,325,233,92,0,22,447,298,149,1,2000-10-29,1,0,"sfo",-10
"10","Sun","November 5","L","","2-8",FALSE,"New Orleans Saints",15,31,19,346,262,84,2,25,360,249,111,0,2000-11-05,-2,0,"sfo",-16
"11","Sun","November 12","W","","3-8",TRUE,"Kansas City Chiefs",21,7,25,389,240,149,0,20,294,245,49,1,2000-11-12,1,1,"sfo",14
"12","Sun","November 19","W","","4-8",TRUE,"Atlanta Falcons",16,6,17,337,210,127,1,11,211,118,93,1,2000-11-19,0,1,"sfo",10
"14","Sun","December 3","W","","5-8",FALSE,"San Diego Chargers",45,17,19,385,312,73,0,18,303,254,49,5,2000-12-03,5,1,"sfo",28
"15","Sun","December 10","L","","5-9",TRUE,"New Orleans Saints",27,31,21,398,288,110,3,21,388,172,216,0,2000-12-10,-3,0,"sfo",-4
"16","Sun","December 17","W","","6-9",TRUE,"Chicago Bears",17,0,26,456,379,77,1,8,104,65,39,1,2000-12-17,0,1,"sfo",17
"17","Sat","December 23","L","","6-10",FALSE,"Denver Broncos",9,38,16,192,146,46,2,28,362,203,159,1,2000-12-23,-1,0,"sfo",-29
"1","Sun","September 9","W","OT","1-0",TRUE,"Atlanta Falcons",16,13,20,429,324,105,1,13,241,107,134,0,2001-09-09,-1,1,"sfo",3
"2","Sun","September 23","L","","1-1",TRUE,"St. Louis Rams",26,30,14,232,116,116,1,20,425,310,115,3,2001-09-23,2,0,"sfo",-4
"3","Mon","October 1","W","","2-1",FALSE,"New York Jets",19,17,21,359,126,233,1,16,268,186,82,0,2001-10-01,-1,1,"sfo",2
"4","Sun","October 7","W","","3-1",TRUE,"Carolina Panthers",24,14,21,353,203,150,1,17,336,275,61,3,2001-10-07,2,1,"sfo",10
"5","Sun","October 14","W","OT","4-1",FALSE,"Atlanta Falcons",37,31,27,517,330,187,2,21,342,254,88,1,2001-10-14,-1,1,"sfo",6
"7","Sun","October 28","L","OT","4-2",FALSE,"Chicago Bears",31,37,20,350,267,83,2,29,364,229,135,3,2001-10-28,1,0,"sfo",-6
"8","Sun","November 4","W","","5-2",TRUE,"Detroit Lions",21,13,27,427,282,145,3,12,131,73,58,0,2001-11-04,-3,1,"sfo",8
"9","Sun","November 11","W","","6-2",TRUE,"New Orleans Saints",28,27,21,415,251,164,0,24,488,336,152,1,2001-11-11,1,1,"sfo",1
"10","Sun","November 18","W","OT","7-2",FALSE,"Carolina Panthers",25,22,26,417,296,121,3,14,280,177,103,0,2001-11-18,-3,1,"sfo",3
"11","Sun","November 25","W","","8-2",FALSE,"Indianapolis Colts",40,21,16,340,169,171,1,30,491,364,127,5,2001-11-25,4,1,"sfo",19
"12","Sun","December 2","W","","9-2",TRUE,"Buffalo Bills",35,0,26,409,179,230,0,11,191,162,29,5,2001-12-02,5,1,"sfo",35
"13","Sun","December 9","L","","9-3",FALSE,"St. Louis Rams",14,27,16,220,144,76,2,23,385,270,115,2,2001-12-09,0,0,"sfo",-13
"14","Sun","December 16","W","","10-3",TRUE,"Miami Dolphins",21,0,21,285,133,152,0,12,174,107,67,4,2001-12-16,4,1,"sfo",21
"15","Sat","December 22","W","","11-3",TRUE,"Philadelphia Eagles",13,3,14,244,127,117,0,12,292,213,79,1,2001-12-22,1,1,"sfo",10
"16","Sun","December 30","L","","11-4",FALSE,"Dallas Cowboys",21,27,16,285,229,56,1,24,420,234,186,0,2001-12-30,-1,0,"sfo",-6
"17","Sun","January 6","W","","12-4",FALSE,"New Orleans Saints",38,0,22,407,269,138,1,11,126,86,40,6,2002-01-06,5,1,"sfo",38
"WildCard","Sun","January 13","L","","12-5",FALSE,"Green Bay Packers",15,25,19,290,219,71,2,21,368,262,106,1,2002-01-13,-1,0,"sfo",-10
"1","Thu","September 5","W","","1-0",FALSE,"New York Giants",16,13,13,279,166,113,1,21,361,318,43,3,2002-09-05,2,1,"sfo",3
"2","Sun","September 15","L","","1-1",TRUE,"Denver Broncos",14,24,18,261,190,71,2,21,299,98,201,1,2002-09-15,-1,0,"sfo",-10
"3","Sun","September 22","W","","2-1",TRUE,"Washington Redskins",20,10,22,366,114,252,1,12,217,160,57,3,2002-09-22,2,1,"sfo",10
"5","Sun","October 6","W","","3-1",TRUE,"St. Louis Rams",37,13,21,386,207,179,0,19,313,225,88,2,2002-10-06,2,1,"sfo",24
"6","Mon","October 14","W","","4-1",FALSE,"Seattle Seahawks",28,21,24,351,190,161,0,24,334,211,123,2,2002-10-14,2,1,"sfo",7
"7","Sun","October 20","L","","4-2",FALSE,"New Orleans Saints",27,35,26,418,275,143,2,27,422,243,179,1,2002-10-20,-1,0,"sfo",-8
"8","Sun","October 27","W","","5-2",TRUE,"Arizona Cardinals",38,28,18,357,252,105,0,23,420,269,151,4,2002-10-27,4,1,"sfo",10
"9","Sun","November 3","W","OT","6-2",FALSE,"Oakland Raiders",23,20,30,434,282,152,1,15,239,158,81,1,2002-11-03,0,1,"sfo",3
"10","Sun","November 10","W","","7-2",TRUE,"Kansas City Chiefs",17,13,22,323,168,155,1,14,256,176,80,0,2002-11-10,-1,1,"sfo",4
"11","Sun","November 17","L","OT","7-3",FALSE,"San Diego Chargers",17,20,21,467,331,136,1,26,441,336,105,1,2002-11-17,0,0,"sfo",-3
"12","Mon","November 25","L","","7-4",TRUE,"Philadelphia Eagles",17,38,24,409,305,104,0,19,343,236,107,0,2002-11-25,0,0,"sfo",-21
"13","Sun","December 1","W","","8-4",TRUE,"Seattle Seahawks",31,24,21,299,157,142,2,25,507,427,80,3,2002-12-01,1,1,"sfo",7
"14","Sun","December 8","W","","9-4",FALSE,"Dallas Cowboys",31,27,26,401,276,125,1,10,257,147,110,2,2002-12-08,1,1,"sfo",4
"15","Sun","December 15","L","","9-5",TRUE,"Green Bay Packers",14,20,16,263,156,107,1,21,302,198,104,0,2002-12-15,-1,0,"sfo",-6
"16","Sat","December 21","W","","10-5",FALSE,"Arizona Cardinals",17,14,21,358,252,106,2,14,184,76,108,2,2002-12-21,0,1,"sfo",3
"17","Mon","December 30","L","","10-6",FALSE,"St. Louis Rams",20,31,19,329,136,193,2,16,263,228,35,2,2002-12-30,0,0,"sfo",-11
"WildCard","Sun","January 5","W","","11-6",TRUE,"New York Giants",39,38,23,446,356,90,2,26,446,327,119,1,2003-01-05,-1,1,"sfo",1
"Division","Sun","January 12","L","","11-7",FALSE,"Tampa Bay Buccaneers",6,31,14,228,166,62,5,21,329,208,121,2,2003-01-12,-3,0,"sfo",-25
"1","Sun","September 7","W","","1-0",TRUE,"Chicago Bears",49,7,23,391,229,162,2,8,127,72,55,5,2003-09-07,3,1,"sfo",42
"2","Sun","September 14","L","OT","1-1",FALSE,"St. Louis Rams",24,27,20,390,242,148,1,21,278,190,88,4,2003-09-14,3,0,"sfo",-3
"3","Sun","September 21","L","","1-2",TRUE,"Cleveland Browns",12,13,15,265,190,75,1,20,251,200,51,2,2003-09-21,1,0,"sfo",-1
"4","Sun","September 28","L","","1-3",FALSE,"Minnesota Vikings",7,35,18,372,227,145,3,19,354,252,102,0,2003-09-28,-3,0,"sfo",-28
"5","Sun","October 5","W","","2-3",TRUE,"Detroit Lions",24,17,20,325,183,142,1,15,305,221,84,2,2003-10-05,1,1,"sfo",7
"6","Sun","October 12","L","","2-4",FALSE,"Seattle Seahawks",19,20,19,261,150,111,1,21,333,186,147,1,2003-10-12,0,0,"sfo",-1
"7","Sun","October 19","W","","3-4",TRUE,"Tampa Bay Buccaneers",24,7,22,458,246,212,2,14,326,258,68,4,2003-10-19,2,1,"sfo",17
"8","Sun","October 26","L","OT","3-5",FALSE,"Arizona Cardinals",13,16,15,255,149,106,1,18,314,93,221,1,2003-10-26,0,0,"sfo",-3
"9","Sun","November 2","W","","4-5",TRUE,"St. Louis Rams",30,10,24,389,224,165,2,18,340,331,9,3,2003-11-02,1,1,"sfo",20
"11","Mon","November 17","W","","5-5",TRUE,"Pittsburgh Steelers",30,14,17,423,254,169,0,21,349,305,44,2,2003-11-17,2,1,"sfo",16
"12","Sun","November 23","L","","5-6",FALSE,"Green Bay Packers",10,20,13,192,119,73,1,18,379,136,243,3,2003-11-23,2,0,"sfo",-10
"13","Sun","November 30","L","","5-7",FALSE,"Baltimore Ravens",6,44,10,264,158,106,4,15,282,165,117,2,2003-11-30,-2,0,"sfo",-38
"14","Sun","December 7","W","","6-7",TRUE,"Arizona Cardinals",50,14,30,496,264,232,1,18,210,151,59,2,2003-12-07,1,1,"sfo",36
"15","Sun","December 14","L","","6-8",FALSE,"Cincinnati Bengals",38,41,31,502,331,171,3,23,393,168,225,0,2003-12-14,-3,0,"sfo",-3
"16","Sun","December 21","W","OT","7-8",FALSE,"Philadelphia Eagles",31,28,22,414,211,203,1,18,293,205,88,3,2003-12-21,2,1,"sfo",3
"17","Sat","December 27","L","","7-9",TRUE,"Seattle Seahawks",17,24,14,290,231,59,1,25,394,305,89,3,2003-12-27,2,0,"sfo",-7
"1","Sun","September 12","L","","0-1",TRUE,"Atlanta Falcons",19,21,21,359,266,93,2,14,227,132,95,1,2004-09-12,-1,0,"sfo",-2
"2","Sun","September 19","L","","0-2",FALSE,"New Orleans Saints",27,30,22,370,190,180,3,17,302,256,46,1,2004-09-19,-2,0,"sfo",-3
"3","Sun","September 26","L","","0-3",FALSE,"Seattle Seahawks",0,34,9,175,127,48,4,24,374,257,117,0,2004-09-26,-4,0,"sfo",-34
"4","Sun","October 3","L","","0-4",TRUE,"St. Louis Rams",14,24,26,332,274,58,2,24,360,186,174,0,2004-10-03,-2,0,"sfo",-10
"5","Sun","October 10","W","OT","1-4",TRUE,"Arizona Cardinals",31,28,28,448,391,57,2,19,320,217,103,1,2004-10-10,-1,1,"sfo",3
"6","Sun","October 17","L","","1-5",FALSE,"New York Jets",14,22,19,371,272,99,2,22,374,222,152,0,2004-10-17,-2,0,"sfo",-8
"8","Sun","October 31","L","","1-6",FALSE,"Chicago Bears",13,23,10,162,100,62,2,14,254,134,120,3,2004-10-31,1,0,"sfo",-10
"9","Sun","November 7","L","","1-7",TRUE,"Seattle Seahawks",27,42,19,317,243,74,1,26,453,269,184,0,2004-11-07,-1,0,"sfo",-15
"10","Sun","November 14","L","","1-8",TRUE,"Carolina Panthers",27,37,23,357,247,110,5,17,358,301,57,2,2004-11-14,-3,0,"sfo",-10
"11","Sun","November 21","L","","1-9",FALSE,"Tampa Bay Buccaneers",3,35,13,197,125,72,2,19,352,193,159,2,2004-11-21,0,0,"sfo",-32
"12","Sun","November 28","L","","1-10",TRUE,"Miami Dolphins",17,24,16,224,147,77,3,15,200,151,49,2,2004-11-28,-1,0,"sfo",-7
"13","Sun","December 5","L","","1-11",FALSE,"St. Louis Rams",6,16,9,160,97,63,1,19,350,214,136,2,2004-12-05,1,0,"sfo",-10
"14","Sun","December 12","W","OT","2-11",FALSE,"Arizona Cardinals",31,28,23,352,184,168,1,25,374,299,75,2,2004-12-12,1,1,"sfo",3
"15","Sat","December 18","L","","2-12",TRUE,"Washington Redskins",16,26,15,254,199,55,4,17,337,209,128,1,2004-12-18,-3,0,"sfo",-10
"16","Sun","December 26","L","","2-13",TRUE,"Buffalo Bills",7,41,12,189,91,98,4,27,441,215,226,1,2004-12-26,-3,0,"sfo",-34
"17","Sun","January 2","L","","2-14",FALSE,"New England Patriots",7,21,15,318,183,135,2,23,405,231,174,3,2005-01-02,1,0,"sfo",-14
"1","Sun","September 11","W","","1-0",TRUE,"St. Louis Rams",28,25,12,217,183,34,2,26,405,316,89,1,2005-09-11,-1,1,"sfo",3
"2","Sun","September 18","L","","1-1",FALSE,"Philadelphia Eagles",3,42,8,142,84,58,3,30,583,443,140,1,2005-09-18,-2,0,"sfo",-39
"3","Sun","September 25","L","","1-2",TRUE,"Dallas Cowboys",31,34,19,390,266,124,3,26,443,348,95,3,2005-09-25,0,0,"sfo",-3
"4","Sun","October 2","L","","1-3",FALSE,"Arizona Cardinals",14,31,8,168,117,51,4,24,463,366,97,3,2005-10-02,-1,0,"sfo",-17
"5","Sun","October 9","L","","1-4",TRUE,"Indianapolis Colts",3,28,12,177,44,133,5,22,365,245,120,3,2005-10-09,-2,0,"sfo",-25
"7","Sun","October 23","L","","1-5",FALSE,"Washington Redskins",17,52,9,194,54,140,2,24,457,253,204,0,2005-10-23,-2,0,"sfo",-35
"8","Sun","October 30","W","","2-5",TRUE,"Tampa Bay Buccaneers",15,10,9,208,50,158,0,13,275,232,43,3,2005-10-30,3,1,"sfo",5
"9","Sun","November 6","L","","2-6",TRUE,"New York Giants",6,24,9,138,86,52,1,19,344,251,93,0,2005-11-06,-1,0,"sfo",-18
"10","Sun","November 13","L","","2-7",FALSE,"Chicago Bears",9,17,9,161,28,133,2,12,239,67,172,4,2005-11-13,2,0,"sfo",-8
"11","Sun","November 20","L","","2-8",TRUE,"Seattle Seahawks",25,27,17,336,226,110,1,21,373,228,145,0,2005-11-20,-1,0,"sfo",-2
"12","Sun","November 27","L","","2-9",FALSE,"Tennessee Titans",22,33,15,261,187,74,4,15,461,343,118,1,2005-11-27,-3,0,"sfo",-11
"13","Sun","December 4","L","","2-10",TRUE,"Arizona Cardinals",10,17,11,220,169,51,4,18,404,339,65,2,2005-12-04,-2,0,"sfo",-7
"14","Sun","December 11","L","","2-11",FALSE,"Seattle Seahawks",3,41,8,113,51,62,2,31,438,253,185,1,2005-12-11,-1,0,"sfo",-38
"15","Sun","December 18","L","","2-12",FALSE,"Jacksonville Jaguars",9,10,11,217,107,110,1,21,336,202,134,0,2005-12-18,-1,0,"sfo",-1
"16","Sat","December 24","W","","3-12",FALSE,"St. Louis Rams",24,20,15,321,104,217,0,20,389,345,44,2,2005-12-24,2,1,"sfo",4
"17","Sun","January 1","W","OT","4-12",TRUE,"Houston Texans",20,17,19,324,142,182,1,13,284,196,88,2,2006-01-01,1,1,"sfo",3
"1","Sun","September 10","L","","0-1",FALSE,"Arizona Cardinals",27,34,19,393,286,107,2,23,367,283,84,1,2006-09-10,-1,0,"sfo",-7
"2","Sun","September 17","W","","1-1",TRUE,"St. Louis Rams",20,13,14,360,233,127,1,17,265,147,118,1,2006-09-17,0,1,"sfo",7
"3","Sun","September 24","L","","1-2",TRUE,"Philadelphia Eagles",24,38,23,392,269,123,2,16,416,266,150,1,2006-09-24,-1,0,"sfo",-14
"4","Sun","October 1","L","","1-3",FALSE,"Kansas City Chiefs",0,41,10,165,76,89,4,23,333,208,125,0,2006-10-01,-4,0,"sfo",-41
"5","Sun","October 8","W","","2-3",TRUE,"Oakland Raiders",34,20,18,330,165,165,1,18,370,216,154,5,2006-10-08,4,1,"sfo",14
"6","Sun","October 15","L","","2-4",TRUE,"San Diego Chargers",19,48,15,274,182,92,2,30,421,334,87,0,2006-10-15,-2,0,"sfo",-29
"8","Sun","October 29","L","","2-5",FALSE,"Chicago Bears",10,41,12,248,121,127,5,24,402,257,145,0,2006-10-29,-5,0,"sfo",-31
"9","Sun","November 5","W","","3-5",TRUE,"Minnesota Vikings",9,3,8,133,91,42,1,17,238,103,135,3,2006-11-05,2,1,"sfo",6
"10","Sun","November 12","W","","4-5",FALSE,"Detroit Lions",19,13,17,315,117,198,1,16,251,180,71,4,2006-11-12,3,1,"sfo",6
"11","Sun","November 19","W","","5-5",TRUE,"Seattle Seahawks",20,14,18,416,154,262,1,15,303,233,70,5,2006-11-19,4,1,"sfo",6
"12","Sun","November 26","L","","5-6",FALSE,"St. Louis Rams",17,20,20,319,148,171,3,23,349,209,140,1,2006-11-26,-2,0,"sfo",-3
"13","Sun","December 3","L","","5-7",FALSE,"New Orleans Saints",10,34,10,202,145,57,3,23,375,185,190,0,2006-12-03,-3,0,"sfo",-24
"14","Sun","December 10","L","","5-8",TRUE,"Green Bay Packers",19,30,13,340,194,146,3,19,420,281,139,0,2006-12-10,-3,0,"sfo",-11
"15","Thu","December 14","W","","6-8",FALSE,"Seattle Seahawks",24,14,15,390,162,228,0,22,300,210,90,2,2006-12-14,2,1,"sfo",10
"16","Sun","December 24","L","","6-9",TRUE,"Arizona Cardinals",20,26,14,223,174,49,2,21,372,249,123,1,2006-12-24,-1,0,"sfo",-6
"17","Sun","December 31","W","OT","7-9",FALSE,"Denver Broncos",26,23,17,357,168,189,1,19,325,210,115,3,2006-12-31,2,1,"sfo",3
"1","Mon","September 10","W","","1-0",TRUE,"Arizona Cardinals",20,17,16,194,102,92,1,20,261,100,161,2,2007-09-10,1,1,"sfo",3
"2","Sun","September 16","W","","2-0",FALSE,"St. Louis Rams",17,16,8,186,97,89,2,20,392,331,61,3,2007-09-16,1,1,"sfo",1
"3","Sun","September 23","L","","2-1",FALSE,"Pittsburgh Steelers",16,37,17,289,198,91,1,19,350,145,205,1,2007-09-23,0,0,"sfo",-21
"4","Sun","September 30","L","","2-2",TRUE,"Seattle Seahawks",3,23,9,184,75,109,3,17,371,278,93,1,2007-09-30,-2,0,"sfo",-20
"5","Sun","October 7","L","","2-3",TRUE,"Baltimore Ravens",7,9,6,163,114,49,1,19,315,214,101,0,2007-10-07,-1,0,"sfo",-2
"7","Sun","October 21","L","","2-4",FALSE,"New York Giants",15,33,20,267,164,103,4,21,279,139,140,1,2007-10-21,-3,0,"sfo",-18
"8","Sun","October 28","L","","2-5",TRUE,"New Orleans Saints",10,31,15,260,177,83,1,26,438,336,102,1,2007-10-28,0,0,"sfo",-21
"9","Sun","November 4","L","","2-6",FALSE,"Atlanta Falcons",16,20,16,251,135,116,4,15,286,131,155,1,2007-11-04,-3,0,"sfo",-4
"10","Mon","November 12","L","","2-7",FALSE,"Seattle Seahawks",0,24,6,173,94,79,2,27,380,274,106,2,2007-11-12,0,0,"sfo",-24
"11","Sun","November 18","L","","2-8",TRUE,"St. Louis Rams",9,13,13,244,212,32,2,15,207,105,102,0,2007-11-18,-2,0,"sfo",-4
"12","Sun","November 25","W","OT","3-8",FALSE,"Arizona Cardinals",37,31,21,374,237,137,0,25,552,456,96,4,2007-11-25,4,1,"sfo",6
"13","Sun","December 2","L","","3-9",FALSE,"Carolina Panthers",14,31,12,195,136,59,6,20,323,157,166,2,2007-12-02,-4,0,"sfo",-17
"14","Sun","December 9","L","","3-10",TRUE,"Minnesota Vikings",7,27,17,282,209,73,5,11,280,163,117,1,2007-12-09,-4,0,"sfo",-20
"15","Sat","December 15","W","","4-10",TRUE,"Cincinnati Bengals",20,13,22,337,181,156,0,15,313,252,61,0,2007-12-15,0,1,"sfo",7
"16","Sun","December 23","W","","5-10",TRUE,"Tampa Bay Buccaneers",21,19,11,213,116,97,2,20,434,367,67,2,2007-12-23,0,1,"sfo",2
"17","Sun","December 30","L","","5-11",FALSE,"Cleveland Browns",7,20,9,185,73,112,0,18,358,195,163,1,2007-12-30,1,0,"sfo",-13
"1","Sun","September 7","L","","0-1",TRUE,"Arizona Cardinals",13,23,13,291,183,108,5,18,285,176,109,0,2008-09-07,-5,0,"sfo",-10
"2","Sun","September 14","W","OT","1-1",FALSE,"Seattle Seahawks",33,30,20,365,272,93,1,22,351,182,169,3,2008-09-14,2,1,"sfo",3
"3","Sun","September 21","W","","2-1",TRUE,"Detroit Lions",31,13,25,370,188,182,0,14,240,124,116,2,2008-09-21,2,1,"sfo",18
"4","Sun","September 28","L","","2-2",FALSE,"New Orleans Saints",17,31,20,312,221,91,3,24,467,363,104,2,2008-09-28,-1,0,"sfo",-14
"5","Sun","October 5","L","","2-3",TRUE,"New England Patriots",21,30,12,199,122,77,3,25,377,233,144,2,2008-10-05,-1,0,"sfo",-9
"6","Sun","October 12","L","","2-4",TRUE,"Philadelphia Eagles",26,40,14,306,175,131,3,21,383,280,103,1,2008-10-12,-2,0,"sfo",-14
"7","Sun","October 19","L","","2-5",FALSE,"New York Giants",17,29,13,253,218,35,3,17,273,161,112,0,2008-10-19,-3,0,"sfo",-12
"8","Sun","October 26","L","","2-6",TRUE,"Seattle Seahawks",13,34,21,388,264,124,2,14,261,222,39,0,2008-10-26,-2,0,"sfo",-21
"10","Mon","November 10","L","","2-7",FALSE,"Arizona Cardinals",24,29,19,336,217,119,3,21,374,328,46,0,2008-11-10,-3,0,"sfo",-5
"11","Sun","November 16","W","","3-7",TRUE,"St. Louis Rams",35,16,19,334,199,135,2,22,406,280,126,3,2008-11-16,1,1,"sfo",19
"12","Sun","November 23","L","","3-8",FALSE,"Dallas Cowboys",22,35,16,304,278,26,2,16,408,334,74,1,2008-11-23,-1,0,"sfo",-13
"13","Sun","November 30","W","","4-8",FALSE,"Buffalo Bills",10,3,12,195,133,62,1,18,350,194,156,1,2008-11-30,0,1,"sfo",7
"14","Sun","December 7","W","","5-8",TRUE,"New York Jets",24,14,25,375,275,100,2,10,182,123,59,1,2008-12-07,-1,1,"sfo",10
"15","Sun","December 14","L","","5-9",FALSE,"Miami Dolphins",9,14,24,318,206,112,0,11,248,150,98,0,2008-12-14,0,0,"sfo",-5
"16","Sun","December 21","W","","6-9",FALSE,"St. Louis Rams",17,16,15,273,190,83,4,21,343,214,129,1,2008-12-21,-3,1,"sfo",1
"17","Sun","December 28","W","","7-9",TRUE,"Washington Redskins",27,24,19,359,238,121,1,19,268,143,125,1,2008-12-28,0,1,"sfo",3
"1","Sun","September 13","W","","1-0",FALSE,"Arizona Cardinals",20,16,13,203,182,21,1,17,299,259,40,2,2009-09-13,1,1,"sfo",4
"2","Sun","September 20","W","","2-0",TRUE,"Seattle Seahawks",23,10,16,379,123,256,0,19,283,217,66,1,2009-09-20,1,1,"sfo",13
"3","Sun","September 27","L","","2-1",FALSE,"Minnesota Vikings",24,27,13,246,188,58,1,19,377,283,94,1,2009-09-27,0,0,"sfo",-3
"4","Sun","October 4","W","","3-1",TRUE,"St. Louis Rams",35,0,13,228,132,96,0,9,177,82,95,3,2009-10-04,3,1,"sfo",35
"5","Sun","October 11","L","","3-2",TRUE,"Atlanta Falcons",10,45,13,279,179,100,3,28,477,329,148,2,2009-10-11,-1,0,"sfo",-35
"7","Sun","October 25","L","","3-3",FALSE,"Houston Texans",21,24,17,297,238,59,2,18,336,246,90,1,2009-10-25,-1,0,"sfo",-3
"8","Sun","November 1","L","","3-4",FALSE,"Indianapolis Colts",14,18,16,295,182,113,2,20,410,349,61,0,2009-11-01,-2,0,"sfo",-4
"9","Sun","November 8","L","","3-5",TRUE,"Tennessee Titans",27,34,25,358,250,108,4,14,315,163,152,0,2009-11-08,-4,0,"sfo",-7
"10","Thu","November 12","W","","4-5",TRUE,"Chicago Bears",10,6,12,216,106,110,1,19,350,307,43,5,2009-11-12,4,1,"sfo",4
"11","Sun","November 22","L","","4-6",FALSE,"Green Bay Packers",24,30,11,284,215,69,1,26,484,326,158,0,2009-11-22,-1,0,"sfo",-6
"12","Sun","November 29","W","","5-6",TRUE,"Jacksonville Jaguars",20,3,15,284,232,52,0,18,357,261,96,2,2009-11-29,2,1,"sfo",17
"13","Sun","December 6","L","","5-7",FALSE,"Seattle Seahawks",17,20,14,356,303,53,2,17,292,185,107,1,2009-12-06,-1,0,"sfo",-3
"14","Mon","December 14","W","","6-7",TRUE,"Arizona Cardinals",24,9,18,327,138,189,2,11,245,160,85,7,2009-12-14,5,1,"sfo",15
"15","Sun","December 20","L","","6-8",FALSE,"Philadelphia Eagles",13,27,13,261,154,107,4,21,422,306,116,2,2009-12-20,-2,0,"sfo",-14
"16","Sun","December 27","W","","7-8",TRUE,"Detroit Lions",20,6,13,310,226,84,1,16,289,175,114,6,2009-12-27,5,1,"sfo",14
"17","Sun","January 3","W","","8-8",FALSE,"St. Louis Rams",28,6,16,329,204,125,0,6,109,22,87,0,2010-01-03,0,1,"sfo",22
"1","Sun","September 12","L","","0-1",FALSE,"Seattle Seahawks",6,31,14,263,214,49,2,14,242,165,77,1,2010-09-12,-1,0,"sfo",-25
"2","Mon","September 20","L","","0-2",TRUE,"New Orleans Saints",22,25,24,417,275,142,4,17,287,237,50,0,2010-09-20,-4,0,"sfo",-3
"3","Sun","September 26","L","","0-3",FALSE,"Kansas City Chiefs",10,31,11,251,208,43,1,21,457,250,207,1,2010-09-26,0,0,"sfo",-21
"4","Sun","October 3","L","","0-4",FALSE,"Atlanta Falcons",14,16,17,262,181,81,3,23,357,259,98,2,2010-10-03,-1,0,"sfo",-2
"5","Sun","October 10","L","","0-5",TRUE,"Philadelphia Eagles",24,27,21,364,290,74,5,17,352,227,125,1,2010-10-10,-4,0,"sfo",-3
"6","Sun","October 17","W","","1-5",TRUE,"Oakland Raiders",17,9,17,349,191,158,0,10,179,69,110,2,2010-10-17,2,1,"sfo",8
"7","Sun","October 24","L","","1-6",FALSE,"Carolina Panthers",20,23,15,282,183,99,1,22,379,303,76,3,2010-10-24,2,0,"sfo",-3
"8","Sun","October 31","W","","2-6",TRUE,"Denver Broncos",24,16,16,339,196,143,0,22,398,339,59,2,2010-10-31,2,1,"sfo",8
"10","Sun","November 14","W","OT","3-6",TRUE,"St. Louis Rams",23,20,19,421,323,98,0,22,332,228,104,0,2010-11-14,0,1,"sfo",3
"11","Sun","November 21","L","","3-7",TRUE,"Tampa Bay Buccaneers",0,21,11,189,118,71,2,20,299,137,162,0,2010-11-21,-2,0,"sfo",-21
"12","Mon","November 29","W","","4-7",FALSE,"Arizona Cardinals",27,6,26,386,125,261,1,8,203,190,13,2,2010-11-29,1,1,"sfo",21
"13","Sun","December 5","L","","4-8",FALSE,"Green Bay Packers",16,34,11,269,172,97,1,21,410,274,136,0,2010-12-05,-1,0,"sfo",-18
"14","Sun","December 12","W","","5-8",TRUE,"Seattle Seahawks",40,21,10,336,241,95,0,20,361,277,84,5,2010-12-12,5,1,"sfo",19
"15","Thu","December 16","L","","5-9",FALSE,"San Diego Chargers",7,34,11,192,131,61,1,24,374,266,108,0,2010-12-16,-1,0,"sfo",-27
"16","Sun","December 26","L","","5-10",FALSE,"St. Louis Rams",17,25,12,331,246,85,2,19,335,275,60,1,2010-12-26,-1,0,"sfo",-8
"17","Sun","January 2","W","","6-10",TRUE,"Arizona Cardinals",38,7,16,362,262,100,0,19,279,201,78,2,2011-01-02,2,1,"sfo",31
"1","Sun","September 11","W","","1-0",TRUE,"Seattle Seahawks",33,17,12,209,124,85,0,18,219,155,64,3,2011-09-11,3,1,"sfo",16
"2","Sun","September 18","L","OT","1-1",TRUE,"Dallas Cowboys",24,27,14,206,132,74,1,20,472,427,45,2,2011-09-18,1,0,"sfo",-3
"3","Sun","September 25","W","","2-1",FALSE,"Cincinnati Bengals",13,8,16,226,176,50,1,14,228,149,79,3,2011-09-25,2,1,"sfo",5
"4","Sun","October 2","W","","3-1",FALSE,"Philadelphia Eagles",24,23,22,442,278,164,1,23,513,405,108,3,2011-10-02,2,1,"sfo",1
"5","Sun","October 9","W","","4-1",TRUE,"Tampa Bay Buccaneers",48,3,28,418,205,213,1,14,272,186,86,3,2011-10-09,2,1,"sfo",45
"6","Sun","October 16","W","","5-1",FALSE,"Detroit Lions",25,19,14,314,111,203,2,21,310,244,66,0,2011-10-16,-2,1,"sfo",6
"8","Sun","October 30","W","","6-1",TRUE,"Cleveland Browns",20,10,19,348,174,174,0,18,290,224,66,2,2011-10-30,2,1,"sfo",10
"9","Sun","November 6","W","","7-1",FALSE,"Washington Redskins",19,11,15,326,188,138,1,17,303,251,52,3,2011-11-06,2,1,"sfo",8
"10","Sun","November 13","W","","8-1",TRUE,"New York Giants",27,20,16,305,228,77,1,21,395,302,93,2,2011-11-13,1,1,"sfo",7
"11","Sun","November 20","W","","9-1",TRUE,"Arizona Cardinals",23,7,25,431,267,164,1,11,229,149,80,5,2011-11-20,4,1,"sfo",16
"12","Thu","November 24","L","","9-2",FALSE,"Baltimore Ravens",6,16,12,170,96,74,1,16,253,161,92,0,2011-11-24,-1,0,"sfo",-10
"13","Sun","December 4","W","","10-2",TRUE,"St. Louis Rams",26,0,18,389,245,144,0,10,157,126,31,2,2011-12-04,2,1,"sfo",26
"14","Sun","December 11","L","","10-3",FALSE,"Arizona Cardinals",19,21,12,233,143,90,0,12,325,270,55,3,2011-12-11,3,0,"sfo",-2
"15","Mon","December 19","W","","11-3",TRUE,"Pittsburgh Steelers",20,3,17,287,187,100,0,20,389,305,84,4,2011-12-19,4,1,"sfo",17
"16","Sat","December 24","W","","12-3",FALSE,"Seattle Seahawks",19,17,21,349,171,178,0,14,265,141,124,1,2011-12-24,1,1,"sfo",2
"17","Sun","January 1","W","","13-3",FALSE,"St. Louis Rams",34,27,21,321,205,116,0,18,311,200,111,2,2012-01-01,2,1,"sfo",7
"Division","Sat","January 14","W","","14-3",TRUE,"New Orleans Saints",36,32,17,407,264,143,1,26,472,435,37,5,2012-01-14,4,1,"sfo",4
"ConfChamp","Sun","January 22","L","OT","14-4",TRUE,"New York Giants",17,20,15,328,178,150,2,20,352,267,85,0,2012-01-22,-2,0,"sfo",-3
"1","Sun","September 8","W","","1-0",FALSE,"Cincinnati Bengals",28,24,20,297,206,91,0,19,344,193,151,1,1985-09-08,1,1,"sea",4
"2","Sun","September 15","W","","2-0",FALSE,"San Diego Chargers",49,35,30,489,293,196,0,32,557,494,63,4,1985-09-15,4,1,"sea",14
"3","Mon","September 23","L","","2-1",TRUE,"Los Angeles Rams",24,35,17,314,270,44,5,19,357,187,170,5,1985-09-23,0,0,"sea",-11
"4","Sun","September 29","L","","2-2",FALSE,"Kansas City Chiefs",7,28,21,369,301,68,7,10,165,88,77,4,1985-09-29,-3,0,"sea",-21
"5","Sun","October 6","W","","3-2",TRUE,"San Diego Chargers",26,21,17,253,145,108,1,20,345,305,40,5,1985-10-06,4,1,"sea",5
"6","Sun","October 13","W","","4-2",TRUE,"Atlanta Falcons",30,26,22,421,358,63,3,20,350,187,163,1,1985-10-13,-2,1,"sea",4
"7","Sun","October 20","L","OT","4-3",FALSE,"Denver Broncos",10,13,17,249,77,172,5,14,246,148,98,0,1985-10-20,-5,0,"sea",-3
"8","Sun","October 27","L","","4-4",FALSE,"New York Jets",14,17,14,252,114,138,3,22,335,123,212,3,1985-10-27,0,0,"sea",-3
"9","Sun","November 3","W","","5-4",TRUE,"Los Angeles Raiders",33,3,15,234,133,101,1,18,282,131,151,5,1985-11-03,4,1,"sea",30
"10","Sun","November 10","W","","6-4",FALSE,"New Orleans Saints",27,3,17,346,256,90,1,12,183,96,87,1,1985-11-10,0,1,"sea",24
"11","Sun","November 17","L","","6-5",TRUE,"New England Patriots",13,20,19,324,189,135,4,14,285,198,87,2,1985-11-17,-2,0,"sea",-7
"12","Mon","November 25","L","","6-6",FALSE,"San Francisco 49ers",6,19,15,252,177,75,2,21,376,230,146,4,1985-11-25,2,0,"sea",-13
"13","Sun","December 1","W","","7-6",TRUE,"Kansas City Chiefs",24,6,22,337,243,94,3,11,201,149,52,3,1985-12-01,0,1,"sea",18
"14","Sun","December 8","W","","8-6",TRUE,"Cleveland Browns",31,13,21,338,246,92,1,16,306,214,92,4,1985-12-08,3,1,"sea",18
"15","Sun","December 15","L","","8-7",FALSE,"Los Angeles Raiders",3,13,12,201,150,51,4,16,349,195,154,2,1985-12-15,-2,0,"sea",-10
"16","Fri","December 20","L","","8-8",TRUE,"Denver Broncos",24,27,20,331,205,126,1,26,479,385,94,0,1985-12-20,-1,0,"sea",-3
"1","Sun","September 7","W","","1-0",TRUE,"Pittsburgh Steelers",30,0,20,374,172,202,2,9,146,61,85,5,1986-09-07,3,1,"sea",30
"2","Sun","September 14","W","","2-0",TRUE,"Kansas City Chiefs",23,17,19,331,203,128,1,13,265,167,98,3,1986-09-14,2,1,"sea",6
"3","Sun","September 21","W","","3-0",FALSE,"New England Patriots",38,31,12,303,183,120,0,24,506,386,120,1,1986-09-21,1,1,"sea",7
"4","Sun","September 28","L","","3-1",FALSE,"Washington Redskins",14,19,17,361,213,148,2,20,357,195,162,1,1986-09-28,-1,0,"sea",-5
"5","Mon","October 6","W","","4-1",TRUE,"San Diego Chargers",33,7,29,512,294,218,3,15,271,222,49,5,1986-10-06,2,1,"sea",26
"6","Sun","October 12","L","","4-2",FALSE,"Los Angeles Raiders",10,14,12,211,120,91,0,18,323,185,138,2,1986-10-12,2,0,"sea",-4
"7","Sun","October 19","W","","5-2",TRUE,"New York Giants",17,12,13,218,146,72,2,22,307,145,162,4,1986-10-19,2,1,"sea",5
"8","Sun","October 26","L","","5-3",FALSE,"Denver Broncos",13,20,13,214,50,164,0,24,450,332,118,2,1986-10-26,2,0,"sea",-7
"9","Sun","November 2","L","","5-4",TRUE,"New York Jets",7,38,16,322,271,51,3,22,553,427,126,0,1986-11-02,-3,0,"sea",-31
"10","Sun","November 9","L","","5-5",FALSE,"Kansas City Chiefs",7,27,8,133,108,25,3,24,375,248,127,4,1986-11-09,1,0,"sea",-20
"11","Sun","November 16","L","","5-6",FALSE,"Cincinnati Bengals",7,34,22,306,127,179,5,23,425,320,105,4,1986-11-16,-1,0,"sea",-27
"12","Sun","November 23","W","","6-6",TRUE,"Philadelphia Eagles",24,20,14,340,260,80,3,24,324,182,142,0,1986-11-23,-3,1,"sea",4
"13","Thu","November 27","W","","7-6",FALSE,"Dallas Cowboys",31,14,24,415,214,201,1,22,328,201,127,1,1986-11-27,0,1,"sea",17
"14","Mon","December 8","W","","8-6",TRUE,"Los Angeles Raiders",37,0,21,407,224,183,1,10,138,98,40,3,1986-12-08,2,1,"sea",37
"15","Sun","December 14","W","","9-6",FALSE,"San Diego Chargers",34,24,24,426,286,140,0,22,305,220,85,1,1986-12-14,1,1,"sea",10
"16","Sat","December 20","W","","10-6",TRUE,"Denver Broncos",41,16,27,536,238,298,1,18,268,193,75,0,1986-12-20,-1,1,"sea",25
"1","Sun","September 13","L","","0-1",FALSE,"Denver Broncos",17,40,15,277,169,108,5,25,504,338,166,2,1987-09-13,-3,0,"sea",-23
"2","Sun","September 20","W","","1-1",TRUE,"Kansas City Chiefs",43,14,23,360,137,223,0,12,182,107,75,5,1987-09-20,5,1,"sea",29
"3","Sun","October 4","W","","2-1",TRUE,"Miami Dolphins",24,20,20,402,326,76,3,19,324,160,164,2,1987-10-04,-1,1,"sea",4
"4","Sun","October 11","L","","2-2",TRUE,"Cincinnati Bengals",10,17,17,216,126,90,2,22,367,97,270,3,1987-10-11,1,0,"sea",-7
"5","Sun","October 18","W","","3-2",FALSE,"Detroit Lions",37,14,24,404,324,80,2,15,197,104,93,2,1987-10-18,0,1,"sea",23
"6","Sun","October 25","W","","4-2",FALSE,"Los Angeles Raiders",35,13,21,293,149,144,2,18,250,206,44,3,1987-10-25,1,1,"sea",22
"7","Sun","November 1","W","","5-2",TRUE,"Minnesota Vikings",28,17,19,318,195,123,1,23,395,252,143,2,1987-11-01,1,1,"sea",11
"8","Mon","November 9","L","","5-3",FALSE,"New York Jets",14,30,17,275,164,111,4,23,342,210,132,1,1987-11-09,-3,0,"sea",-16
"9","Sun","November 15","W","","6-3",TRUE,"Green Bay Packers",24,13,16,281,88,193,5,13,298,198,100,5,1987-11-15,0,1,"sea",11
"10","Sun","November 22","W","","7-3",TRUE,"San Diego Chargers",34,3,34,496,219,277,1,6,156,139,17,4,1987-11-22,3,1,"sea",31
"11","Mon","November 30","L","","7-4",TRUE,"Los Angeles Raiders",14,37,14,167,130,37,3,24,507,151,356,1,1987-11-30,-2,0,"sea",-23
"12","Sun","December 6","L","","7-5",FALSE,"Pittsburgh Steelers",9,13,16,215,80,135,2,18,308,99,209,0,1987-12-06,-2,0,"sea",-4
"13","Sun","December 13","W","","8-5",TRUE,"Denver Broncos",28,21,24,367,226,141,4,20,380,308,72,2,1987-12-13,-2,1,"sea",7
"14","Sun","December 20","W","","9-5",FALSE,"Chicago Bears",34,21,17,300,184,116,0,31,437,276,161,5,1987-12-20,5,1,"sea",13
"15","Sun","December 27","L","","9-6",FALSE,"Kansas City Chiefs",20,41,24,364,195,169,2,28,512,313,199,1,1987-12-27,-1,0,"sea",-21
"WildCard","Sun","January 3","L","OT","9-7",FALSE,"Houston Oilers",20,23,11,250,221,29,1,27,437,259,178,2,1988-01-03,1,0,"sea",-3
"1","Sun","September 4","W","","1-0",FALSE,"Denver Broncos",21,14,19,330,152,178,1,19,302,226,76,3,1988-09-04,2,1,"sea",7
"2","Sun","September 11","W","","2-0",TRUE,"Kansas City Chiefs",31,10,19,263,107,156,1,19,286,236,50,6,1988-09-11,5,1,"sea",21
"3","Sun","September 18","L","","2-1",FALSE,"San Diego Chargers",6,17,20,299,194,105,4,14,237,78,159,1,1988-09-18,-3,0,"sea",-11
"4","Sun","September 25","L","","2-2",TRUE,"San Francisco 49ers",7,38,8,154,125,29,5,27,580,341,239,1,1988-09-25,-4,0,"sea",-31
"5","Sun","October 2","W","","3-2",FALSE,"Atlanta Falcons",31,20,22,317,149,168,1,18,385,245,140,4,1988-10-02,3,1,"sea",11
"6","Sun","October 9","W","","4-2",FALSE,"Cleveland Browns",16,10,14,227,101,126,1,21,334,174,160,4,1988-10-09,3,1,"sea",6
"7","Sun","October 16","L","","4-3",TRUE,"New Orleans Saints",19,20,23,434,341,93,2,20,318,177,141,3,1988-10-16,1,0,"sea",-1
"8","Sun","October 23","L","","4-4",FALSE,"Los Angeles Rams",10,31,21,296,143,153,5,24,465,311,154,3,1988-10-23,-2,0,"sea",-21
"9","Sun","October 30","W","","5-4",TRUE,"San Diego Chargers",17,14,16,235,109,126,0,18,299,169,130,3,1988-10-30,3,1,"sea",3
"10","Sun","November 6","L","","5-5",TRUE,"Buffalo Bills",3,13,10,145,73,72,2,18,336,194,142,2,1988-11-06,0,0,"sea",-10
"11","Sun","November 13","W","","6-5",TRUE,"Houston Oilers",27,24,22,365,188,177,1,22,419,182,237,1,1988-11-13,0,1,"sea",3
"12","Sun","November 20","L","","6-6",FALSE,"Kansas City Chiefs",24,27,20,313,208,105,2,23,365,203,162,2,1988-11-20,0,0,"sea",-3
"13","Mon","November 28","W","","7-6",TRUE,"Los Angeles Raiders",35,27,25,459,212,247,5,15,257,144,113,2,1988-11-28,-3,1,"sea",8
"14","Sun","December 4","L","","7-7",FALSE,"New England Patriots",7,13,2,65,45,20,1,16,212,41,171,3,1988-12-04,2,0,"sea",-6
"15","Sun","December 11","W","","8-7",TRUE,"Denver Broncos",42,14,30,450,220,230,0,25,402,301,101,1,1988-12-11,1,1,"sea",28
"16","Sun","December 18","W","","9-7",FALSE,"Los Angeles Raiders",43,37,20,490,389,101,3,22,442,331,111,1,1988-12-18,-2,1,"sea",6
"Division","Sat","December 31","L","","9-8",FALSE,"Cincinnati Bengals",13,21,19,294,276,18,3,22,345,91,254,2,1988-12-31,-1,0,"sea",-8
"1","Sun","September 10","L","","0-1",FALSE,"Philadelphia Eagles",7,31,17,270,193,77,3,18,365,234,131,0,1989-09-10,-3,0,"sea",-24
"2","Sun","September 17","L","","0-2",TRUE,"Phoenix Cardinals",24,34,23,346,269,77,1,25,469,298,171,2,1989-09-17,1,0,"sea",-10
"3","Sun","September 24","W","","1-2",FALSE,"New England Patriots",24,3,20,316,159,157,0,13,219,128,91,3,1989-09-24,3,1,"sea",21
"4","Sun","October 1","W","","2-2",FALSE,"Los Angeles Raiders",24,20,25,354,194,160,2,16,311,197,114,2,1989-10-01,0,1,"sea",4
"5","Sun","October 8","L","","2-3",TRUE,"Kansas City Chiefs",16,20,16,288,236,52,2,17,303,104,199,1,1989-10-08,-1,0,"sea",-4
"6","Sun","October 15","W","","3-3",FALSE,"San Diego Chargers",17,16,15,224,139,85,3,26,362,263,99,4,1989-10-15,1,1,"sea",1
"7","Sun","October 22","L","OT","3-4",TRUE,"Denver Broncos",21,24,23,363,224,139,4,15,371,316,55,1,1989-10-22,-3,0,"sea",-3
"8","Sun","October 29","W","","4-4",TRUE,"San Diego Chargers",10,7,23,339,269,70,2,11,195,103,92,1,1989-10-29,-1,1,"sea",3
"9","Sun","November 5","L","","4-5",FALSE,"Kansas City Chiefs",10,20,10,129,90,39,4,18,315,69,246,2,1989-11-05,-2,0,"sea",-10
"10","Sun","November 12","L","","4-6",TRUE,"Cleveland Browns",7,17,14,180,134,46,3,20,277,138,139,0,1989-11-12,-3,0,"sea",-10
"11","Sun","November 19","L","","4-7",FALSE,"New York Giants",3,15,12,195,132,63,2,21,349,187,162,1,1989-11-19,-1,0,"sea",-12
"12","Sun","November 26","L","","4-8",FALSE,"Denver Broncos",14,41,21,325,192,133,4,18,353,216,137,0,1989-11-26,-4,0,"sea",-27
"13","Mon","December 4","W","","5-8",TRUE,"Buffalo Bills",17,16,22,355,277,78,2,11,232,135,97,2,1989-12-04,0,1,"sea",1
"14","Sun","December 10","W","","6-8",FALSE,"Cincinnati Bengals",24,17,15,361,252,109,1,23,365,215,150,1,1989-12-10,0,1,"sea",7
"15","Sun","December 17","W","","7-8",TRUE,"Los Angeles Raiders",23,17,22,350,268,82,0,15,273,175,98,1,1989-12-17,1,1,"sea",6
"16","Sat","December 23","L","","7-9",TRUE,"Washington Redskins",0,29,12,201,176,25,4,26,456,319,137,1,1989-12-23,-3,0,"sea",-29
"1","Sun","September 9","L","","0-1",FALSE,"Chicago Bears",0,17,6,132,74,58,3,21,366,195,171,1,1990-09-09,-2,0,"sea",-17
"2","Sun","September 16","L","","0-2",TRUE,"Los Angeles Raiders",13,17,23,344,222,122,1,16,326,235,91,0,1990-09-16,-1,0,"sea",-4
"3","Sun","September 23","L","OT","0-3",FALSE,"Denver Broncos",31,34,24,369,185,184,3,30,422,281,141,1,1990-09-23,-2,0,"sea",-3
"4","Mon","October 1","W","","1-3",TRUE,"Cincinnati Bengals",31,16,20,352,201,151,2,16,230,161,69,2,1990-10-01,0,1,"sea",15
"5","Sun","October 7","W","","2-3",FALSE,"New England Patriots",33,20,21,338,227,111,2,16,274,213,61,5,1990-10-07,3,1,"sea",13
"6","Sun","October 14","L","","2-4",FALSE,"Los Angeles Raiders",17,24,19,342,265,77,2,19,305,227,78,1,1990-10-14,-1,0,"sea",-7
"7","Sun","October 21","W","","3-4",TRUE,"Kansas City Chiefs",19,7,16,260,124,136,4,15,248,179,69,3,1990-10-21,-1,1,"sea",12
"9","Sun","November 4","L","","3-5",TRUE,"San Diego Chargers",14,31,17,194,129,65,3,15,289,145,144,0,1990-11-04,-3,0,"sea",-17
"10","Sun","November 11","W","","4-5",FALSE,"Kansas City Chiefs",17,16,13,297,236,61,2,16,229,115,114,0,1990-11-11,-2,1,"sea",1
"11","Sun","November 18","L","","4-6",TRUE,"Minnesota Vikings",21,24,17,233,132,101,1,14,302,161,141,1,1990-11-18,0,0,"sea",-3
"12","Sun","November 25","W","OT","5-6",FALSE,"San Diego Chargers",13,10,13,233,175,58,2,16,304,140,164,5,1990-11-25,3,1,"sea",3
"13","Sun","December 2","W","OT","6-6",TRUE,"Houston Oilers",13,10,20,281,158,123,1,19,276,220,56,3,1990-12-02,2,1,"sea",3
"14","Sun","December 9","W","","7-6",FALSE,"Green Bay Packers",20,14,14,291,133,158,2,19,252,239,13,1,1990-12-09,-1,1,"sea",6
"15","Sun","December 16","L","","7-7",FALSE,"Miami Dolphins",17,24,21,344,261,83,4,20,347,242,105,3,1990-12-16,-1,0,"sea",-7
"16","Sun","December 23","W","","8-7",TRUE,"Denver Broncos",17,12,13,213,103,110,1,16,246,145,101,2,1990-12-23,1,1,"sea",5
"17","Sun","December 30","W","","9-7",TRUE,"Detroit Lions",30,10,27,360,209,151,3,12,193,106,87,2,1990-12-30,-1,1,"sea",20
"1","Sun","September 1","L","","0-1",FALSE,"New Orleans Saints",24,27,19,348,302,46,4,13,244,201,43,3,1991-09-01,-1,0,"sea",-3
"2","Sun","September 8","W","","1-1",TRUE,"New York Jets",20,13,18,290,193,97,2,18,316,158,158,4,1991-09-08,2,1,"sea",7
"3","Sun","September 15","L","","1-2",FALSE,"Denver Broncos",10,16,17,362,312,50,4,16,345,246,99,2,1991-09-15,-2,0,"sea",-6
"4","Sun","September 22","L","","1-3",FALSE,"Kansas City Chiefs",13,20,24,378,208,170,4,16,312,214,98,0,1991-09-22,-4,0,"sea",-7
"5","Sun","September 29","W","","2-3",TRUE,"Indianapolis Colts",31,3,16,251,83,168,3,9,137,95,42,3,1991-09-29,0,1,"sea",28
"6","Sun","October 6","W","","3-3",FALSE,"Cincinnati Bengals",13,7,15,305,202,103,3,20,364,240,124,5,1991-10-06,2,1,"sea",6
"7","Sun","October 13","L","OT","3-4",TRUE,"Los Angeles Raiders",20,23,12,264,145,119,3,25,420,274,146,5,1991-10-13,2,0,"sea",-3
"8","Sun","October 20","W","","4-4",FALSE,"Pittsburgh Steelers",27,7,18,324,259,65,0,12,240,162,78,3,1991-10-20,3,1,"sea",20
"9","Sun","October 27","W","","5-4",TRUE,"San Diego Chargers",20,9,15,202,127,75,2,19,320,192,128,0,1991-10-27,-2,1,"sea",11
"11","Sun","November 10","L","","5-5",FALSE,"San Diego Chargers",14,17,18,387,350,37,3,16,315,213,102,0,1991-11-10,-3,0,"sea",-3
"12","Sun","November 17","L","","5-6",FALSE,"Los Angeles Raiders",7,31,13,185,162,23,1,20,342,226,116,1,1991-11-17,0,0,"sea",-24
"13","Sun","November 24","W","","6-6",TRUE,"Denver Broncos",13,10,11,199,53,146,4,12,210,112,98,4,1991-11-24,0,1,"sea",3
"14","Sun","December 1","L","","6-7",TRUE,"Kansas City Chiefs",6,19,13,273,226,47,2,21,311,154,157,0,1991-12-01,-2,0,"sea",-13
"15","Sun","December 8","L","","6-8",TRUE,"San Francisco 49ers",22,24,17,278,128,150,2,19,329,261,68,5,1991-12-08,3,0,"sea",-2
"16","Sun","December 15","L","","6-9",FALSE,"Atlanta Falcons",13,26,14,235,202,33,3,14,271,140,131,1,1991-12-15,-2,0,"sea",-13
"17","Sun","December 22","W","","7-9",TRUE,"Los Angeles Rams",23,9,13,253,156,97,3,12,227,131,96,3,1991-12-22,0,1,"sea",14
"1","Sun","September 6","L","","0-1",TRUE,"Cincinnati Bengals",3,21,18,202,110,92,2,18,269,102,167,2,1992-09-06,0,0,"sea",-18
"2","Sun","September 13","L","","0-2",FALSE,"Kansas City Chiefs",7,26,11,189,98,91,4,16,321,206,115,1,1992-09-13,-3,0,"sea",-19
"3","Sun","September 20","W","","1-2",FALSE,"New England Patriots",10,6,14,250,110,140,0,16,245,146,99,3,1992-09-20,3,1,"sea",4
"4","Sun","September 27","L","","1-3",TRUE,"Miami Dolphins",17,19,14,221,135,86,2,18,314,255,59,4,1992-09-27,2,0,"sea",-2
"5","Sun","October 4","L","","1-4",FALSE,"San Diego Chargers",6,17,11,180,70,110,3,17,302,195,107,0,1992-10-04,-3,0,"sea",-11
"6","Sun","October 11","L","","1-5",FALSE,"Dallas Cowboys",0,27,6,62,24,38,3,16,313,197,116,2,1992-10-11,-1,0,"sea",-27
"7","Sun","October 18","L","","1-6",TRUE,"Los Angeles Raiders",0,19,14,237,196,41,2,11,248,69,179,1,1992-10-18,-1,0,"sea",-19
"8","Sun","October 25","L","","1-7",FALSE,"New York Giants",10,23,12,186,108,78,2,13,261,85,176,2,1992-10-25,0,0,"sea",-13
"10","Sun","November 8","L","","1-8",TRUE,"Washington Redskins",3,16,9,183,59,124,3,15,330,242,88,1,1992-11-08,-2,0,"sea",-13
"11","Sun","November 15","L","","1-9",FALSE,"Los Angeles Raiders",3,20,10,159,46,113,2,12,188,88,100,1,1992-11-15,-1,0,"sea",-17
"12","Sun","November 22","L","","1-10",TRUE,"Kansas City Chiefs",14,24,20,310,129,181,6,11,190,73,117,0,1992-11-22,-6,0,"sea",-10
"13","Mon","November 30","W","OT","2-10",TRUE,"Denver Broncos",16,13,15,308,234,74,4,10,196,112,84,2,1992-11-30,-2,1,"sea",3
"14","Sun","December 6","L","","2-11",FALSE,"Pittsburgh Steelers",14,20,10,220,153,67,2,16,306,168,138,5,1992-12-06,3,0,"sea",-6
"15","Sun","December 13","L","OT","2-12",TRUE,"Philadelphia Eagles",17,20,11,87,24,63,2,25,466,276,190,2,1992-12-13,0,0,"sea",-3
"16","Sun","December 20","L","","2-13",FALSE,"Denver Broncos",6,10,16,222,80,142,2,15,293,204,89,5,1992-12-20,3,0,"sea",-4
"17","Sun","December 27","L","","2-14",TRUE,"San Diego Chargers",14,31,17,358,202,156,2,18,341,243,98,0,1992-12-27,-2,0,"sea",-17
"1","Sun","September 5","L","","0-1",FALSE,"San Diego Chargers",12,18,15,230,141,89,2,19,269,109,160,2,1993-09-05,0,0,"sea",-6
"2","Sun","September 12","L","","0-2",TRUE,"Los Angeles Raiders",13,17,14,232,120,112,3,16,264,181,83,1,1993-09-12,-2,0,"sea",-4
"3","Sun","September 19","W","","1-2",FALSE,"New England Patriots",17,14,23,334,125,209,3,19,274,223,51,3,1993-09-19,0,1,"sea",3
"4","Sun","September 26","W","","2-2",FALSE,"Cincinnati Bengals",19,10,17,305,166,139,2,19,354,324,30,3,1993-09-26,1,1,"sea",9
"5","Sun","October 3","W","","3-2",TRUE,"San Diego Chargers",31,14,24,344,287,57,0,19,315,221,94,2,1993-10-03,2,1,"sea",17
"7","Sun","October 17","L","","3-3",FALSE,"Detroit Lions",10,30,16,232,166,66,4,20,292,151,141,2,1993-10-17,-2,0,"sea",-20
"8","Sun","October 24","W","","4-3",TRUE,"New England Patriots",10,9,15,261,194,67,2,16,295,129,166,2,1993-10-24,0,1,"sea",1
"9","Sun","October 31","L","","4-4",FALSE,"Denver Broncos",17,28,19,287,184,103,2,25,326,239,87,1,1993-10-31,-1,0,"sea",-11
"10","Sun","November 7","L","","4-5",FALSE,"Houston Oilers",14,24,14,252,168,84,1,26,458,347,111,2,1993-11-07,1,0,"sea",-10
"11","Sun","November 14","W","","5-5",TRUE,"Cleveland Browns",22,5,12,223,104,119,0,13,232,57,175,7,1993-11-14,7,1,"sea",17
"13","Sun","November 28","L","","5-6",TRUE,"Denver Broncos",9,17,13,288,161,127,2,19,307,206,101,2,1993-11-28,0,0,"sea",-8
"14","Sun","December 5","L","","5-7",TRUE,"Kansas City Chiefs",16,31,16,365,275,90,4,23,337,231,106,0,1993-12-05,-4,0,"sea",-15
"15","Sun","December 12","L","","5-8",FALSE,"Los Angeles Raiders",23,27,21,303,169,134,1,18,362,303,59,2,1993-12-12,1,0,"sea",-4
"16","Sun","December 19","L","OT","5-9",TRUE,"Phoenix Cardinals",27,30,19,365,153,212,1,26,476,405,71,4,1993-12-19,3,0,"sea",-3
"17","Sun","December 26","W","","6-9",TRUE,"Pittsburgh Steelers",16,6,25,368,101,267,1,18,380,264,116,2,1993-12-26,1,1,"sea",10
"18","Sun","January 2","L","","6-10",FALSE,"Kansas City Chiefs",24,34,16,280,140,140,3,26,372,263,109,2,1994-01-02,-1,0,"sea",-10
"1","Sun","September 4","W","","1-0",FALSE,"Washington Redskins",28,7,23,360,176,184,0,17,258,224,34,3,1994-09-04,3,1,"sea",21
"2","Sun","September 11","W","","2-0",FALSE,"Los Angeles Raiders",38,9,22,332,235,97,1,20,297,198,99,4,1994-09-11,3,1,"sea",29
"3","Sun","September 18","L","","2-1",TRUE,"San Diego Chargers",10,24,23,187,128,59,2,18,346,251,95,2,1994-09-18,0,0,"sea",-14
"4","Sun","September 25","W","","3-1",TRUE,"Pittsburgh Steelers",30,13,20,297,152,145,1,29,452,321,131,4,1994-09-25,3,1,"sea",17
"5","Sun","October 2","L","","3-2",FALSE,"Indianapolis Colts",15,17,17,276,174,102,1,14,287,168,119,1,1994-10-02,0,0,"sea",-2
"6","Sun","October 9","L","","3-3",TRUE,"Denver Broncos",9,16,16,338,244,94,5,19,278,128,150,0,1994-10-09,-5,0,"sea",-7
"8","Sun","October 23","L","","3-4",FALSE,"Kansas City Chiefs",23,38,16,263,96,167,2,24,477,305,172,0,1994-10-23,-2,0,"sea",-15
"9","Sun","October 30","L","","3-5",FALSE,"San Diego Chargers",15,35,14,283,171,112,2,25,348,187,161,1,1994-10-30,-1,0,"sea",-20
"10","Sun","November 6","L","OT","3-6",TRUE,"Cincinnati Bengals",17,20,21,318,170,148,1,23,496,377,119,2,1994-11-06,1,0,"sea",-3
"11","Sun","November 13","L","","3-7",FALSE,"Denver Broncos",10,17,14,289,131,158,1,21,297,128,169,2,1994-11-13,1,0,"sea",-7
"12","Sun","November 20","W","","4-7",TRUE,"Tampa Bay Buccaneers",22,21,18,294,117,177,3,23,332,212,120,2,1994-11-20,-1,1,"sea",1
"13","Sun","November 27","W","","5-7",TRUE,"Kansas City Chiefs",10,9,12,266,207,59,0,18,312,197,115,2,1994-11-27,2,1,"sea",1
"14","Sun","December 4","L","","5-8",TRUE,"Indianapolis Colts",19,31,15,238,131,107,5,14,288,105,183,4,1994-12-04,-1,0,"sea",-12
"15","Sun","December 11","W","","6-8",FALSE,"Houston Oilers",16,14,21,330,64,266,1,14,208,145,63,2,1994-12-11,1,1,"sea",2
"16","Sun","December 18","L","","6-9",TRUE,"Los Angeles Raiders",16,17,15,280,155,125,0,16,322,206,116,0,1994-12-18,0,0,"sea",-1
"17","Sat","December 24","L","","6-10",FALSE,"Cleveland Browns",9,35,18,301,217,84,3,23,351,245,106,1,1994-12-24,-2,0,"sea",-26
"1","Sun","September 3","L","","0-1",TRUE,"Kansas City Chiefs",10,34,20,342,264,78,2,17,419,278,141,0,1995-09-03,-2,0,"sea",-24
"2","Sun","September 10","L","","0-2",FALSE,"San Diego Chargers",10,14,15,209,127,82,2,25,397,251,146,2,1995-09-10,0,0,"sea",-4
"3","Sun","September 17","W","","1-2",TRUE,"Cincinnati Bengals",24,21,24,406,263,143,1,18,401,291,110,1,1995-09-17,0,1,"sea",3
"5","Sun","October 1","W","","2-2",TRUE,"Denver Broncos",27,10,26,422,192,230,0,18,318,243,75,1,1995-10-01,1,1,"sea",17
"6","Sun","October 8","L","","2-3",FALSE,"Oakland Raiders",14,34,19,343,227,116,2,24,530,335,195,0,1995-10-08,-2,0,"sea",-20
"7","Sun","October 15","L","","2-4",FALSE,"Buffalo Bills",21,27,16,268,190,78,4,23,374,259,115,0,1995-10-15,-4,0,"sea",-6
"8","Sun","October 22","L","","2-5",TRUE,"San Diego Chargers",25,35,24,383,233,150,4,15,299,146,153,1,1995-10-22,-3,0,"sea",-10
"9","Sun","October 29","L","OT","2-6",FALSE,"Arizona Cardinals",14,20,17,428,198,230,7,20,305,190,115,4,1995-10-29,-3,0,"sea",-6
"10","Sun","November 5","W","","3-6",TRUE,"New York Giants",30,28,24,386,248,138,2,26,403,286,117,0,1995-11-05,-2,1,"sea",2
"11","Sun","November 12","W","","4-6",FALSE,"Jacksonville Jaguars",47,30,26,481,235,246,1,20,266,105,161,2,1995-11-12,1,1,"sea",17
"12","Sun","November 19","W","","5-6",FALSE,"Washington Redskins",27,20,21,340,173,167,2,20,348,281,67,5,1995-11-19,3,1,"sea",7
"13","Sun","November 26","L","","5-7",TRUE,"New York Jets",10,16,14,192,118,74,3,17,255,143,112,1,1995-11-26,-2,0,"sea",-6
"14","Sun","December 3","W","","6-7",TRUE,"Philadelphia Eagles",26,14,20,316,149,167,0,17,269,200,69,1,1995-12-03,1,1,"sea",12
"15","Sun","December 10","W","","7-7",FALSE,"Denver Broncos",31,27,19,326,192,134,2,25,388,148,240,5,1995-12-10,3,1,"sea",4
"16","Sun","December 17","W","","8-7",TRUE,"Oakland Raiders",44,10,18,339,220,119,0,15,322,182,140,1,1995-12-17,1,1,"sea",34
"17","Sun","December 24","L","","8-8",FALSE,"Kansas City Chiefs",3,26,8,89,63,26,0,21,375,201,174,1,1995-12-24,1,0,"sea",-23
"1","Sun","September 1","L","","0-1",FALSE,"San Diego Chargers",7,29,16,357,251,106,4,27,377,191,186,0,1996-09-01,-4,0,"sea",-22
"2","Sun","September 8","L","","0-2",TRUE,"Denver Broncos",20,30,10,211,172,39,3,22,374,194,180,1,1996-09-08,-2,0,"sea",-10
"3","Sun","September 15","L","","0-3",TRUE,"Kansas City Chiefs",17,35,17,238,141,97,1,24,323,166,157,2,1996-09-15,1,0,"sea",-18
"4","Sun","September 22","W","","1-3",FALSE,"Tampa Bay Buccaneers",17,13,22,322,198,124,1,14,217,106,111,1,1996-09-22,0,1,"sea",4
"5","Sun","September 29","L","","1-4",TRUE,"Green Bay Packers",10,31,19,329,170,159,5,23,344,202,142,0,1996-09-29,-5,0,"sea",-21
"6","Sun","October 6","W","","2-4",FALSE,"Miami Dolphins",22,15,12,358,299,59,3,17,299,214,85,3,1996-10-06,0,1,"sea",7
"8","Thu","October 17","L","","2-5",FALSE,"Kansas City Chiefs",16,34,18,323,213,110,1,27,340,194,146,1,1996-10-17,0,0,"sea",-18
"9","Sun","October 27","W","","3-5",TRUE,"San Diego Chargers",32,13,18,404,196,208,1,15,322,253,69,5,1996-10-27,4,1,"sea",19
"10","Sun","November 3","W","","4-5",TRUE,"Houston Oilers",23,16,19,342,310,32,1,13,353,225,128,1,1996-11-03,0,1,"sea",7
"11","Sun","November 10","W","","5-5",TRUE,"Minnesota Vikings",42,23,26,452,253,199,1,16,315,300,15,4,1996-11-10,3,1,"sea",19
"12","Sun","November 17","L","","5-6",FALSE,"Detroit Lions",16,17,24,378,194,184,1,17,285,141,144,1,1996-11-17,0,0,"sea",-1
"13","Sun","November 24","L","","5-7",TRUE,"Oakland Raiders",21,27,17,296,166,130,1,19,349,149,200,1,1996-11-24,0,0,"sea",-6
"14","Sun","December 1","L","","5-8",FALSE,"Denver Broncos",7,34,13,277,172,105,3,31,441,236,205,0,1996-12-01,-3,0,"sea",-27
"15","Sun","December 8","W","","6-8",TRUE,"Buffalo Bills",26,18,10,302,132,170,0,21,391,312,79,5,1996-12-08,5,1,"sea",8
"16","Sun","December 15","L","","6-9",FALSE,"Jacksonville Jaguars",13,20,19,306,147,159,1,18,351,218,133,0,1996-12-15,-1,0,"sea",-7
"17","Sun","December 22","W","","7-9",FALSE,"Oakland Raiders",28,21,8,129,13,116,2,21,356,238,118,7,1996-12-22,5,1,"sea",7
"1","Sun","August 31","L","","0-1",TRUE,"New York Jets",3,41,16,247,163,84,2,28,434,270,164,0,1997-08-31,-2,0,"sea",-38
"2","Sun","September 7","L","","0-2",TRUE,"Denver Broncos",14,35,16,289,220,69,1,22,331,188,143,1,1997-09-07,0,0,"sea",-21
"3","Sun","September 14","W","","1-2",FALSE,"Indianapolis Colts",31,3,27,423,270,153,1,11,118,23,95,0,1997-09-14,-1,1,"sea",28
"4","Sun","September 21","W","","2-2",TRUE,"San Diego Chargers",26,22,21,343,251,92,3,20,309,230,79,3,1997-09-21,0,1,"sea",4
"5","Sun","September 28","L","OT","2-3",FALSE,"Kansas City Chiefs",17,20,16,376,220,156,1,29,466,263,203,3,1997-09-28,2,0,"sea",-3
"6","Sun","October 5","W","","3-3",TRUE,"Tennessee Oilers",16,13,20,405,238,167,2,18,253,97,156,2,1997-10-05,0,1,"sea",3
"8","Sun","October 19","W","","4-3",FALSE,"St. Louis Rams",17,9,27,357,251,106,2,10,192,155,37,1,1997-10-19,-1,1,"sea",8
"9","Sun","October 26","W","","5-3",TRUE,"Oakland Raiders",45,34,26,554,409,145,2,19,354,235,119,1,1997-10-26,-1,1,"sea",11
"10","Sun","November 2","L","","5-4",FALSE,"Denver Broncos",27,30,22,349,245,104,2,19,385,245,140,2,1997-11-02,0,0,"sea",-3
"11","Sun","November 9","W","","6-4",FALSE,"San Diego Chargers",37,31,24,373,281,92,2,13,260,179,81,2,1997-11-09,0,1,"sea",6
"12","Sun","November 16","L","OT","6-5",FALSE,"New Orleans Saints",17,20,19,340,229,111,4,14,177,102,75,5,1997-11-16,1,0,"sea",-3
"13","Sun","November 23","L","","6-6",TRUE,"Kansas City Chiefs",14,19,18,291,223,68,3,22,324,204,120,2,1997-11-23,-1,0,"sea",-5
"14","Sun","November 30","L","","6-7",TRUE,"Atlanta Falcons",17,24,19,351,228,123,1,14,273,201,72,0,1997-11-30,-1,0,"sea",-7
"15","Sun","December 7","L","","6-8",FALSE,"Baltimore Ravens",24,31,14,273,170,103,4,15,374,286,88,3,1997-12-07,-1,0,"sea",-7
"16","Sun","December 14","W","","7-8",FALSE,"Oakland Raiders",22,21,22,381,278,103,2,15,275,241,34,2,1997-12-14,0,1,"sea",1
"17","Sun","December 21","W","","8-8",TRUE,"San Francisco 49ers",38,9,24,407,283,124,0,17,324,199,125,2,1997-12-21,2,1,"sea",29
"1","Sun","September 6","W","","1-0",FALSE,"Philadelphia Eagles",38,0,18,406,218,188,0,14,174,12,162,3,1998-09-06,3,1,"sea",38
"2","Sun","September 13","W","","2-0",TRUE,"Arizona Cardinals",33,14,16,244,121,123,2,17,274,163,111,4,1998-09-13,2,1,"sea",19
"3","Sun","September 20","W","","3-0",TRUE,"Washington Redskins",24,14,16,299,136,163,0,27,465,369,96,3,1998-09-20,3,1,"sea",10
"4","Sun","September 27","L","","3-1",FALSE,"Pittsburgh Steelers",10,13,14,230,169,61,4,16,285,100,185,0,1998-09-27,-4,0,"sea",-3
"5","Sun","October 4","L","","3-2",FALSE,"Kansas City Chiefs",6,17,10,167,94,73,4,12,251,120,131,5,1998-10-04,1,0,"sea",-11
"6","Sun","October 11","L","","3-3",TRUE,"Denver Broncos",16,21,16,319,242,77,1,17,373,171,202,2,1998-10-11,1,0,"sea",-5
"8","Sun","October 25","W","","4-3",FALSE,"San Diego Chargers",27,20,14,274,234,40,0,27,391,280,111,0,1998-10-25,0,1,"sea",7
"9","Sun","November 1","L","","4-4",TRUE,"Oakland Raiders",18,31,22,333,253,80,5,14,293,220,73,1,1998-11-01,-4,0,"sea",-13
"10","Sun","November 8","W","","5-4",TRUE,"Kansas City Chiefs",24,12,16,202,94,108,2,24,357,260,97,4,1998-11-08,2,1,"sea",12
"11","Sun","November 15","L","","5-5",FALSE,"Oakland Raiders",17,20,15,293,192,101,3,21,380,249,131,3,1998-11-15,0,0,"sea",-3
"12","Sun","November 22","L","","5-6",FALSE,"Dallas Cowboys",22,30,17,249,183,66,2,29,465,292,173,1,1998-11-22,-1,0,"sea",-8
"13","Sun","November 29","W","","6-6",TRUE,"Tennessee Oilers",20,18,20,378,296,82,3,23,343,179,164,2,1998-11-29,-1,1,"sea",2
"14","Sun","December 6","L","","6-7",FALSE,"New York Jets",31,32,13,377,271,106,4,31,488,418,70,3,1998-12-06,-1,0,"sea",-1
"15","Sun","December 13","W","","7-7",TRUE,"San Diego Chargers",38,17,18,238,130,108,3,16,277,211,66,8,1998-12-13,5,1,"sea",21
"16","Sun","December 20","W","","8-7",TRUE,"Indianapolis Colts",27,23,23,376,150,226,0,18,362,330,32,2,1998-12-20,2,1,"sea",4
"17","Sun","December 27","L","","8-8",FALSE,"Denver Broncos",21,28,19,241,217,24,1,31,511,316,195,1,1998-12-27,0,0,"sea",-7
"1","Sun","September 12","L","","0-1",TRUE,"Detroit Lions",20,28,16,205,174,31,2,19,369,202,167,1,1999-09-12,-1,0,"sea",-8
"2","Sun","September 19","W","","1-1",FALSE,"Chicago Bears",14,13,19,349,249,100,3,20,311,196,115,1,1999-09-19,-2,1,"sea",1
"3","Sun","September 26","W","","2-1",FALSE,"Pittsburgh Steelers",29,10,16,341,251,90,2,15,272,207,65,5,1999-09-26,3,1,"sea",19
"4","Sun","October 3","W","","3-1",TRUE,"Oakland Raiders",22,21,15,276,201,75,1,21,383,217,166,1,1999-10-03,0,1,"sea",1
"6","Sun","October 17","L","","3-2",FALSE,"San Diego Chargers",10,13,15,201,140,61,1,19,330,281,49,4,1999-10-17,3,0,"sea",-3
"7","Sun","October 24","W","","4-2",TRUE,"Buffalo Bills",26,16,18,385,275,110,0,25,352,254,98,3,1999-10-24,3,1,"sea",10
"8","Mon","November 1","W","","5-2",FALSE,"Green Bay Packers",27,7,12,222,90,132,2,17,307,182,125,7,1999-11-01,5,1,"sea",20
"9","Sun","November 7","W","","6-2",TRUE,"Cincinnati Bengals",37,20,26,360,187,173,2,19,397,294,103,2,1999-11-07,0,1,"sea",17
"10","Sun","November 14","W","","7-2",TRUE,"Denver Broncos",20,17,14,271,230,41,2,18,323,236,87,1,1999-11-14,-1,1,"sea",3
"11","Sun","November 21","W","","8-2",FALSE,"Kansas City Chiefs",31,19,20,368,235,133,2,22,371,295,76,2,1999-11-21,0,1,"sea",12
"12","Sun","November 28","L","","8-3",TRUE,"Tampa Bay Buccaneers",3,16,15,259,170,89,6,9,156,51,105,0,1999-11-28,-6,0,"sea",-13
"13","Sun","December 5","L","","8-4",FALSE,"Oakland Raiders",21,30,20,324,234,90,4,24,415,253,162,1,1999-12-05,-3,0,"sea",-9
"14","Sun","December 12","L","","8-5",TRUE,"San Diego Chargers",16,19,20,347,271,76,2,22,329,222,107,1,1999-12-12,-1,0,"sea",-3
"15","Sun","December 19","L","OT","8-6",FALSE,"Denver Broncos",30,36,19,364,250,114,2,26,430,170,260,2,1999-12-19,0,0,"sea",-6
"16","Sun","December 26","W","","9-6",TRUE,"Kansas City Chiefs",23,14,17,267,207,60,0,17,302,230,72,3,1999-12-26,3,1,"sea",9
"17","Sun","January 2","L","","9-7",FALSE,"New York Jets",9,19,14,266,233,33,2,20,379,202,177,2,2000-01-02,0,0,"sea",-10
"WildCard","Sun","January 9","L","","9-8",TRUE,"Miami Dolphins",17,20,12,171,130,41,2,18,299,191,108,0,2000-01-09,-2,0,"sea",-3
"1","Sun","September 3","L","","0-1",FALSE,"Miami Dolphins",0,23,8,143,72,71,6,16,308,127,181,1,2000-09-03,-5,0,"sea",-23
"2","Sun","September 10","L","","0-2",TRUE,"St. Louis Rams",34,37,24,338,237,101,3,28,476,379,97,1,2000-09-10,-2,0,"sea",-3
"3","Sun","September 17","W","","1-2",TRUE,"New Orleans Saints",20,10,22,295,169,126,1,13,263,147,116,0,2000-09-17,-1,1,"sea",10
"4","Sun","September 24","W","","2-2",FALSE,"San Diego Chargers",20,12,15,269,161,108,2,15,303,212,91,2,2000-09-24,0,1,"sea",8
"5","Mon","October 2","L","","2-3",FALSE,"Kansas City Chiefs",17,24,20,289,103,186,2,18,378,242,136,0,2000-10-02,-2,0,"sea",-7
"6","Sun","October 8","L","","2-4",FALSE,"Carolina Panthers",3,26,10,209,146,63,0,26,447,322,125,1,2000-10-08,1,0,"sea",-23
"7","Sun","October 15","L","","2-5",TRUE,"Indianapolis Colts",24,37,21,317,252,65,3,28,499,280,219,1,2000-10-15,-2,0,"sea",-13
"8","Sun","October 22","L","","2-6",FALSE,"Oakland Raiders",3,31,17,283,146,137,3,17,380,174,206,1,2000-10-22,-2,0,"sea",-28
"9","Sun","October 29","L","","2-7",TRUE,"Kansas City Chiefs",19,24,22,351,208,143,4,17,410,334,76,3,2000-10-29,-1,0,"sea",-5
"10","Sun","November 5","W","","3-7",TRUE,"San Diego Chargers",17,15,9,128,78,50,1,22,398,282,116,3,2000-11-05,2,1,"sea",2
"11","Sun","November 12","W","","4-7",FALSE,"Jacksonville Jaguars",28,21,22,326,230,96,0,24,437,315,122,1,2000-11-12,1,1,"sea",7
"13","Sun","November 26","L","","4-8",TRUE,"Denver Broncos",31,38,17,354,269,85,3,25,538,237,301,5,2000-11-26,2,0,"sea",-7
"14","Sun","December 3","W","","5-8",FALSE,"Atlanta Falcons",30,10,17,335,252,83,0,20,301,204,97,4,2000-12-03,4,1,"sea",20
"15","Sun","December 10","L","","5-9",FALSE,"Denver Broncos",24,31,22,405,298,107,4,20,313,182,131,1,2000-12-10,-3,0,"sea",-7
"16","Sat","December 16","W","","6-9",TRUE,"Oakland Raiders",27,24,18,326,153,173,2,15,361,134,227,3,2000-12-16,1,1,"sea",3
"17","Sat","December 23","L","","6-10",TRUE,"Buffalo Bills",23,42,17,312,186,126,4,27,579,366,213,2,2000-12-23,-2,0,"sea",-19
"1","Sun","September 9","W","","1-0",FALSE,"Cleveland Browns",9,6,16,251,150,101,2,13,239,149,90,1,2001-09-09,-1,1,"sea",3
"2","Sun","September 23","L","","1-1",TRUE,"Philadelphia Eagles",3,27,9,147,21,126,1,18,344,242,102,1,2001-09-23,0,0,"sea",-24
"3","Sun","September 30","L","","1-2",FALSE,"Oakland Raiders",14,38,21,348,306,42,3,17,344,251,93,1,2001-09-30,-2,0,"sea",-24
"4","Sun","October 7","W","","2-2",TRUE,"Jacksonville Jaguars",24,15,21,395,210,185,2,18,256,199,57,2,2001-10-07,0,1,"sea",9
"5","Sun","October 14","W","","3-2",TRUE,"Denver Broncos",34,21,21,254,93,161,1,20,281,189,92,3,2001-10-14,2,1,"sea",13
"7","Sun","October 28","L","","3-3",TRUE,"Miami Dolphins",20,24,18,302,206,96,2,15,289,213,76,4,2001-10-28,2,0,"sea",-4
"8","Sun","November 4","L","","3-4",FALSE,"Washington Redskins",14,27,12,275,215,60,4,21,365,139,226,1,2001-11-04,-3,0,"sea",-13
"9","Sun","November 11","W","","4-4",TRUE,"Oakland Raiders",34,27,26,497,178,319,0,20,338,250,88,1,2001-11-11,1,1,"sea",7
"10","Sun","November 18","W","","5-4",FALSE,"Buffalo Bills",23,20,16,246,134,112,0,25,372,303,69,2,2001-11-18,2,1,"sea",3
"11","Sun","November 25","L","","5-5",FALSE,"Kansas City Chiefs",7,19,11,204,139,65,0,23,433,245,188,0,2001-11-25,0,0,"sea",-12
"12","Sun","December 2","W","OT","6-5",TRUE,"San Diego Chargers",13,10,18,309,192,117,0,19,292,185,107,3,2001-12-02,3,1,"sea",3
"13","Sun","December 9","L","","6-6",FALSE,"Denver Broncos",7,20,15,277,207,70,2,20,309,144,165,2,2001-12-09,0,0,"sea",-13
"14","Sun","December 16","W","","7-6",TRUE,"Dallas Cowboys",29,3,22,312,139,173,0,10,218,116,102,1,2001-12-16,1,1,"sea",26
"15","Sun","December 23","L","","7-7",FALSE,"New York Giants",24,27,14,259,161,98,2,22,420,332,88,2,2001-12-23,0,0,"sea",-3
"16","Sun","December 30","W","","8-7",FALSE,"San Diego Chargers",25,22,14,307,246,61,0,21,398,346,52,2,2001-12-30,2,1,"sea",3
"17","Sun","January 6","W","","9-7",TRUE,"Kansas City Chiefs",21,18,20,389,239,150,2,18,308,182,126,1,2002-01-06,-1,1,"sea",3
"1","Sun","September 8","L","","0-1",FALSE,"Oakland Raiders",17,31,14,186,143,43,0,27,423,202,221,2,2002-09-08,2,0,"sea",-14
"2","Sun","September 15","L","","0-2",TRUE,"Arizona Cardinals",13,24,26,426,345,81,1,19,347,98,249,1,2002-09-15,0,0,"sea",-11
"3","Sun","September 22","L","","0-3",FALSE,"New York Giants",6,9,7,145,105,40,1,21,351,257,94,0,2002-09-22,-1,0,"sea",-3
"4","Sun","September 29","W","","1-3",TRUE,"Minnesota Vikings",48,23,18,381,222,159,1,28,443,249,194,4,2002-09-29,3,1,"sea",25
"6","Mon","October 14","L","","1-4",TRUE,"San Francisco 49ers",21,28,24,334,211,123,2,24,351,190,161,0,2002-10-14,-2,0,"sea",-7
"7","Sun","October 20","L","","1-5",FALSE,"St. Louis Rams",20,37,13,290,240,50,3,28,478,260,218,2,2002-10-20,-1,0,"sea",-17
"8","Sun","October 27","W","","2-5",FALSE,"Dallas Cowboys",17,14,18,267,170,97,2,17,237,132,105,1,2002-10-27,-1,1,"sea",3
"9","Sun","November 3","L","","2-6",TRUE,"Washington Redskins",3,14,21,324,240,84,2,16,259,113,146,1,2002-11-03,-1,0,"sea",-11
"10","Sun","November 10","W","","3-6",FALSE,"Arizona Cardinals",27,6,27,406,255,151,0,19,337,226,111,5,2002-11-10,5,1,"sea",21
"11","Sun","November 17","L","","3-7",TRUE,"Denver Broncos",9,31,13,204,153,51,3,22,401,199,202,1,2002-11-17,-2,0,"sea",-22
"12","Sun","November 24","W","","4-7",TRUE,"Kansas City Chiefs",39,32,32,534,354,180,0,32,552,335,217,1,2002-11-24,1,1,"sea",7
"13","Sun","December 1","L","","4-8",FALSE,"San Francisco 49ers",24,31,25,507,427,80,3,21,299,157,142,2,2002-12-01,-1,0,"sea",-7
"14","Sun","December 8","L","","4-9",TRUE,"Philadelphia Eagles",20,27,24,367,195,172,3,20,316,190,126,1,2002-12-08,-2,0,"sea",-7
"15","Sun","December 15","W","OT","5-9",FALSE,"Atlanta Falcons",30,24,25,464,298,166,3,21,373,223,150,3,2002-12-15,0,1,"sea",6
"16","Sun","December 22","W","","6-9",TRUE,"St. Louis Rams",30,10,26,392,292,100,1,17,271,254,17,5,2002-12-22,4,1,"sea",20
"17","Sun","December 29","W","OT","7-9",FALSE,"San Diego Chargers",31,28,34,591,428,163,3,24,414,326,88,1,2002-12-29,-2,1,"sea",3
"1","Sun","September 7","W","","1-0",TRUE,"New Orleans Saints",27,10,17,270,119,151,0,20,359,263,96,4,2003-09-07,4,1,"sea",17
"2","Sun","September 14","W","","2-0",FALSE,"Arizona Cardinals",38,0,16,323,193,130,0,18,286,193,93,6,2003-09-14,6,1,"sea",38
"3","Sun","September 21","W","","3-0",TRUE,"St. Louis Rams",24,23,20,316,220,96,1,19,308,226,82,3,2003-09-21,2,1,"sea",1
"5","Sun","October 5","L","","3-1",FALSE,"Green Bay Packers",13,35,23,343,215,128,2,27,336,177,159,0,2003-10-05,-2,0,"sea",-22
"6","Sun","October 12","W","","4-1",TRUE,"San Francisco 49ers",20,19,21,333,186,147,1,19,261,150,111,1,2003-10-12,0,1,"sea",1
"7","Sun","October 19","W","","5-1",TRUE,"Chicago Bears",24,17,22,335,211,124,2,19,211,124,87,2,2003-10-19,0,1,"sea",7
"8","Sun","October 26","L","","5-2",FALSE,"Cincinnati Bengals",24,27,24,459,338,121,5,19,412,218,194,0,2003-10-26,-5,0,"sea",-3
"9","Sun","November 2","W","","6-2",TRUE,"Pittsburgh Steelers",23,16,19,289,191,98,0,19,320,215,105,0,2003-11-02,0,1,"sea",7
"10","Sun","November 9","L","","6-3",FALSE,"Washington Redskins",20,27,21,346,221,125,3,19,379,242,137,2,2003-11-09,-1,0,"sea",-7
"11","Sun","November 16","W","","7-3",TRUE,"Detroit Lions",35,14,22,366,207,159,0,20,357,276,81,2,2003-11-16,2,1,"sea",21
"12","Sun","November 23","L","OT","7-4",FALSE,"Baltimore Ravens",41,44,24,426,293,133,3,20,426,276,150,2,2003-11-23,-1,0,"sea",-3
"13","Sun","November 30","W","","8-4",TRUE,"Cleveland Browns",34,7,26,463,306,157,1,11,214,167,47,3,2003-11-30,2,1,"sea",27
"14","Sun","December 7","L","","8-5",FALSE,"Minnesota Vikings",7,34,13,258,202,56,3,22,465,272,193,0,2003-12-07,-3,0,"sea",-27
"15","Sun","December 14","L","","8-6",FALSE,"St. Louis Rams",22,27,22,366,231,135,1,21,316,230,86,1,2003-12-14,0,0,"sea",-5
"16","Sun","December 21","W","","9-6",TRUE,"Arizona Cardinals",28,10,23,340,180,160,4,17,299,220,79,1,2003-12-21,-3,1,"sea",18
"17","Sat","December 27","W","","10-6",FALSE,"San Francisco 49ers",24,17,25,394,305,89,3,14,290,231,59,1,2003-12-27,-2,1,"sea",7
"WildCard","Sun","January 4","L","OT","10-7",FALSE,"Green Bay Packers",27,33,22,340,291,49,1,22,397,319,78,0,2004-01-04,-1,0,"sea",-6
"1","Sun","September 12","W","","1-0",FALSE,"New Orleans Saints",21,7,21,415,246,169,2,12,281,207,74,3,2004-09-12,1,1,"sea",14
"2","Sun","September 19","W","","2-0",FALSE,"Tampa Bay Buccaneers",10,6,9,182,124,58,1,17,271,179,92,3,2004-09-19,2,1,"sea",4
"3","Sun","September 26","W","","3-0",TRUE,"San Francisco 49ers",34,0,24,374,257,117,0,9,175,127,48,4,2004-09-26,4,1,"sea",34
"5","Sun","October 10","L","OT","3-1",TRUE,"St. Louis Rams",27,33,20,391,204,187,0,21,441,317,124,3,2004-10-10,3,0,"sea",-6
"6","Sun","October 17","L","","3-2",FALSE,"New England Patriots",20,30,23,443,341,102,2,20,362,224,138,2,2004-10-17,0,0,"sea",-10
"7","Sun","October 24","L","","3-3",FALSE,"Arizona Cardinals",17,25,12,257,180,77,4,16,316,189,127,2,2004-10-24,-2,0,"sea",-8
"8","Sun","October 31","W","","4-3",TRUE,"Carolina Panthers",23,17,24,433,196,237,2,16,342,248,94,1,2004-10-31,-1,1,"sea",6
"9","Sun","November 7","W","","5-3",FALSE,"San Francisco 49ers",42,27,26,453,269,184,0,19,317,243,74,1,2004-11-07,1,1,"sea",15
"10","Sun","November 14","L","","5-4",FALSE,"St. Louis Rams",12,23,20,372,172,200,2,24,462,260,202,2,2004-11-14,0,0,"sea",-11
"11","Sun","November 21","W","","6-4",TRUE,"Miami Dolphins",24,17,17,293,177,116,3,19,288,219,69,4,2004-11-21,1,1,"sea",7
"12","Sun","November 28","L","","6-5",TRUE,"Buffalo Bills",9,38,17,230,175,55,2,25,434,286,148,3,2004-11-28,1,0,"sea",-29
"13","Mon","December 6","L","","6-6",TRUE,"Dallas Cowboys",39,43,25,507,398,109,2,24,405,207,198,2,2004-12-06,0,0,"sea",-4
"14","Sun","December 12","W","","7-6",FALSE,"Minnesota Vikings",27,23,26,455,317,138,2,22,374,261,113,2,2004-12-12,0,1,"sea",4
"15","Sun","December 19","L","","7-7",FALSE,"New York Jets",14,37,19,275,187,88,3,27,482,253,229,0,2004-12-19,-3,0,"sea",-23
"16","Sun","December 26","W","","8-7",TRUE,"Arizona Cardinals",24,21,16,301,126,175,1,18,317,220,97,2,2004-12-26,1,1,"sea",3
"17","Sun","January 2","W","","9-7",TRUE,"Atlanta Falcons",28,26,21,253,170,83,1,22,354,150,204,1,2005-01-02,0,1,"sea",2
"WildCard","Sat","January 8","L","","9-8",TRUE,"St. Louis Rams",20,27,24,413,332,81,1,22,396,294,102,1,2005-01-08,0,0,"sea",-7
"1","Sun","September 11","L","","0-1",FALSE,"Jacksonville Jaguars",14,26,20,322,225,97,5,18,362,243,119,0,2005-09-11,-5,0,"sea",-12
"2","Sun","September 18","W","","1-1",TRUE,"Atlanta Falcons",21,18,24,428,265,163,1,14,223,108,115,0,2005-09-18,-1,1,"sea",3
"3","Sun","September 25","W","","2-1",TRUE,"Arizona Cardinals",37,12,29,447,284,163,0,15,266,176,90,2,2005-09-25,2,1,"sea",25
"4","Sun","October 2","L","OT","2-2",FALSE,"Washington Redskins",17,20,21,354,235,119,0,26,352,211,141,1,2005-10-02,1,0,"sea",-3
"5","Sun","October 9","W","","3-2",FALSE,"St. Louis Rams",37,31,26,433,299,134,0,20,386,309,77,2,2005-10-09,2,1,"sea",6
"6","Sun","October 16","W","","4-2",TRUE,"Houston Texans",42,10,31,459,139,320,1,14,227,160,67,0,2005-10-16,-1,1,"sea",32
"7","Sun","October 23","W","","5-2",TRUE,"Dallas Cowboys",13,10,20,289,217,72,3,16,275,111,164,2,2005-10-23,-1,1,"sea",3
"9","Sun","November 6","W","","6-2",FALSE,"Arizona Cardinals",33,19,22,370,162,208,0,23,378,307,71,4,2005-11-06,4,1,"sea",14
"10","Sun","November 13","W","","7-2",TRUE,"St. Louis Rams",31,16,21,417,243,174,2,22,353,278,75,2,2005-11-13,0,1,"sea",15
"11","Sun","November 20","W","","8-2",FALSE,"San Francisco 49ers",27,25,21,373,228,145,0,17,336,226,110,1,2005-11-20,1,1,"sea",2
"12","Sun","November 27","W","OT","9-2",TRUE,"New York Giants",24,21,17,355,228,127,2,25,490,324,166,1,2005-11-27,-1,1,"sea",3
"13","Mon","December 5","W","","10-2",FALSE,"Philadelphia Eagles",42,0,14,194,98,96,0,11,190,129,61,6,2005-12-05,6,1,"sea",42
"14","Sun","December 11","W","","11-2",TRUE,"San Francisco 49ers",41,3,31,438,253,185,1,8,113,51,62,2,2005-12-11,1,1,"sea",38
"15","Sun","December 18","W","","12-2",FALSE,"Tennessee Titans",28,24,26,459,276,183,0,25,417,336,81,0,2005-12-18,0,1,"sea",4
"16","Sat","December 24","W","","13-2",TRUE,"Indianapolis Colts",28,13,21,332,159,173,0,20,387,344,43,1,2005-12-24,1,1,"sea",15
"17","Sun","January 1","L","","13-3",FALSE,"Green Bay Packers",17,23,17,245,147,98,2,21,314,246,68,3,2006-01-01,1,0,"sea",-6
"Division","Sat","January 14","W","","14-3",TRUE,"Washington Redskins",20,10,15,334,215,119,3,11,289,230,59,1,2006-01-14,-2,1,"sea",10
"ConfChamp","Sun","January 22","W","","15-3",TRUE,"Carolina Panthers",34,14,27,393,203,190,0,11,212,176,36,4,2006-01-22,4,1,"sea",20
"SuperBowl","Sun","February 5","L","","15-4",TRUE,"Pittsburgh Steelers",10,21,20,396,259,137,1,14,339,158,181,2,2006-02-05,1,0,"sea",-11
"1","Sun","September 10","W","","1-0",FALSE,"Detroit Lions",9,6,17,264,173,91,1,15,251,213,38,1,2006-09-10,0,1,"sea",3
"2","Sun","September 17","W","","2-0",TRUE,"Arizona Cardinals",21,10,20,341,195,146,2,17,256,191,65,2,2006-09-17,0,1,"sea",11
"3","Sun","September 24","W","","3-0",TRUE,"New York Giants",42,30,26,333,227,106,3,18,337,264,73,4,2006-09-24,1,1,"sea",12
"4","Sun","October 1","L","","3-1",FALSE,"Chicago Bears",6,37,14,230,153,77,2,21,362,219,143,0,2006-10-01,-2,0,"sea",-31
"6","Sun","October 15","W","","4-1",FALSE,"St. Louis Rams",30,28,20,364,239,125,1,21,368,309,59,2,2006-10-15,1,1,"sea",2
"7","Sun","October 22","L","","4-2",TRUE,"Minnesota Vikings",13,31,16,290,237,53,3,14,332,157,175,0,2006-10-22,-3,0,"sea",-18
"8","Sun","October 29","L","","4-3",FALSE,"Kansas City Chiefs",28,35,15,240,190,50,2,30,499,308,191,3,2006-10-29,1,0,"sea",-7
"9","Mon","November 6","W","","5-3",TRUE,"Oakland Raiders",16,0,20,371,164,207,0,13,185,121,64,0,2006-11-06,0,1,"sea",16
"10","Sun","November 12","W","","6-3",TRUE,"St. Louis Rams",24,22,19,283,123,160,2,18,299,191,108,1,2006-11-12,-1,1,"sea",2
"11","Sun","November 19","L","","6-4",FALSE,"San Francisco 49ers",14,20,15,303,233,70,5,18,416,154,262,1,2006-11-19,-4,0,"sea",-6
"12","Mon","November 27","W","","7-4",TRUE,"Green Bay Packers",34,24,29,382,147,235,4,14,316,265,51,4,2006-11-27,0,1,"sea",10
"13","Sun","December 3","W","","8-4",FALSE,"Denver Broncos",23,20,12,270,162,108,1,14,302,121,181,5,2006-12-03,4,1,"sea",3
"14","Sun","December 10","L","","8-5",FALSE,"Arizona Cardinals",21,27,21,348,228,120,3,20,345,232,113,1,2006-12-10,-2,0,"sea",-6
"15","Thu","December 14","L","","8-6",TRUE,"San Francisco 49ers",14,24,22,300,210,90,2,15,390,162,228,0,2006-12-14,-2,0,"sea",-10
"16","Sun","December 24","L","","8-7",TRUE,"San Diego Chargers",17,20,18,314,161,153,2,14,340,172,168,0,2006-12-24,-2,0,"sea",-3
"17","Sun","December 31","W","","9-7",FALSE,"Tampa Bay Buccaneers",23,7,28,344,212,132,1,15,287,177,110,2,2006-12-31,1,1,"sea",16
"WildCard","Sat","January 6","W","","10-7",TRUE,"Dallas Cowboys",21,20,19,332,240,92,2,14,284,168,116,1,2007-01-06,-1,1,"sea",1
"Division","Sun","January 14","L","OT","10-8",FALSE,"Chicago Bears",24,27,18,306,179,127,1,21,371,251,120,2,2007-01-14,1,0,"sea",-3
"1","Sun","September 9","W","","1-0",TRUE,"Tampa Bay Buccaneers",20,6,17,343,204,139,1,13,284,194,90,2,2007-09-09,1,1,"sea",14
"2","Sun","September 16","L","","1-1",FALSE,"Arizona Cardinals",20,23,18,362,278,84,1,20,431,299,132,1,2007-09-16,0,0,"sea",-3
"3","Sun","September 23","W","","2-1",TRUE,"Cincinnati Bengals",24,21,19,340,238,102,2,24,412,328,84,4,2007-09-23,2,1,"sea",3
"4","Sun","September 30","W","","3-1",FALSE,"San Francisco 49ers",23,3,17,371,278,93,1,9,184,75,109,3,2007-09-30,2,1,"sea",20
"5","Sun","October 7","L","","3-2",FALSE,"Pittsburgh Steelers",0,21,8,144,106,38,1,19,342,179,163,0,2007-10-07,-1,0,"sea",-21
"6","Sun","October 14","L","","3-3",TRUE,"New Orleans Saints",17,28,25,425,333,92,2,22,367,246,121,1,2007-10-14,-1,0,"sea",-11
"7","Sun","October 21","W","","4-3",TRUE,"St. Louis Rams",33,6,19,289,189,100,1,15,221,168,53,5,2007-10-21,4,1,"sea",27
"9","Sun","November 4","L","OT","4-4",FALSE,"Cleveland Browns",30,33,28,423,318,105,2,30,428,364,64,1,2007-11-04,-1,0,"sea",-3
"10","Mon","November 12","W","","5-4",TRUE,"San Francisco 49ers",24,0,27,380,274,106,2,6,173,94,79,2,2007-11-12,0,1,"sea",24
"11","Sun","November 18","W","","6-4",TRUE,"Chicago Bears",30,23,21,425,322,103,1,16,345,238,107,1,2007-11-18,0,1,"sea",7
"12","Sun","November 25","W","","7-4",FALSE,"St. Louis Rams",24,19,18,302,215,87,2,17,265,161,104,2,2007-11-25,0,1,"sea",5
"13","Sun","December 2","W","","8-4",FALSE,"Philadelphia Eagles",28,24,16,311,176,135,2,17,363,219,144,4,2007-12-02,2,1,"sea",4
"14","Sun","December 9","W","","9-4",TRUE,"Arizona Cardinals",42,21,21,349,269,80,0,23,355,305,50,5,2007-12-09,5,1,"sea",21
"15","Sun","December 16","L","","9-5",FALSE,"Carolina Panthers",10,13,18,282,238,44,1,15,322,208,114,0,2007-12-16,-1,0,"sea",-3
"16","Sun","December 23","W","","10-5",TRUE,"Baltimore Ravens",27,6,21,336,192,144,2,13,293,187,106,3,2007-12-23,1,1,"sea",21
"17","Sun","December 30","L","","10-6",FALSE,"Atlanta Falcons",41,44,30,501,334,167,3,19,364,240,124,0,2007-12-30,-3,0,"sea",-3
"WildCard","Sat","January 5","W","","11-6",TRUE,"Washington Redskins",35,14,14,304,227,77,2,21,319,244,75,2,2008-01-05,0,1,"sea",21
"Division","Sat","January 12","L","","11-7",FALSE,"Green Bay Packers",20,42,15,200,172,28,1,25,408,173,235,2,2008-01-12,1,0,"sea",-22
"1","Sun","September 7","L","","0-1",FALSE,"Buffalo Bills",10,34,16,252,167,85,2,13,338,232,106,0,2008-09-07,-2,0,"sea",-24
"2","Sun","September 14","L","OT","0-2",TRUE,"San Francisco 49ers",30,33,22,351,182,169,3,20,365,272,93,1,2008-09-14,-2,0,"sea",-3
"3","Sun","September 21","W","","1-2",TRUE,"St. Louis Rams",37,13,24,407,162,245,1,14,240,175,65,2,2008-09-21,1,1,"sea",24
"5","Sun","October 5","L","","1-3",FALSE,"New York Giants",6,44,13,187,113,74,1,27,523,269,254,0,2008-10-05,-1,0,"sea",-38
"6","Sun","October 12","L","","1-4",TRUE,"Green Bay Packers",17,27,13,177,64,113,2,20,313,200,113,1,2008-10-12,-1,0,"sea",-10
"7","Sun","October 19","L","","1-5",FALSE,"Tampa Bay Buccaneers",10,20,7,176,73,103,2,22,402,305,97,1,2008-10-19,-1,0,"sea",-10
"8","Sun","October 26","W","","2-5",FALSE,"San Francisco 49ers",34,13,14,261,222,39,0,21,388,264,124,2,2008-10-26,2,1,"sea",21
"9","Sun","November 2","L","","2-6",TRUE,"Philadelphia Eagles",7,26,10,233,147,86,0,20,419,347,72,1,2008-11-02,1,0,"sea",-19
"10","Sun","November 9","L","","2-7",FALSE,"Miami Dolphins",19,21,21,298,172,126,0,20,361,206,155,1,2008-11-09,1,0,"sea",-2
"11","Sun","November 16","L","","2-8",TRUE,"Arizona Cardinals",20,26,18,196,153,43,4,24,458,382,76,3,2008-11-16,-1,0,"sea",-6
"12","Sun","November 23","L","","2-9",TRUE,"Washington Redskins",17,20,13,228,89,139,2,24,386,199,187,1,2008-11-23,-1,0,"sea",-3
"13","Thu","November 27","L","","2-10",FALSE,"Dallas Cowboys",9,34,19,322,242,80,2,24,447,331,116,1,2008-11-27,-1,0,"sea",-25
"14","Sun","December 7","L","","2-11",TRUE,"New England Patriots",21,24,18,339,205,134,1,22,344,260,84,0,2008-12-07,-1,0,"sea",-3
"15","Sun","December 14","W","","3-11",FALSE,"St. Louis Rams",23,20,16,333,208,125,2,18,342,211,131,2,2008-12-14,0,1,"sea",3
"16","Sun","December 21","W","","4-11",TRUE,"New York Jets",13,3,17,295,175,120,2,16,265,150,115,2,2008-12-21,0,1,"sea",10
"17","Sun","December 28","L","","4-12",FALSE,"Arizona Cardinals",21,34,24,330,243,87,3,19,457,346,111,2,2008-12-28,-1,0,"sea",-13
"1","Sun","September 13","W","","1-0",TRUE,"St. Louis Rams",28,0,25,446,279,167,3,13,247,170,77,1,2009-09-13,-2,1,"sea",28
"2","Sun","September 20","L","","1-1",FALSE,"San Francisco 49ers",10,23,19,283,217,66,1,16,379,123,256,0,2009-09-20,-1,0,"sea",-13
"3","Sun","September 27","L","","1-2",TRUE,"Chicago Bears",19,25,19,346,243,103,2,14,318,233,85,2,2009-09-27,0,0,"sea",-6
"4","Sun","October 4","L","","1-3",FALSE,"Indianapolis Colts",17,34,20,279,230,49,2,24,431,353,78,1,2009-10-04,-1,0,"sea",-17
"5","Sun","October 11","W","","2-3",TRUE,"Jacksonville Jaguars",41,0,24,379,236,143,0,10,199,161,38,2,2009-10-11,2,1,"sea",41
"6","Sun","October 18","L","","2-4",TRUE,"Arizona Cardinals",3,27,7,128,114,14,2,21,344,282,62,2,2009-10-18,0,0,"sea",-24
"8","Sun","November 1","L","","2-5",FALSE,"Dallas Cowboys",17,38,18,308,229,79,2,26,362,249,113,1,2009-11-01,-1,0,"sea",-21
"9","Sun","November 8","W","","3-5",TRUE,"Detroit Lions",32,20,25,397,342,55,2,17,300,186,114,5,2009-11-08,3,1,"sea",12
"10","Sun","November 15","L","","3-6",FALSE,"Arizona Cardinals",20,31,29,472,308,164,2,22,462,340,122,0,2009-11-15,-2,0,"sea",-11
"11","Sun","November 22","L","","3-7",FALSE,"Minnesota Vikings",9,35,10,212,208,4,2,28,431,271,160,0,2009-11-22,-2,0,"sea",-26
"12","Sun","November 29","W","","4-7",FALSE,"St. Louis Rams",27,17,15,265,95,170,1,23,364,251,113,2,2009-11-29,1,1,"sea",10
"13","Sun","December 6","W","","5-7",TRUE,"San Francisco 49ers",20,17,17,292,185,107,1,14,356,303,53,2,2009-12-06,1,1,"sea",3
"14","Sun","December 13","L","","5-8",FALSE,"Houston Texans",7,34,13,282,220,62,1,23,450,365,85,2,2009-12-13,1,0,"sea",-27
"15","Sun","December 20","L","","5-9",TRUE,"Tampa Bay Buccaneers",7,24,23,380,252,128,5,15,339,205,134,1,2009-12-20,-4,0,"sea",-17
"16","Sun","December 27","L","","5-10",FALSE,"Green Bay Packers",10,48,17,291,176,115,4,20,417,264,153,0,2009-12-27,-4,0,"sea",-38
"17","Sun","January 3","L","","5-11",TRUE,"Tennessee Titans",13,17,16,309,169,140,1,19,304,171,133,2,2010-01-03,1,0,"sea",-4
"1","Sun","September 12","W","","1-0",TRUE,"San Francisco 49ers",31,6,14,242,165,77,1,14,263,214,49,2,2010-09-12,1,1,"sea",25
"2","Sun","September 19","L","","1-1",FALSE,"Denver Broncos",14,31,17,339,230,109,4,23,369,304,65,0,2010-09-19,-4,0,"sea",-17
"3","Sun","September 26","W","","2-1",TRUE,"San Diego Chargers",27,20,13,271,203,68,2,27,518,429,89,5,2010-09-26,3,1,"sea",7
"4","Sun","October 3","L","","2-2",FALSE,"St. Louis Rams",3,20,15,257,193,64,2,19,349,261,88,1,2010-10-03,-1,0,"sea",-17
"6","Sun","October 17","W","","3-2",FALSE,"Chicago Bears",23,20,20,353,242,111,0,15,307,246,61,0,2010-10-17,0,1,"sea",3
"7","Sun","October 24","W","","4-2",TRUE,"Arizona Cardinals",22,10,16,302,158,144,1,13,227,114,113,5,2010-10-24,4,1,"sea",12
"8","Sun","October 31","L","","4-3",FALSE,"Oakland Raiders",3,33,10,164,117,47,1,18,545,306,239,0,2010-10-31,-1,0,"sea",-30
"9","Sun","November 7","L","","4-4",TRUE,"New York Giants",7,41,8,162,113,49,3,30,487,290,197,1,2010-11-07,-2,0,"sea",-34
"10","Sun","November 14","W","","5-4",FALSE,"Arizona Cardinals",36,18,24,490,380,110,1,19,327,286,41,2,2010-11-14,1,1,"sea",18
"11","Sun","November 21","L","","5-5",FALSE,"New Orleans Saints",19,34,21,424,366,58,2,26,494,382,112,2,2010-11-21,0,0,"sea",-15
"12","Sun","November 28","L","","5-6",TRUE,"Kansas City Chiefs",24,42,13,288,268,20,3,28,503,233,270,1,2010-11-28,-2,0,"sea",-18
"13","Sun","December 5","W","","6-6",TRUE,"Carolina Panthers",31,14,25,371,210,161,2,18,283,152,131,1,2010-12-05,-1,1,"sea",17
"14","Sun","December 12","L","","6-7",FALSE,"San Francisco 49ers",21,40,20,361,277,84,5,10,336,241,95,0,2010-12-12,-5,0,"sea",-19
"15","Sun","December 19","L","","6-8",TRUE,"Atlanta Falcons",18,34,15,234,143,91,3,21,266,168,98,1,2010-12-19,-2,0,"sea",-16
"16","Sun","December 26","L","","6-9",FALSE,"Tampa Bay Buccaneers",15,38,10,174,84,90,0,22,439,231,208,0,2010-12-26,0,0,"sea",-23
"17","Sun","January 2","W","","7-9",TRUE,"St. Louis Rams",16,6,19,333,192,141,1,10,184,137,47,1,2011-01-02,0,1,"sea",10
"WildCard","Sat","January 8","W","","8-9",TRUE,"New Orleans Saints",41,36,19,415,265,150,1,32,474,397,77,1,2011-01-08,0,1,"sea",5
"Division","Sun","January 16","L","","8-10",FALSE,"Chicago Bears",24,35,18,276,242,34,0,21,437,261,176,1,2011-01-16,1,0,"sea",-11
"1","Sun","September 11","L","","0-1",FALSE,"San Francisco 49ers",17,33,18,219,155,64,3,12,209,124,85,0,2011-09-11,-3,0,"sea",-16
"2","Sun","September 18","L","","0-2",FALSE,"Pittsburgh Steelers",0,24,8,164,133,31,0,23,421,297,124,0,2011-09-18,0,0,"sea",-24
"3","Sun","September 25","W","","1-2",TRUE,"Arizona Cardinals",13,10,16,261,139,122,1,20,324,234,90,2,2011-09-25,1,1,"sea",3
"4","Sun","October 2","L","","1-3",TRUE,"Atlanta Falcons",28,30,20,372,319,53,2,25,412,291,121,0,2011-10-02,-2,0,"sea",-2
"5","Sun","October 9","W","","2-3",FALSE,"New York Giants",36,25,26,424,279,145,3,21,464,395,69,5,2011-10-09,2,1,"sea",11
"7","Sun","October 23","L","","2-4",FALSE,"Cleveland Browns",3,6,9,137,69,68,2,20,300,159,141,1,2011-10-23,-1,0,"sea",-3
"8","Sun","October 30","L","","2-5",TRUE,"Cincinnati Bengals",12,34,20,411,350,61,2,18,252,160,92,2,2011-10-30,0,0,"sea",-22
"9","Sun","November 6","L","","2-6",FALSE,"Dallas Cowboys",13,23,18,381,219,162,3,18,442,279,163,1,2011-11-06,-2,0,"sea",-10
"10","Sun","November 13","W","","3-6",TRUE,"Baltimore Ravens",22,17,16,327,208,119,0,25,323,248,75,3,2011-11-13,3,1,"sea",5
"11","Sun","November 20","W","","4-6",FALSE,"St. Louis Rams",24,7,16,289,163,126,2,13,185,143,42,3,2011-11-20,1,1,"sea",17
"12","Sun","November 27","L","","4-7",TRUE,"Washington Redskins",17,23,15,250,126,124,1,22,416,306,110,2,2011-11-27,1,0,"sea",-6
"13","Thu","December 1","W","","5-7",TRUE,"Philadelphia Eagles",31,14,15,347,173,174,0,20,330,198,132,4,2011-12-01,4,1,"sea",17
"14","Mon","December 12","W","","6-7",TRUE,"St. Louis Rams",30,13,21,359,214,145,1,19,281,167,114,1,2011-12-12,0,1,"sea",17
"15","Sun","December 18","W","","7-7",FALSE,"Chicago Bears",38,14,18,286,226,60,1,13,221,89,132,5,2011-12-18,4,1,"sea",24
"16","Sat","December 24","L","","7-8",TRUE,"San Francisco 49ers",17,19,14,265,141,124,1,21,349,171,178,0,2011-12-24,-1,0,"sea",-2
"17","Sun","January 1","L","OT","7-9",FALSE,"Arizona Cardinals",20,23,19,369,191,178,1,20,388,257,131,2,2012-01-01,1,0,"sea",-3
"1","Sun","September 8","W","","1-0",TRUE,"Denver Broncos",20,16,19,285,138,147,3,13,277,214,63,3,1985-09-08,0,1,"ram",4
"2","Sun","September 15","W","","2-0",FALSE,"Philadelphia Eagles",17,6,16,334,161,173,2,16,300,180,120,7,1985-09-15,5,1,"ram",11
"3","Mon","September 23","W","","3-0",FALSE,"Seattle Seahawks",35,24,19,357,187,170,5,17,314,270,44,5,1985-09-23,0,1,"ram",11
"4","Sun","September 29","W","","4-0",TRUE,"Atlanta Falcons",17,6,14,283,177,106,0,18,258,154,104,1,1985-09-29,1,1,"ram",11
"5","Sun","October 6","W","","5-0",TRUE,"Minnesota Vikings",13,10,14,188,130,58,1,25,306,172,134,1,1985-10-06,0,1,"ram",3
"6","Sun","October 13","W","","6-0",FALSE,"Tampa Bay Buccaneers",31,27,14,282,148,134,4,15,210,151,59,5,1985-10-13,1,1,"ram",4
"7","Sun","October 20","W","","7-0",FALSE,"Kansas City Chiefs",16,0,12,184,54,130,0,15,245,143,102,7,1985-10-20,7,1,"ram",16
"8","Sun","October 27","L","","7-1",TRUE,"San Francisco 49ers",14,28,25,401,319,82,4,23,429,290,139,1,1985-10-27,-3,0,"ram",-14
"9","Sun","November 3","W","","8-1",TRUE,"New Orleans Saints",28,10,20,366,236,130,3,13,187,122,65,3,1985-11-03,0,1,"ram",18
"10","Sun","November 10","L","","8-2",FALSE,"New York Giants",19,24,14,261,103,158,1,21,333,224,109,3,1985-11-10,2,0,"ram",-5
"11","Sun","November 17","L","","8-3",FALSE,"Atlanta Falcons",14,30,9,177,132,45,5,22,290,132,158,1,1985-11-17,-4,0,"ram",-16
"12","Sun","November 24","W","","9-3",TRUE,"Green Bay Packers",34,17,20,329,142,187,1,20,281,203,78,1,1985-11-24,0,1,"ram",17
"13","Sun","December 1","L","","9-4",FALSE,"New Orleans Saints",3,29,13,164,59,105,4,14,280,196,84,0,1985-12-01,-4,0,"ram",-26
"14","Mon","December 9","W","","10-4",FALSE,"San Francisco 49ers",27,20,12,264,150,114,1,22,410,300,110,3,1985-12-09,2,1,"ram",7
"15","Sun","December 15","W","","11-4",TRUE,"St. Louis Cardinals",46,14,22,425,217,208,0,14,213,131,82,3,1985-12-15,3,1,"ram",32
"16","Mon","December 23","L","","11-5",TRUE,"Los Angeles Raiders",6,16,15,220,110,110,1,13,315,180,135,2,1985-12-23,1,0,"ram",-10
"Division","Sat","January 4","W","","12-5",TRUE,"Dallas Cowboys",20,0,15,316,47,269,2,15,243,182,61,6,1986-01-04,4,1,"ram",20
"ConfChamp","Sun","January 12","L","","12-6",FALSE,"Chicago Bears",0,24,9,130,44,86,3,13,232,141,91,1,1986-01-12,-2,0,"ram",-24
"1","Sun","September 7","W","","1-0",FALSE,"St. Louis Cardinals",16,10,17,269,70,199,2,14,247,177,70,2,1986-09-07,0,1,"ram",6
"2","Sun","September 14","W","","2-0",TRUE,"San Francisco 49ers",16,13,14,192,89,103,0,13,325,247,78,2,1986-09-14,2,1,"ram",3
"3","Sun","September 21","W","","3-0",FALSE,"Indianapolis Colts",24,7,21,316,162,154,2,14,177,122,55,2,1986-09-21,0,1,"ram",17
"4","Sun","September 28","L","","3-1",FALSE,"Philadelphia Eagles",20,34,18,320,207,113,3,20,395,259,136,1,1986-09-28,-2,0,"ram",-14
"5","Sun","October 5","W","OT","4-1",TRUE,"Tampa Bay Buccaneers",26,20,20,357,106,251,2,14,234,60,174,1,1986-10-05,-1,1,"ram",6
"6","Sun","October 12","L","","4-2",FALSE,"Atlanta Falcons",14,26,19,290,184,106,3,16,275,108,167,2,1986-10-12,-1,0,"ram",-12
"7","Sun","October 19","W","","5-2",TRUE,"Detroit Lions",14,10,10,200,22,178,2,21,372,303,69,3,1986-10-19,1,1,"ram",4
"8","Sun","October 26","W","","6-2",TRUE,"Atlanta Falcons",14,7,18,335,101,234,5,8,151,55,96,3,1986-10-26,-2,1,"ram",7
"9","Mon","November 3","W","","7-2",FALSE,"Chicago Bears",20,17,14,278,137,141,3,14,269,123,146,3,1986-11-03,0,1,"ram",3
"10","Sun","November 9","L","","7-3",FALSE,"New Orleans Saints",0,6,10,176,123,53,4,9,236,134,102,5,1986-11-09,1,0,"ram",-6
"11","Sun","November 16","L","","7-4",TRUE,"New England Patriots",28,30,18,369,220,149,2,23,390,341,49,4,1986-11-16,2,0,"ram",-2
"12","Sun","November 23","W","","8-4",TRUE,"New Orleans Saints",26,13,18,239,50,189,2,23,312,223,89,5,1986-11-23,3,1,"ram",13
"13","Sun","November 30","W","","9-4",FALSE,"New York Jets",17,3,14,293,155,138,2,19,350,261,89,4,1986-11-30,2,1,"ram",14
"14","Sun","December 7","W","","10-4",TRUE,"Dallas Cowboys",29,10,21,418,212,206,1,14,224,140,84,2,1986-12-07,1,1,"ram",19
"15","Sun","December 14","L","OT","10-5",TRUE,"Miami Dolphins",31,37,25,372,230,142,1,23,506,399,107,2,1986-12-14,1,0,"ram",-6
"16","Fri","December 19","L","","10-6",FALSE,"San Francisco 49ers",14,24,12,229,128,101,3,27,408,238,170,2,1986-12-19,-1,0,"ram",-10
"WildCard","Sun","December 28","L","","10-7",FALSE,"Washington Redskins",7,19,16,324,126,198,6,15,228,90,138,0,1986-12-28,-6,0,"ram",-12
"1","Sun","September 13","L","","0-1",FALSE,"Houston Oilers",16,20,14,244,97,147,3,22,400,287,113,3,1987-09-13,0,0,"ram",-4
"2","Sun","September 20","L","","0-2",TRUE,"Minnesota Vikings",16,21,15,210,88,122,2,17,353,257,96,2,1987-09-20,0,0,"ram",-5
"3","Sun","October 4","L","","0-3",FALSE,"New Orleans Saints",10,37,12,207,135,72,2,19,349,195,154,1,1987-10-04,-1,0,"ram",-27
"4","Sun","October 11","W","","1-3",TRUE,"Pittsburgh Steelers",31,21,15,313,141,172,2,16,319,170,149,1,1987-10-11,-1,1,"ram",10
"5","Sun","October 18","L","","1-4",FALSE,"Atlanta Falcons",20,24,21,350,164,186,4,22,342,296,46,5,1987-10-18,1,0,"ram",-4
"6","Mon","October 26","L","","1-5",FALSE,"Cleveland Browns",17,30,22,328,227,101,4,15,267,202,65,1,1987-10-26,-3,0,"ram",-13
"7","Sun","November 1","L","","1-6",TRUE,"San Francisco 49ers",10,31,19,280,218,62,1,23,435,286,149,1,1987-11-01,0,0,"ram",-21
"8","Sun","November 8","L","","1-7",TRUE,"New Orleans Saints",14,31,18,304,202,102,3,20,443,211,232,2,1987-11-08,-1,0,"ram",-17
"9","Sun","November 15","W","","2-7",FALSE,"St. Louis Cardinals",27,24,21,383,144,239,2,19,280,156,124,1,1987-11-15,-1,1,"ram",3
"10","Mon","November 23","W","","3-7",FALSE,"Washington Redskins",30,26,14,234,96,138,1,20,343,277,66,2,1987-11-23,1,1,"ram",4
"11","Sun","November 29","W","","4-7",TRUE,"Tampa Bay Buccaneers",35,3,27,425,212,213,1,11,201,122,79,3,1987-11-29,2,1,"ram",32
"12","Sun","December 6","W","","5-7",FALSE,"Detroit Lions",37,16,22,423,313,110,2,19,328,271,57,3,1987-12-06,1,1,"ram",21
"13","Sun","December 13","W","","6-7",TRUE,"Atlanta Falcons",33,0,28,494,256,238,0,13,269,210,59,2,1987-12-13,2,1,"ram",33
"14","Mon","December 21","L","","6-8",TRUE,"Dallas Cowboys",21,29,19,311,237,74,4,20,365,171,194,0,1987-12-21,-4,0,"ram",-8
"15","Sun","December 27","L","","6-9",FALSE,"San Francisco 49ers",0,48,9,145,24,121,2,23,427,278,149,0,1987-12-27,-2,0,"ram",-48
"1","Sun","September 4","W","","1-0",FALSE,"Green Bay Packers",34,7,18,290,176,114,1,12,209,131,78,7,1988-09-04,6,1,"ram",27
"2","Sun","September 11","W","","2-0",TRUE,"Detroit Lions",17,10,23,315,124,191,2,16,210,134,76,3,1988-09-11,1,1,"ram",7
"3","Sun","September 18","W","","3-0",FALSE,"Los Angeles Raiders",22,17,16,313,173,140,1,18,408,305,103,1,1988-09-18,0,1,"ram",5
"4","Sun","September 25","W","","4-0",FALSE,"New York Giants",45,31,21,369,232,137,1,24,363,284,79,3,1988-09-25,2,1,"ram",14
"5","Sun","October 2","L","","4-1",TRUE,"Phoenix Cardinals",27,41,23,353,268,85,3,30,519,332,187,1,1988-10-02,-2,0,"ram",-14
"6","Sun","October 9","W","","5-1",FALSE,"Atlanta Falcons",33,0,27,501,249,252,1,12,150,77,73,2,1988-10-09,1,1,"ram",33
"7","Sun","October 16","L","","5-2",TRUE,"San Francisco 49ers",21,24,14,236,194,42,4,24,429,184,245,2,1988-10-16,-2,0,"ram",-3
"8","Sun","October 23","W","","6-2",TRUE,"Seattle Seahawks",31,10,24,465,311,154,3,21,296,143,153,5,1988-10-23,2,1,"ram",21
"9","Sun","October 30","W","","7-2",FALSE,"New Orleans Saints",12,10,16,332,236,96,0,14,242,209,33,2,1988-10-30,2,1,"ram",2
"10","Sun","November 6","L","","7-3",FALSE,"Philadelphia Eagles",24,30,22,427,358,69,5,21,436,313,123,0,1988-11-06,-5,0,"ram",-6
"11","Sun","November 13","L","","7-4",TRUE,"New Orleans Saints",10,14,15,256,196,60,2,19,337,249,88,3,1988-11-13,1,0,"ram",-4
"12","Sun","November 20","L","","7-5",TRUE,"San Diego Chargers",24,38,20,363,212,151,2,17,297,196,101,1,1988-11-20,-1,0,"ram",-14
"13","Sun","November 27","L","","7-6",FALSE,"Denver Broncos",24,35,28,484,352,132,3,19,368,270,98,1,1988-11-27,-2,0,"ram",-11
"14","Mon","December 5","W","","8-6",TRUE,"Chicago Bears",23,3,22,364,232,132,3,13,213,99,114,3,1988-12-05,0,1,"ram",20
"15","Sun","December 11","W","","9-6",TRUE,"Atlanta Falcons",22,7,21,418,291,127,2,9,193,128,65,2,1988-12-11,0,1,"ram",15
"16","Sun","December 18","W","","10-6",FALSE,"San Francisco 49ers",38,16,23,322,201,121,1,20,316,246,70,1,1988-12-18,0,1,"ram",22
"WildCard","Mon","December 26","L","","10-7",FALSE,"Minnesota Vikings",17,28,19,342,235,107,3,11,310,207,103,0,1988-12-26,-3,0,"ram",-11
"1","Sun","September 10","W","","1-0",FALSE,"Atlanta Falcons",31,21,21,363,195,168,1,16,314,271,43,0,1989-09-10,-1,1,"ram",10
"2","Sun","September 17","W","","2-0",TRUE,"Indianapolis Colts",31,17,26,449,352,97,1,20,386,266,120,2,1989-09-17,1,1,"ram",14
"3","Sun","September 24","W","","3-0",TRUE,"Green Bay Packers",41,38,20,440,223,217,2,29,442,326,116,5,1989-09-24,3,1,"ram",3
"4","Sun","October 1","W","","4-0",FALSE,"San Francisco 49ers",13,12,11,287,250,37,0,22,367,215,152,1,1989-10-01,1,1,"ram",1
"5","Sun","October 8","W","","5-0",TRUE,"Atlanta Falcons",26,14,21,438,273,165,1,19,353,315,38,1,1989-10-08,0,1,"ram",12
"6","Mon","October 16","L","","5-1",FALSE,"Buffalo Bills",20,23,15,266,207,59,2,17,348,214,134,4,1989-10-16,2,0,"ram",-3
"7","Sun","October 22","L","","5-2",TRUE,"New Orleans Saints",21,40,22,313,260,53,3,16,373,267,106,1,1989-10-22,-2,0,"ram",-19
"8","Sun","October 29","L","","5-3",FALSE,"Chicago Bears",10,20,17,252,168,84,3,19,318,170,148,0,1989-10-29,-3,0,"ram",-10
"9","Sun","November 5","L","OT","5-4",FALSE,"Minnesota Vikings",21,23,14,304,185,119,2,23,376,276,100,1,1989-11-05,-1,0,"ram",-2
"10","Sun","November 12","W","","6-4",TRUE,"New York Giants",31,10,28,445,295,150,2,13,207,201,6,2,1989-11-12,0,1,"ram",21
"11","Sun","November 19","W","","7-4",TRUE,"Phoenix Cardinals",37,14,16,436,301,135,1,13,292,216,76,4,1989-11-19,3,1,"ram",23
"12","Sun","November 26","W","OT","8-4",FALSE,"New Orleans Saints",20,17,23,472,415,57,3,14,301,163,138,2,1989-11-26,-1,1,"ram",3
"13","Sun","December 3","W","","9-4",FALSE,"Dallas Cowboys",35,31,20,403,325,78,3,20,303,165,138,4,1989-12-03,1,1,"ram",4
"14","Mon","December 11","L","","9-5",TRUE,"San Francisco 49ers",27,30,24,337,231,106,2,25,502,439,63,2,1989-12-11,0,0,"ram",-3
"15","Sun","December 17","W","","10-5",TRUE,"New York Jets",38,14,21,422,272,150,1,14,291,199,92,4,1989-12-17,3,1,"ram",24
"16","Sun","December 24","W","","11-5",FALSE,"New England Patriots",24,20,22,415,181,234,2,26,394,321,73,3,1989-12-24,1,1,"ram",4
"WildCard","Sun","December 31","W","","12-5",FALSE,"Philadelphia Eagles",21,7,19,409,265,144,3,14,306,211,95,3,1989-12-31,0,1,"ram",14
"Division","Sun","January 7","W","OT","13-5",FALSE,"New York Giants",19,13,26,448,302,146,2,20,344,173,171,1,1990-01-07,-1,1,"ram",6
"ConfChamp","Sun","January 14","L","","13-6",FALSE,"San Francisco 49ers",3,30,9,156,130,26,3,29,442,263,179,2,1990-01-14,-1,0,"ram",-27
"1","Sun","September 9","L","","0-1",FALSE,"Green Bay Packers",24,36,18,408,321,87,5,18,333,238,95,1,1990-09-09,-4,0,"ram",-12
"2","Sun","September 16","W","","1-1",FALSE,"Tampa Bay Buccaneers",35,14,22,389,253,136,0,13,255,194,61,2,1990-09-16,2,1,"ram",21
"3","Sun","September 23","L","","1-2",TRUE,"Philadelphia Eagles",21,27,15,281,246,35,2,25,405,234,171,3,1990-09-23,1,0,"ram",-6
"5","Sun","October 7","L","OT","1-3",TRUE,"Cincinnati Bengals",31,34,26,477,364,113,1,27,582,483,99,2,1990-10-07,1,0,"ram",-3
"6","Sun","October 14","L","","1-4",FALSE,"Chicago Bears",9,38,15,267,179,88,1,22,402,248,154,0,1990-10-14,-1,0,"ram",-29
"7","Sun","October 21","W","","2-4",TRUE,"Atlanta Falcons",44,24,26,431,302,129,0,12,315,236,79,3,1990-10-21,3,1,"ram",20
"8","Mon","October 29","L","","2-5",FALSE,"Pittsburgh Steelers",10,41,13,217,173,44,3,18,345,156,189,1,1990-10-29,-2,0,"ram",-31
"9","Sun","November 4","W","","3-5",TRUE,"Houston Oilers",17,13,23,316,198,118,1,20,366,333,33,2,1990-11-04,1,1,"ram",4
"10","Sun","November 11","L","","3-6",TRUE,"New York Giants",7,31,14,274,174,100,3,20,300,185,115,1,1990-11-11,-2,0,"ram",-24
"11","Sun","November 18","L","","3-7",TRUE,"Dallas Cowboys",21,24,18,292,124,168,1,17,359,295,64,1,1990-11-18,0,0,"ram",-3
"12","Sun","November 25","W","","4-7",FALSE,"San Francisco 49ers",28,17,19,350,239,111,2,16,291,225,66,6,1990-11-25,4,1,"ram",11
"13","Sun","December 2","W","","5-7",FALSE,"Cleveland Browns",38,23,27,411,261,150,1,18,303,266,37,1,1990-12-02,0,1,"ram",15
"14","Sun","December 9","L","","5-8",TRUE,"New Orleans Saints",20,24,24,444,341,103,4,9,218,110,108,3,1990-12-09,-1,0,"ram",-4
"15","Mon","December 17","L","","5-9",TRUE,"San Francisco 49ers",10,26,17,266,213,53,4,21,388,215,173,2,1990-12-17,-2,0,"ram",-16
"16","Sun","December 23","L","","5-10",FALSE,"Atlanta Falcons",13,20,18,228,155,73,2,16,281,170,111,3,1990-12-23,1,0,"ram",-7
"17","Mon","December 31","L","","5-11",FALSE,"New Orleans Saints",17,20,16,379,275,104,1,14,268,174,94,0,1990-12-31,-1,0,"ram",-3
"1","Sun","September 1","L","","0-1",TRUE,"Phoenix Cardinals",14,24,25,375,276,99,7,13,193,124,69,0,1991-09-01,-7,0,"ram",-10
"2","Sun","September 8","W","","1-1",FALSE,"New York Giants",19,13,10,217,74,143,1,18,293,177,116,3,1991-09-08,2,1,"ram",6
"3","Sun","September 15","L","","1-2",FALSE,"New Orleans Saints",7,24,6,120,43,77,1,18,334,181,153,1,1991-09-15,0,0,"ram",-17
"4","Sun","September 22","L","","1-3",FALSE,"San Francisco 49ers",10,27,15,272,208,64,1,20,422,273,149,1,1991-09-22,0,0,"ram",-17
"5","Sun","September 29","W","","2-3",TRUE,"Green Bay Packers",23,21,18,310,233,77,2,17,260,172,88,3,1991-09-29,1,1,"ram",2
"7","Sun","October 13","W","","3-3",TRUE,"San Diego Chargers",30,24,21,284,204,80,0,17,387,298,89,1,1991-10-13,1,1,"ram",6
"8","Sun","October 20","L","","3-4",FALSE,"Los Angeles Raiders",17,20,21,347,294,53,3,18,339,255,84,2,1991-10-20,-1,0,"ram",-3
"9","Sun","October 27","L","","3-5",FALSE,"Atlanta Falcons",14,31,13,209,109,100,1,16,399,278,121,1,1991-10-27,0,0,"ram",-17
"10","Sun","November 3","L","","3-6",TRUE,"New Orleans Saints",17,24,16,381,326,55,5,19,359,269,90,1,1991-11-03,-4,0,"ram",-7
"11","Sun","November 10","L","","3-7",TRUE,"Kansas City Chiefs",20,27,25,430,319,111,4,22,354,190,164,0,1991-11-10,-4,0,"ram",-7
"12","Sun","November 17","L","","3-8",FALSE,"Detroit Lions",10,21,18,334,308,26,2,16,249,181,68,0,1991-11-17,-2,0,"ram",-11
"13","Mon","November 25","L","","3-9",TRUE,"San Francisco 49ers",10,33,18,320,285,35,2,23,387,306,81,1,1991-11-25,-1,0,"ram",-23
"14","Sun","December 1","L","","3-10",TRUE,"Washington Redskins",6,27,16,278,181,97,1,15,353,269,84,1,1991-12-01,0,0,"ram",-21
"15","Sun","December 8","L","","3-11",TRUE,"Atlanta Falcons",14,31,15,274,165,109,2,21,359,275,84,1,1991-12-08,-1,0,"ram",-17
"16","Sun","December 15","L","","3-12",FALSE,"Minnesota Vikings",14,20,21,317,254,63,5,20,263,141,122,0,1991-12-15,-5,0,"ram",-6
"17","Sun","December 22","L","","3-13",FALSE,"Seattle Seahawks",9,23,12,227,131,96,3,13,253,156,97,3,1991-12-22,0,0,"ram",-14
"1","Sun","September 6","L","","0-1",FALSE,"Buffalo Bills",7,40,15,215,149,66,4,23,363,156,207,1,1992-09-06,-3,0,"ram",-33
"2","Sun","September 13","W","","1-1",TRUE,"New England Patriots",14,0,13,240,119,121,0,14,227,109,118,5,1992-09-13,5,1,"ram",14
"3","Sun","September 20","L","","1-2",FALSE,"Miami Dolphins",10,26,15,298,214,84,4,24,381,223,158,2,1992-09-20,-2,0,"ram",-16
"4","Sun","September 27","W","","2-2",TRUE,"New York Jets",18,10,15,269,151,118,3,21,330,181,149,4,1992-09-27,1,1,"ram",8
"5","Sun","October 4","L","","2-3",FALSE,"San Francisco 49ers",24,27,15,347,224,123,2,20,412,238,174,1,1992-10-04,-1,0,"ram",-3
"6","Sun","October 11","L","","2-4",FALSE,"New Orleans Saints",10,13,13,196,143,53,1,19,301,166,135,2,1992-10-11,1,0,"ram",-3
"7","Sun","October 18","W","","3-4",TRUE,"New York Giants",38,17,22,356,226,130,1,18,296,172,124,2,1992-10-18,1,1,"ram",21
"9","Sun","November 1","L","","3-5",FALSE,"Atlanta Falcons",28,30,19,359,212,147,2,19,350,214,136,2,1992-11-01,0,0,"ram",-2
"10","Sun","November 8","L","","3-6",TRUE,"Phoenix Cardinals",14,20,19,302,248,54,3,18,324,216,108,0,1992-11-08,-3,0,"ram",-6
"11","Sun","November 15","W","","4-6",FALSE,"Dallas Cowboys",27,23,24,367,244,123,0,19,349,269,80,0,1992-11-15,0,1,"ram",4
"12","Sun","November 22","L","","4-7",TRUE,"San Francisco 49ers",10,27,14,245,149,96,0,21,366,153,213,1,1992-11-22,1,0,"ram",-17
"13","Sun","November 29","L","","4-8",TRUE,"Minnesota Vikings",17,31,22,337,247,90,4,24,408,274,134,3,1992-11-29,-1,0,"ram",-14
"14","Sun","December 6","W","","5-8",FALSE,"Tampa Bay Buccaneers",31,27,21,405,342,63,3,16,313,163,150,3,1992-12-06,0,1,"ram",4
"15","Sun","December 13","L","","5-9",TRUE,"New Orleans Saints",14,37,18,328,226,102,6,25,399,238,161,1,1992-12-13,-5,0,"ram",-23
"16","Sun","December 20","L","","5-10",FALSE,"Green Bay Packers",13,28,17,337,216,121,3,15,259,158,101,3,1992-12-20,0,0,"ram",-15
"17","Sun","December 27","W","","6-10",TRUE,"Atlanta Falcons",38,27,16,276,108,168,1,23,445,363,82,3,1992-12-27,2,1,"ram",11
"1","Sun","September 5","L","","0-1",FALSE,"Green Bay Packers",6,36,14,228,175,53,2,22,381,243,138,1,1993-09-05,-1,0,"ram",-30
"2","Sun","September 12","W","","1-1",TRUE,"Pittsburgh Steelers",27,0,20,314,215,99,2,11,175,120,55,3,1993-09-12,1,1,"ram",27
"3","Sun","September 19","L","","1-2",FALSE,"New York Giants",10,20,8,171,126,45,2,23,330,184,146,2,1993-09-19,0,0,"ram",-10
"4","Sun","September 26","W","","2-2",FALSE,"Houston Oilers",28,13,22,374,316,58,0,18,370,288,82,2,1993-09-26,2,1,"ram",15
"5","Sun","October 3","L","","2-3",TRUE,"New Orleans Saints",6,37,17,256,129,127,3,17,359,205,154,1,1993-10-03,-2,0,"ram",-31
"7","Thu","October 14","L","","2-4",FALSE,"Atlanta Falcons",24,30,22,450,283,167,3,16,311,208,103,1,1993-10-14,-2,0,"ram",-6
"8","Sun","October 24","L","","2-5",TRUE,"Detroit Lions",13,16,23,291,141,150,2,18,363,229,134,1,1993-10-24,-1,0,"ram",-3
"9","Sun","October 31","L","","2-6",FALSE,"San Francisco 49ers",17,40,16,220,110,110,3,24,374,245,129,1,1993-10-31,-2,0,"ram",-23
"11","Sun","November 14","L","","2-7",TRUE,"Atlanta Falcons",0,13,14,260,165,95,3,15,319,182,137,2,1993-11-14,-1,0,"ram",-13
"12","Sun","November 21","W","","3-7",TRUE,"Washington Redskins",10,6,12,282,193,89,1,16,273,159,114,1,1993-11-21,0,1,"ram",4
"13","Sun","November 28","L","","3-8",TRUE,"San Francisco 49ers",10,35,17,300,139,161,1,25,539,475,64,1,1993-11-28,0,0,"ram",-25
"14","Sun","December 5","L","","3-9",FALSE,"Phoenix Cardinals",10,38,16,303,151,152,2,22,382,245,137,0,1993-12-05,-2,0,"ram",-28
"15","Sun","December 12","W","","4-9",FALSE,"New Orleans Saints",23,20,16,306,40,266,1,24,364,267,97,3,1993-12-12,2,1,"ram",3
"16","Sun","December 19","L","","4-10",FALSE,"Cincinnati Bengals",3,15,14,273,107,166,2,20,393,223,170,0,1993-12-19,-2,0,"ram",-12
"17","Sun","December 26","L","","4-11",TRUE,"Cleveland Browns",14,42,20,382,287,95,3,23,315,213,102,0,1993-12-26,-3,0,"ram",-28
"18","Sun","January 2","W","","5-11",TRUE,"Chicago Bears",20,6,27,394,213,181,0,10,163,74,89,1,1994-01-02,1,1,"ram",14
"1","Sun","September 4","W","","1-0",TRUE,"Arizona Cardinals",14,12,9,152,102,50,2,23,234,128,106,3,1994-09-04,1,1,"ram",2
"2","Sun","September 11","L","","1-1",FALSE,"Atlanta Falcons",13,31,20,421,281,140,4,24,428,304,124,2,1994-09-11,-2,0,"ram",-18
"3","Sun","September 18","L","","1-2",TRUE,"San Francisco 49ers",19,34,22,278,163,115,1,28,454,349,105,1,1994-09-18,0,0,"ram",-15
"4","Sun","September 25","W","","2-2",FALSE,"Kansas City Chiefs",16,0,17,357,202,155,0,17,242,166,76,3,1994-09-25,3,1,"ram",16
"5","Sun","October 2","L","","2-3",TRUE,"Atlanta Falcons",5,8,16,246,120,126,2,23,366,285,81,1,1994-10-02,-1,0,"ram",-3
"6","Sun","October 9","L","","2-4",FALSE,"Green Bay Packers",17,24,13,211,147,64,2,21,292,208,84,2,1994-10-09,0,0,"ram",-7
"7","Sun","October 16","W","","3-4",TRUE,"New York Giants",17,10,17,274,169,105,1,14,282,161,121,2,1994-10-16,1,1,"ram",7
"8","Sun","October 23","L","","3-5",FALSE,"New Orleans Saints",34,37,13,242,157,85,3,18,314,196,118,1,1994-10-23,-2,0,"ram",-3
"10","Sun","November 6","W","","4-5",TRUE,"Denver Broncos",27,21,23,385,244,141,2,24,284,236,48,0,1994-11-06,-2,1,"ram",6
"11","Sun","November 13","L","","4-6",TRUE,"Los Angeles Raiders",17,20,20,290,268,22,1,18,303,208,95,1,1994-11-13,0,0,"ram",-3
"12","Sun","November 20","L","","4-7",FALSE,"San Francisco 49ers",27,31,17,358,272,86,0,32,459,325,134,1,1994-11-20,1,0,"ram",-4
"13","Sun","November 27","L","","4-8",FALSE,"San Diego Chargers",17,31,17,326,278,48,5,16,243,129,114,1,1994-11-27,-4,0,"ram",-14
"14","Sun","December 4","L","","4-9",TRUE,"New Orleans Saints",15,31,20,333,258,75,4,20,328,191,137,1,1994-12-04,-3,0,"ram",-16
"15","Sun","December 11","L","","4-10",FALSE,"Tampa Bay Buccaneers",14,24,19,261,198,63,2,17,355,230,125,0,1994-12-11,-2,0,"ram",-10
"16","Sun","December 18","L","","4-11",FALSE,"Chicago Bears",13,27,13,243,206,37,1,19,298,135,163,0,1994-12-18,-1,0,"ram",-14
"17","Sat","December 24","L","","4-12",TRUE,"Washington Redskins",21,24,18,370,293,77,1,19,288,138,150,1,1994-12-24,0,0,"ram",-3
"1","Sun","September 3","W","","1-0",FALSE,"Green Bay Packers",17,14,11,187,133,54,0,21,315,262,53,3,1995-09-03,3,1,"ram",3
"2","Sun","September 10","W","","2-0",TRUE,"New Orleans Saints",17,13,19,322,171,151,0,19,308,211,97,2,1995-09-10,2,1,"ram",4
"3","Sun","September 17","W","","3-0",FALSE,"Carolina Panthers",31,10,14,318,202,116,0,21,294,205,89,7,1995-09-17,7,1,"ram",21
"4","Sun","September 24","W","","4-0",TRUE,"Chicago Bears",34,28,22,339,233,106,0,20,364,317,47,2,1995-09-24,2,1,"ram",6
"5","Sun","October 1","L","","4-1",FALSE,"Indianapolis Colts",18,21,16,342,305,37,3,16,381,146,235,2,1995-10-01,-1,0,"ram",-3
"7","Thu","October 12","W","","5-1",TRUE,"Atlanta Falcons",21,19,24,451,318,133,2,10,192,148,44,0,1995-10-12,-2,1,"ram",2
"8","Sun","October 22","L","","5-2",TRUE,"San Francisco 49ers",10,44,16,355,284,71,4,17,257,144,113,0,1995-10-22,-4,0,"ram",-34
"9","Sun","October 29","L","","5-3",FALSE,"Philadelphia Eagles",9,20,24,328,224,104,4,15,274,160,114,1,1995-10-29,-3,0,"ram",-11
"10","Sun","November 5","L","","5-4",FALSE,"New Orleans Saints",10,19,12,224,144,80,2,24,321,168,153,2,1995-11-05,0,0,"ram",-9
"11","Sun","November 12","W","","6-4",TRUE,"Carolina Panthers",28,17,18,315,191,124,3,17,323,246,77,6,1995-11-12,3,1,"ram",11
"12","Sun","November 19","L","","6-5",FALSE,"Atlanta Falcons",6,31,19,351,280,71,3,22,440,325,115,0,1995-11-19,-3,0,"ram",-25
"13","Sun","November 26","L","","6-6",FALSE,"San Francisco 49ers",13,41,13,229,148,81,5,23,348,269,79,3,1995-11-26,-2,0,"ram",-28
"14","Sun","December 3","W","","7-6",FALSE,"New York Jets",23,20,13,210,134,76,4,13,249,188,61,2,1995-12-03,-2,1,"ram",3
"15","Sun","December 10","L","","7-7",TRUE,"Buffalo Bills",27,45,27,450,377,73,1,28,454,232,222,1,1995-12-10,0,0,"ram",-18
"16","Sun","December 17","L","","7-8",TRUE,"Washington Redskins",23,35,23,441,345,96,4,18,258,140,118,3,1995-12-17,-1,0,"ram",-12
"17","Sun","December 24","L","","7-9",TRUE,"Miami Dolphins",22,41,21,374,316,58,4,17,340,280,60,2,1995-12-24,-2,0,"ram",-19
"1","Sun","September 1","W","","1-0",TRUE,"Cincinnati Bengals",26,16,18,209,139,70,3,14,242,205,37,5,1996-09-01,2,1,"ram",10
"2","Sun","September 8","L","","1-1",FALSE,"San Francisco 49ers",0,34,6,105,69,36,4,23,352,222,130,0,1996-09-08,-4,0,"ram",-34
"4","Sun","September 22","L","","1-2",TRUE,"Washington Redskins",10,17,17,285,173,112,3,16,257,151,106,2,1996-09-22,-1,0,"ram",-7
"5","Sun","September 29","L","OT","1-3",FALSE,"Arizona Cardinals",28,31,10,222,162,60,3,27,498,348,150,1,1996-09-29,-2,0,"ram",-3
"6","Sun","October 6","L","","1-4",TRUE,"San Francisco 49ers",11,28,15,202,137,65,4,23,389,235,154,2,1996-10-06,-2,0,"ram",-17
"7","Sun","October 13","L","","1-5",FALSE,"Carolina Panthers",13,45,15,219,141,78,3,21,361,177,184,1,1996-10-13,-2,0,"ram",-32
"8","Sun","October 20","W","","2-5",TRUE,"Jacksonville Jaguars",17,14,8,204,121,83,1,36,538,420,118,6,1996-10-20,5,1,"ram",3
"9","Sun","October 27","L","OT","2-6",FALSE,"Baltimore Ravens",31,37,26,486,324,162,4,25,478,404,74,4,1996-10-27,0,0,"ram",-6
"10","Sun","November 3","L","","2-7",FALSE,"Pittsburgh Steelers",6,42,18,201,137,64,3,20,348,100,248,1,1996-11-03,-2,0,"ram",-36
"11","Sun","November 10","W","","3-7",TRUE,"Atlanta Falcons",59,16,29,464,185,279,1,15,292,248,44,3,1996-11-10,2,1,"ram",43
"12","Sun","November 17","L","","3-8",TRUE,"Carolina Panthers",10,20,15,243,121,122,1,22,255,108,147,2,1996-11-17,1,0,"ram",-10
"13","Sun","November 24","L","","3-9",TRUE,"Green Bay Packers",9,24,15,230,165,65,3,15,243,185,58,2,1996-11-24,-1,0,"ram",-15
"14","Sun","December 1","W","","4-9",FALSE,"New Orleans Saints",26,10,15,312,220,92,2,14,228,142,86,1,1996-12-01,-1,1,"ram",16
"15","Sun","December 8","L","","4-10",FALSE,"Chicago Bears",9,35,17,323,229,94,2,22,384,222,162,1,1996-12-08,-1,0,"ram",-26
"16","Sun","December 15","W","","5-10",FALSE,"Atlanta Falcons",34,27,17,480,306,174,4,24,423,360,63,7,1996-12-15,3,1,"ram",7
"17","Sat","December 21","W","","6-10",TRUE,"New Orleans Saints",14,13,14,187,136,51,3,12,241,148,93,1,1996-12-21,-2,1,"ram",1
"1","Sun","August 31","W","","1-0",TRUE,"New Orleans Saints",38,24,20,403,214,189,1,13,241,159,82,5,1997-08-31,4,1,"ram",14
"2","Sun","September 7","L","","1-1",TRUE,"San Francisco 49ers",12,15,11,203,104,99,4,12,228,93,135,4,1997-09-07,0,0,"ram",-3
"3","Sun","September 14","L","","1-2",FALSE,"Denver Broncos",14,35,18,314,184,130,2,19,377,233,144,2,1997-09-14,0,0,"ram",-21
"4","Sun","September 21","W","","2-2",TRUE,"New York Giants",13,3,15,225,133,92,1,11,194,147,47,2,1997-09-21,1,1,"ram",10
"5","Sun","September 28","L","","2-3",FALSE,"Oakland Raiders",17,35,20,374,255,119,3,20,383,213,170,2,1997-09-28,-1,0,"ram",-18
"7","Sun","October 12","L","","2-4",FALSE,"San Francisco 49ers",10,30,7,113,83,30,3,21,345,189,156,1,1997-10-12,-2,0,"ram",-20
"8","Sun","October 19","L","","2-5",TRUE,"Seattle Seahawks",9,17,10,192,155,37,1,27,357,251,106,2,1997-10-19,1,0,"ram",-8
"9","Sun","October 26","L","","2-6",TRUE,"Kansas City Chiefs",20,28,20,360,261,99,4,19,255,168,87,0,1997-10-26,-4,0,"ram",-8
"10","Sun","November 2","L","","2-7",FALSE,"Atlanta Falcons",31,34,24,507,399,108,1,28,462,265,197,1,1997-11-02,0,0,"ram",-3
"11","Sun","November 9","L","","2-8",FALSE,"Green Bay Packers",7,17,16,269,203,66,1,18,387,291,96,3,1997-11-09,2,0,"ram",-10
"12","Sun","November 16","L","","2-9",TRUE,"Atlanta Falcons",21,27,22,330,242,88,0,22,314,214,100,2,1997-11-16,2,0,"ram",-6
"13","Sun","November 23","L","","2-10",TRUE,"Carolina Panthers",10,16,12,268,187,81,1,17,302,254,48,1,1997-11-23,0,0,"ram",-6
"14","Sun","November 30","W","","3-10",FALSE,"Washington Redskins",23,20,19,398,284,114,0,19,301,240,61,2,1997-11-30,2,1,"ram",3
"15","Sun","December 7","W","","4-10",FALSE,"New Orleans Saints",34,27,23,343,229,114,3,16,284,240,44,4,1997-12-07,1,1,"ram",7
"16","Sun","December 14","L","","4-11",TRUE,"Chicago Bears",10,13,11,165,116,49,5,13,309,189,120,5,1997-12-14,0,0,"ram",-3
"17","Sat","December 20","W","","5-11",FALSE,"Carolina Panthers",30,18,23,297,149,148,0,21,327,233,94,3,1997-12-20,3,1,"ram",12
"1","Sun","September 6","L","","0-1",TRUE,"New Orleans Saints",17,24,23,314,267,47,2,15,232,197,35,1,1998-09-06,-1,0,"ram",-7
"2","Sun","September 13","L","","0-2",TRUE,"Minnesota Vikings",31,38,22,410,275,135,4,23,421,227,194,3,1998-09-13,-1,0,"ram",-7
"3","Sun","September 20","W","","1-2",FALSE,"Buffalo Bills",34,33,21,406,225,181,4,23,407,192,215,2,1998-09-20,-2,1,"ram",1
"4","Sun","September 27","L","","1-3",TRUE,"Arizona Cardinals",17,20,17,264,144,120,0,22,281,203,78,1,1998-09-27,1,0,"ram",-3
"6","Sun","October 11","W","","2-3",TRUE,"New York Jets",30,10,18,319,178,141,1,14,177,123,54,5,1998-10-11,4,1,"ram",20
"7","Sun","October 18","L","","2-4",FALSE,"Miami Dolphins",0,14,15,204,128,76,2,16,245,104,141,1,1998-10-18,-1,0,"ram",-14
"8","Sun","October 25","L","","2-5",TRUE,"San Francisco 49ers",10,28,15,168,89,79,4,16,303,210,93,2,1998-10-25,-2,0,"ram",-18
"9","Sun","November 1","L","","2-6",FALSE,"Atlanta Falcons",15,37,16,247,207,40,1,25,434,235,199,1,1998-11-01,0,0,"ram",-22
"10","Sun","November 8","W","","3-6",FALSE,"Chicago Bears",20,12,20,266,202,64,1,15,251,122,129,1,1998-11-08,0,1,"ram",8
"11","Sun","November 15","L","","3-7",FALSE,"New Orleans Saints",3,24,17,234,179,55,3,13,237,135,102,0,1998-11-15,-3,0,"ram",-21
"12","Sun","November 22","L","","3-8",TRUE,"Carolina Panthers",20,24,17,281,239,42,2,17,257,184,73,1,1998-11-22,-1,0,"ram",-4
"13","Sun","November 29","L","","3-9",TRUE,"Atlanta Falcons",10,21,12,169,129,40,0,20,374,170,204,1,1998-11-29,1,0,"ram",-11
"14","Thu","December 3","L","","3-10",FALSE,"Philadelphia Eagles",14,17,17,330,248,82,1,16,299,169,130,1,1998-12-03,0,0,"ram",-3
"15","Sun","December 13","W","","4-10",TRUE,"New England Patriots",32,18,18,278,162,116,3,14,319,119,200,2,1998-12-13,-1,1,"ram",14
"16","Sun","December 20","L","","4-11",FALSE,"Carolina Panthers",13,20,16,261,151,110,4,11,246,164,82,1,1998-12-20,-3,0,"ram",-7
"17","Sun","December 27","L","","4-12",FALSE,"San Francisco 49ers",19,38,17,321,264,57,1,22,397,277,120,0,1998-12-27,-1,0,"ram",-19
"1","Sun","September 12","W","","1-0",TRUE,"Baltimore Ravens",27,10,23,343,284,59,3,13,223,163,60,2,1999-09-12,-1,1,"ram",17
"3","Sun","September 26","W","","2-0",TRUE,"Atlanta Falcons",35,7,19,442,275,167,0,12,233,165,68,1,1999-09-26,1,1,"ram",28
"4","Sun","October 3","W","","3-0",FALSE,"Cincinnati Bengals",38,10,18,399,326,73,2,18,257,165,92,1,1999-10-03,-1,1,"ram",28
"5","Sun","October 10","W","","4-0",TRUE,"San Francisco 49ers",42,20,20,423,314,109,2,21,305,233,72,3,1999-10-10,1,1,"ram",22
"6","Sun","October 17","W","","5-0",FALSE,"Atlanta Falcons",41,13,17,283,94,189,1,16,316,270,46,3,1999-10-17,2,1,"ram",28
"7","Sun","October 24","W","","6-0",TRUE,"Cleveland Browns",34,3,27,436,225,211,0,13,272,178,94,3,1999-10-24,3,1,"ram",31
"8","Sun","October 31","L","","6-1",FALSE,"Tennessee Titans",21,24,23,415,287,128,3,17,281,178,103,0,1999-10-31,-3,0,"ram",-3
"9","Sun","November 7","L","","6-2",FALSE,"Detroit Lions",27,31,20,332,275,57,2,17,332,311,21,0,1999-11-07,-2,0,"ram",-4
"10","Sun","November 14","W","","7-2",TRUE,"Carolina Panthers",35,10,16,363,284,79,2,18,377,260,117,3,1999-11-14,1,1,"ram",25
"11","Sun","November 21","W","","8-2",FALSE,"San Francisco 49ers",23,7,21,345,181,164,1,14,251,145,106,5,1999-11-21,4,1,"ram",16
"12","Sun","November 28","W","","9-2",TRUE,"New Orleans Saints",43,12,24,324,195,129,0,20,365,263,102,2,1999-11-28,2,1,"ram",31
"13","Sun","December 5","W","","10-2",FALSE,"Carolina Panthers",34,21,22,480,358,122,3,14,307,252,55,3,1999-12-05,0,1,"ram",13
"14","Sun","December 12","W","","11-2",FALSE,"New Orleans Saints",30,14,23,492,336,156,2,13,210,144,66,3,1999-12-12,1,1,"ram",16
"15","Sun","December 19","W","","12-2",TRUE,"New York Giants",31,10,19,419,319,100,1,20,328,261,67,2,1999-12-19,1,1,"ram",21
"16","Sun","December 26","W","","13-2",TRUE,"Chicago Bears",34,12,23,476,361,115,2,24,434,365,69,3,1999-12-26,1,1,"ram",22
"17","Sun","January 2","L","","13-3",FALSE,"Philadelphia Eagles",31,38,20,440,239,201,7,13,207,156,51,2,2000-01-02,-5,0,"ram",-7
"Division","Sun","January 16","W","","14-3",TRUE,"Minnesota Vikings",49,37,23,405,374,31,3,27,475,388,87,3,2000-01-16,0,1,"ram",12
"ConfChamp","Sun","January 23","W","","15-3",TRUE,"Tampa Bay Buccaneers",11,6,17,309,258,51,3,12,203,126,77,2,2000-01-23,-1,1,"ram",5
"SuperBowl","Sun","January 30","W","","16-3",TRUE,"Tennessee Titans",23,16,23,436,407,29,0,27,367,208,159,0,2000-01-30,0,1,"ram",7
"1","Mon","September 4","W","","1-0",TRUE,"Denver Broncos",41,36,23,513,433,80,3,25,424,274,150,0,2000-09-04,-3,1,"ram",5
"2","Sun","September 10","W","","2-0",FALSE,"Seattle Seahawks",37,34,28,476,379,97,1,24,338,237,101,3,2000-09-10,2,1,"ram",3
"3","Sun","September 17","W","","3-0",TRUE,"San Francisco 49ers",41,24,32,529,389,140,2,16,401,290,111,2,2000-09-17,0,1,"ram",17
"4","Sun","September 24","W","","4-0",FALSE,"Atlanta Falcons",41,20,14,395,321,74,2,18,286,218,68,4,2000-09-24,2,1,"ram",21
"5","Sun","October 1","W","","5-0",TRUE,"San Diego Chargers",57,31,29,614,451,163,0,23,381,333,48,2,2000-10-01,2,1,"ram",26
"7","Sun","October 15","W","","6-0",TRUE,"Atlanta Falcons",45,29,29,529,302,227,1,21,259,198,61,1,2000-10-15,0,1,"ram",16
"8","Sun","October 22","L","","6-1",FALSE,"Kansas City Chiefs",34,54,24,428,362,66,4,21,468,362,106,0,2000-10-22,-4,0,"ram",-20
"9","Sun","October 29","W","","7-1",FALSE,"San Francisco 49ers",34,24,22,447,298,149,1,15,325,233,92,0,2000-10-29,-1,1,"ram",10
"10","Sun","November 5","L","","7-2",TRUE,"Carolina Panthers",24,27,20,426,395,31,2,18,268,178,90,2,2000-11-05,0,0,"ram",-3
"11","Sun","November 12","W","","8-2",FALSE,"New York Giants",38,24,28,397,256,141,1,14,348,213,135,3,2000-11-12,2,1,"ram",14
"12","Mon","November 20","L","","8-3",TRUE,"Washington Redskins",20,33,18,394,344,50,3,21,400,262,138,1,2000-11-20,-2,0,"ram",-13
"13","Sun","November 26","L","","8-4",TRUE,"New Orleans Saints",24,31,21,279,251,28,4,23,332,185,147,2,2000-11-26,-2,0,"ram",-7
"14","Sun","December 3","L","","8-5",FALSE,"Carolina Panthers",3,16,15,278,179,99,7,20,237,169,68,2,2000-12-03,-5,0,"ram",-13
"15","Sun","December 10","W","","9-5",TRUE,"Minnesota Vikings",40,29,32,508,346,162,0,23,312,208,104,0,2000-12-10,0,1,"ram",11
"16","Mon","December 18","L","","9-6",FALSE,"Tampa Bay Buccaneers",35,38,19,388,298,90,3,27,446,241,205,2,2000-12-18,-1,0,"ram",-3
"17","Sun","December 24","W","","10-6",FALSE,"New Orleans Saints",26,21,26,474,228,246,1,12,269,196,73,1,2000-12-24,0,1,"ram",5
"WildCard","Sat","December 30","L","","10-7",FALSE,"New Orleans Saints",28,31,17,384,350,34,5,17,301,251,50,2,2000-12-30,-3,0,"ram",-3
"1","Sun","September 9","W","OT","1-0",FALSE,"Philadelphia Eagles",20,17,22,364,282,82,2,19,334,277,57,3,2001-09-09,1,1,"ram",3
"2","Sun","September 23","W","","2-0",FALSE,"San Francisco 49ers",30,26,20,425,310,115,3,14,232,116,116,1,2001-09-23,-2,1,"ram",4
"3","Sun","September 30","W","","3-0",TRUE,"Miami Dolphins",42,10,27,441,318,123,0,15,253,189,64,4,2001-09-30,4,1,"ram",32
"4","Mon","October 8","W","","4-0",FALSE,"Detroit Lions",35,0,23,378,284,94,1,14,334,229,105,3,2001-10-08,2,1,"ram",35
"5","Sun","October 14","W","","5-0",TRUE,"New York Giants",15,14,19,315,274,41,4,16,324,227,97,2,2001-10-14,-2,1,"ram",1
"6","Sun","October 21","W","","6-0",FALSE,"New York Jets",34,14,22,448,214,234,2,17,266,134,132,1,2001-10-21,-1,1,"ram",20
"7","Sun","October 28","L","","6-1",TRUE,"New Orleans Saints",31,34,25,474,426,48,8,15,320,238,82,2,2001-10-28,-6,0,"ram",-3
"9","Sun","November 11","W","","7-1",TRUE,"Carolina Panthers",48,14,20,493,156,337,4,8,146,115,31,3,2001-11-11,-1,1,"ram",34
"10","Sun","November 18","W","","8-1",FALSE,"New England Patriots",24,17,26,482,396,86,3,13,230,179,51,3,2001-11-18,0,1,"ram",7
"11","Mon","November 26","L","","8-2",TRUE,"Tampa Bay Buccaneers",17,24,19,345,269,76,6,18,264,173,91,1,2001-11-26,-5,0,"ram",-7
"12","Sun","December 2","W","","9-2",FALSE,"Atlanta Falcons",35,6,19,422,333,89,0,20,320,192,128,2,2001-12-02,2,1,"ram",29
"13","Sun","December 9","W","","10-2",TRUE,"San Francisco 49ers",27,14,23,385,270,115,2,16,220,144,76,2,2001-12-09,0,1,"ram",13
"14","Mon","December 17","W","","11-2",FALSE,"New Orleans Saints",34,21,21,365,309,56,2,17,310,242,68,2,2001-12-17,0,1,"ram",13
"15","Sun","December 23","W","","12-2",FALSE,"Carolina Panthers",38,32,21,412,197,215,3,24,402,305,97,1,2001-12-23,-2,1,"ram",6
"16","Sun","December 30","W","","13-2",TRUE,"Indianapolis Colts",42,17,27,483,359,124,1,17,261,178,83,1,2001-12-30,0,1,"ram",25
"17","Sun","January 6","W","","14-2",TRUE,"Atlanta Falcons",31,13,23,458,266,192,3,13,255,159,96,3,2002-01-06,0,1,"ram",18
"Division","Sun","January 20","W","","15-2",TRUE,"Green Bay Packers",45,17,13,292,201,91,1,19,383,265,118,8,2002-01-20,7,1,"ram",28
"ConfChamp","Sun","January 27","W","","16-2",TRUE,"Philadelphia Eagles",29,24,22,371,210,161,0,16,256,146,110,2,2002-01-27,2,1,"ram",5
"SuperBowl","Sun","February 3","L","","16-3",TRUE,"New England Patriots",17,20,26,427,337,90,3,15,267,134,133,0,2002-02-03,-3,0,"ram",-3
"1","Sun","September 8","L","","0-1",FALSE,"Denver Broncos",16,23,15,327,295,32,2,18,291,187,104,2,2002-09-08,0,0,"ram",-7
"2","Sun","September 15","L","","0-2",TRUE,"New York Giants",21,26,18,352,260,92,4,16,394,291,103,1,2002-09-15,-3,0,"ram",-5
"3","Mon","September 23","L","","0-3",FALSE,"Tampa Bay Buccaneers",14,26,21,358,269,89,4,14,252,189,63,1,2002-09-23,-3,0,"ram",-12
"4","Sun","September 29","L","","0-4",TRUE,"Dallas Cowboys",10,13,19,366,273,93,3,17,315,193,122,2,2002-09-29,-1,0,"ram",-3
"5","Sun","October 6","L","","0-5",FALSE,"San Francisco 49ers",13,37,19,313,225,88,2,21,386,207,179,0,2002-10-06,-2,0,"ram",-24
"6","Sun","October 13","W","","1-5",TRUE,"Oakland Raiders",28,13,19,322,164,158,1,20,367,302,65,3,2002-10-13,2,1,"ram",15
"7","Sun","October 20","W","","2-5",TRUE,"Seattle Seahawks",37,20,28,478,260,218,2,13,290,240,50,3,2002-10-20,1,1,"ram",17
"9","Sun","November 3","W","","3-5",FALSE,"Arizona Cardinals",27,14,23,415,223,192,2,13,235,171,64,3,2002-11-03,1,1,"ram",13
"10","Sun","November 10","W","","4-5",TRUE,"San Diego Chargers",28,24,25,524,453,71,4,15,256,130,126,2,2002-11-10,-2,1,"ram",4
"11","Mon","November 18","W","","5-5",TRUE,"Chicago Bears",21,16,21,388,327,61,2,16,220,117,103,0,2002-11-18,-2,1,"ram",5
"12","Sun","November 24","L","","5-6",FALSE,"Washington Redskins",17,20,25,364,280,84,2,21,362,235,127,0,2002-11-24,-2,0,"ram",-3
"13","Sun","December 1","L","","5-7",FALSE,"Philadelphia Eagles",3,10,13,250,174,76,5,12,265,157,108,4,2002-12-01,-1,0,"ram",-7
"14","Sun","December 8","L","","5-8",FALSE,"Kansas City Chiefs",10,49,16,202,169,33,3,21,293,113,180,0,2002-12-08,-3,0,"ram",-39
"15","Sun","December 15","W","","6-8",TRUE,"Arizona Cardinals",30,28,20,366,300,66,2,20,378,249,129,2,2002-12-15,0,1,"ram",2
"16","Sun","December 22","L","","6-9",FALSE,"Seattle Seahawks",10,30,17,271,254,17,5,26,392,292,100,1,2002-12-22,-4,0,"ram",-20
"17","Mon","December 30","W","","7-9",TRUE,"San Francisco 49ers",31,20,16,263,228,35,2,19,329,136,193,2,2002-12-30,0,1,"ram",11
"1","Sun","September 7","L","","0-1",FALSE,"New York Giants",13,23,18,355,315,40,4,15,336,187,149,3,2003-09-07,-1,0,"ram",-10
"2","Sun","September 14","W","OT","1-1",TRUE,"San Francisco 49ers",27,24,21,278,190,88,4,20,390,242,148,1,2003-09-14,-3,1,"ram",3
"3","Sun","September 21","L","","1-2",FALSE,"Seattle Seahawks",23,24,19,308,226,82,3,20,316,220,96,1,2003-09-21,-2,0,"ram",-1
"4","Sun","September 28","W","","2-2",TRUE,"Arizona Cardinals",37,13,34,401,268,133,1,7,161,125,36,3,2003-09-28,2,1,"ram",24
"6","Mon","October 13","W","","3-2",TRUE,"Atlanta Falcons",36,0,26,496,377,119,3,9,209,136,73,4,2003-10-13,1,1,"ram",36
"7","Sun","October 19","W","","4-2",TRUE,"Green Bay Packers",34,24,22,370,239,131,2,22,372,256,116,4,2003-10-19,2,1,"ram",10
"8","Sun","October 26","W","","5-2",FALSE,"Pittsburgh Steelers",33,21,26,448,359,89,0,11,245,151,94,4,2003-10-26,4,1,"ram",12
"9","Sun","November 2","L","","5-3",FALSE,"San Francisco 49ers",10,30,18,340,331,9,3,24,389,224,165,2,2003-11-02,-1,0,"ram",-20
"10","Sun","November 9","W","","6-3",TRUE,"Baltimore Ravens",33,22,7,121,74,47,4,16,267,122,145,7,2003-11-09,3,1,"ram",11
"11","Sun","November 16","W","","7-3",FALSE,"Chicago Bears",23,21,22,320,208,112,3,13,241,146,95,2,2003-11-16,-1,1,"ram",2
"12","Sun","November 23","W","OT","8-3",FALSE,"Arizona Cardinals",30,27,26,415,298,117,5,15,358,192,166,2,2003-11-23,-3,1,"ram",3
"13","Sun","November 30","W","","9-3",TRUE,"Minnesota Vikings",48,17,21,396,255,141,1,25,465,276,189,3,2003-11-30,2,1,"ram",31
"14","Mon","December 8","W","","10-3",FALSE,"Cleveland Browns",26,20,18,328,210,118,1,18,309,147,162,4,2003-12-08,3,1,"ram",6
"15","Sun","December 14","W","","11-3",TRUE,"Seattle Seahawks",27,22,21,316,230,86,1,22,366,231,135,1,2003-12-14,0,1,"ram",5
"16","Sun","December 21","W","","12-3",TRUE,"Cincinnati Bengals",27,10,23,371,228,143,1,14,286,187,99,3,2003-12-21,2,1,"ram",17
"17","Sun","December 28","L","","12-4",FALSE,"Detroit Lions",20,30,13,194,153,41,3,21,342,230,112,2,2003-12-28,-1,0,"ram",-10
"Division","Sat","January 10","L","OT","12-5",TRUE,"Carolina Panthers",23,29,23,380,316,64,3,24,485,269,216,1,2004-01-10,-2,0,"ram",-6
"1","Sun","September 12","W","","1-0",TRUE,"Arizona Cardinals",17,10,27,448,272,176,3,14,260,157,103,0,2004-09-12,-3,1,"ram",7
"2","Sun","September 19","L","","1-1",FALSE,"Atlanta Falcons",17,34,14,280,250,30,2,22,416,174,242,0,2004-09-19,-2,0,"ram",-17
"3","Sun","September 26","L","OT","1-2",TRUE,"New Orleans Saints",25,28,25,403,325,78,1,27,462,316,146,0,2004-09-26,-1,0,"ram",-3
"4","Sun","October 3","W","","2-2",FALSE,"San Francisco 49ers",24,14,24,360,186,174,0,26,332,274,58,2,2004-10-03,2,1,"ram",10
"5","Sun","October 10","W","OT","3-2",FALSE,"Seattle Seahawks",33,27,21,441,317,124,3,20,391,204,187,0,2004-10-10,-3,1,"ram",6
"6","Mon","October 18","W","","4-2",TRUE,"Tampa Bay Buccaneers",28,21,14,324,230,94,2,17,332,277,55,4,2004-10-18,2,1,"ram",7
"7","Sun","October 24","L","","4-3",FALSE,"Miami Dolphins",14,31,20,372,269,103,1,19,323,206,117,0,2004-10-24,-1,0,"ram",-17
"9","Sun","November 7","L","","4-4",TRUE,"New England Patriots",22,40,21,340,259,81,3,22,376,229,147,1,2004-11-07,-2,0,"ram",-18
"10","Sun","November 14","W","","5-4",TRUE,"Seattle Seahawks",23,12,24,462,260,202,2,20,372,172,200,2,2004-11-14,0,1,"ram",11
"11","Sun","November 21","L","","5-5",FALSE,"Buffalo Bills",17,37,19,270,235,35,4,16,294,175,119,1,2004-11-21,-3,0,"ram",-20
"12","Mon","November 29","L","","5-6",FALSE,"Green Bay Packers",17,45,25,452,405,47,3,22,446,215,231,0,2004-11-29,-3,0,"ram",-28
"13","Sun","December 5","W","","6-6",TRUE,"San Francisco 49ers",16,6,19,350,214,136,2,9,160,97,63,1,2004-12-05,-1,1,"ram",10
"14","Sun","December 12","L","","6-7",FALSE,"Carolina Panthers",7,20,11,292,226,66,7,18,308,189,119,2,2004-12-12,-5,0,"ram",-13
"15","Sun","December 19","L","","6-8",FALSE,"Arizona Cardinals",7,31,12,185,163,22,2,26,402,271,131,1,2004-12-19,-1,0,"ram",-24
"16","Mon","December 27","W","","7-8",TRUE,"Philadelphia Eagles",20,7,24,419,210,209,1,11,155,74,81,1,2004-12-27,0,1,"ram",13
"17","Sun","January 2","W","OT","8-8",TRUE,"New York Jets",32,29,21,479,432,47,3,22,324,144,180,0,2005-01-02,-3,1,"ram",3
"WildCard","Sat","January 8","W","","9-8",FALSE,"Seattle Seahawks",27,20,22,396,294,102,1,24,413,332,81,1,2005-01-08,0,1,"ram",7
"Division","Sat","January 15","L","","9-9",FALSE,"Atlanta Falcons",17,47,19,339,262,77,2,18,397,70,327,1,2005-01-15,-1,0,"ram",-30
"1","Sun","September 11","L","","0-1",FALSE,"San Francisco 49ers",25,28,26,405,316,89,1,12,217,183,34,2,2005-09-11,1,0,"ram",-3
"2","Sun","September 18","W","","1-1",FALSE,"Arizona Cardinals",17,12,16,297,189,108,1,18,379,297,82,2,2005-09-18,1,1,"ram",5
"3","Sun","September 25","W","","2-1",TRUE,"Tennessee Titans",31,27,22,360,259,101,4,18,335,248,87,3,2005-09-25,-1,1,"ram",4
"4","Sun","October 2","L","","2-2",FALSE,"New York Giants",24,44,27,476,434,42,5,24,456,292,164,0,2005-10-02,-5,0,"ram",-20
"5","Sun","October 9","L","","2-3",TRUE,"Seattle Seahawks",31,37,20,386,309,77,2,26,433,299,134,0,2005-10-09,-2,0,"ram",-6
"6","Mon","October 17","L","","2-4",FALSE,"Indianapolis Colts",28,45,20,349,244,105,4,31,363,187,176,1,2005-10-17,-3,0,"ram",-17
"7","Sun","October 23","W","","3-4",TRUE,"New Orleans Saints",28,17,16,298,189,109,1,24,332,213,119,2,2005-10-23,1,1,"ram",11
"8","Sun","October 30","W","","4-4",TRUE,"Jacksonville Jaguars",24,21,15,386,186,200,3,16,427,206,221,2,2005-10-30,-1,1,"ram",3
"10","Sun","November 13","L","","4-5",FALSE,"Seattle Seahawks",16,31,22,353,278,75,2,21,417,243,174,2,2005-11-13,0,0,"ram",-15
"11","Sun","November 20","L","","4-6",TRUE,"Arizona Cardinals",28,38,19,357,351,6,2,27,372,278,94,1,2005-11-20,-1,0,"ram",-10
"12","Sun","November 27","W","OT","5-6",FALSE,"Houston Texans",33,27,22,429,291,138,1,26,412,288,124,2,2005-11-27,1,1,"ram",6
"13","Sun","December 4","L","","5-7",TRUE,"Washington Redskins",9,24,13,191,142,49,2,19,407,150,257,0,2005-12-04,-2,0,"ram",-15
"14","Sun","December 11","L","","5-8",FALSE,"Minnesota Vikings",13,27,20,337,229,108,6,16,259,146,113,2,2005-12-11,-4,0,"ram",-14
"15","Sun","December 18","L","","5-9",TRUE,"Philadelphia Eagles",16,17,16,305,127,178,1,13,201,76,125,4,2005-12-18,3,0,"ram",-1
"16","Sat","December 24","L","","5-10",TRUE,"San Francisco 49ers",20,24,20,389,345,44,2,15,321,104,217,0,2005-12-24,-2,0,"ram",-4
"17","Sun","January 1","W","","6-10",FALSE,"Dallas Cowboys",20,10,20,253,147,106,0,15,271,214,57,4,2006-01-01,4,1,"ram",10
"1","Sun","September 10","W","","1-0",TRUE,"Denver Broncos",18,10,16,320,195,125,0,17,259,98,161,5,2006-09-10,5,1,"ram",8
"2","Sun","September 17","L","","1-1",FALSE,"San Francisco 49ers",13,20,17,265,147,118,1,14,360,233,127,1,2006-09-17,0,0,"ram",-7
"3","Sun","September 24","W","","2-1",FALSE,"Arizona Cardinals",16,14,18,364,301,63,2,20,347,246,101,4,2006-09-24,2,1,"ram",2
"4","Sun","October 1","W","","3-1",TRUE,"Detroit Lions",41,34,23,427,321,106,0,21,370,277,93,3,2006-10-01,3,1,"ram",7
"5","Sun","October 8","W","","4-1",FALSE,"Green Bay Packers",23,20,19,327,209,118,0,20,336,215,121,2,2006-10-08,2,1,"ram",3
"6","Sun","October 15","L","","4-2",TRUE,"Seattle Seahawks",28,30,21,368,309,59,2,20,364,239,125,1,2006-10-15,-1,0,"ram",-2
"8","Sun","October 29","L","","4-3",FALSE,"San Diego Chargers",24,38,23,412,311,101,1,21,419,203,216,0,2006-10-29,-1,0,"ram",-14
"9","Sun","November 5","L","","4-4",TRUE,"Kansas City Chiefs",17,31,28,452,337,115,3,16,317,131,186,0,2006-11-05,-3,0,"ram",-14
"10","Sun","November 12","L","","4-5",FALSE,"Seattle Seahawks",22,24,18,299,191,108,1,19,283,123,160,2,2006-11-12,1,0,"ram",-2
"11","Sun","November 19","L","","4-6",FALSE,"Carolina Panthers",0,15,8,111,80,31,2,20,411,169,242,3,2006-11-19,1,0,"ram",-15
"12","Sun","November 26","W","","5-6",TRUE,"San Francisco 49ers",20,17,23,349,209,140,1,20,319,148,171,3,2006-11-26,2,1,"ram",3
"13","Sun","December 3","L","","5-7",TRUE,"Arizona Cardinals",20,34,26,394,287,107,3,24,316,179,137,0,2006-12-03,-3,0,"ram",-14
"14","Mon","December 11","L","","5-8",TRUE,"Chicago Bears",27,42,28,433,332,101,1,22,372,200,172,0,2006-12-11,-1,0,"ram",-15
"15","Sun","December 17","W","","6-8",FALSE,"Oakland Raiders",20,0,16,251,103,148,0,20,260,203,57,5,2006-12-17,5,1,"ram",20
"16","Sun","December 24","W","OT","7-8",TRUE,"Washington Redskins",37,31,25,579,382,197,1,22,336,160,176,1,2006-12-24,0,1,"ram",6
"17","Sun","December 31","W","","8-8",FALSE,"Minnesota Vikings",41,21,23,416,248,168,0,17,293,211,82,2,2006-12-31,2,1,"ram",20
"1","Sun","September 9","L","","0-1",TRUE,"Carolina Panthers",13,27,16,238,162,76,2,21,385,199,186,2,2007-09-09,0,0,"ram",-14
"2","Sun","September 16","L","","0-2",TRUE,"San Francisco 49ers",16,17,20,392,331,61,3,8,186,97,89,2,2007-09-16,-1,0,"ram",-1
"3","Sun","September 23","L","","0-3",FALSE,"Tampa Bay Buccaneers",3,24,18,245,109,136,3,22,322,140,182,1,2007-09-23,-2,0,"ram",-21
"4","Sun","September 30","L","","0-4",FALSE,"Dallas Cowboys",7,35,12,187,125,62,1,28,502,331,171,1,2007-09-30,0,0,"ram",-28
"5","Sun","October 7","L","","0-5",TRUE,"Arizona Cardinals",31,34,24,375,252,123,3,24,383,281,102,2,2007-10-07,-1,0,"ram",-3
"6","Sun","October 14","L","","0-6",FALSE,"Baltimore Ravens",3,22,14,264,197,67,6,14,248,171,77,2,2007-10-14,-4,0,"ram",-19
"7","Sun","October 21","L","","0-7",FALSE,"Seattle Seahawks",6,33,15,221,168,53,5,19,289,189,100,1,2007-10-21,-4,0,"ram",-27
"8","Sun","October 28","L","","0-8",TRUE,"Cleveland Browns",20,27,24,393,314,79,1,20,368,236,132,0,2007-10-28,-1,0,"ram",-7
"10","Sun","November 11","W","","1-8",FALSE,"New Orleans Saints",37,29,26,409,276,133,0,22,299,256,43,2,2007-11-11,2,1,"ram",8
"11","Sun","November 18","W","","2-8",FALSE,"San Francisco 49ers",13,9,15,207,105,102,0,13,244,212,32,2,2007-11-18,2,1,"ram",4
"12","Sun","November 25","L","","2-9",TRUE,"Seattle Seahawks",19,24,17,265,161,104,2,18,302,215,87,2,2007-11-25,0,0,"ram",-5
"13","Sun","December 2","W","","3-9",TRUE,"Atlanta Falcons",28,16,19,409,304,105,2,23,435,324,111,3,2007-12-02,1,1,"ram",12
"14","Sun","December 9","L","","3-10",FALSE,"Cincinnati Bengals",10,19,10,241,153,88,2,18,370,178,192,2,2007-12-09,0,0,"ram",-9
"15","Sun","December 16","L","","3-11",TRUE,"Green Bay Packers",14,33,21,364,191,173,2,17,277,225,52,3,2007-12-16,1,0,"ram",-19
"16","Thu","December 20","L","","3-12",TRUE,"Pittsburgh Steelers",24,41,17,316,226,90,2,24,425,259,166,0,2007-12-20,-2,0,"ram",-17
"17","Sun","December 30","L","","3-13",FALSE,"Arizona Cardinals",19,48,13,234,159,75,3,25,422,300,122,2,2007-12-30,-1,0,"ram",-29
"1","Sun","September 7","L","","0-1",FALSE,"Philadelphia Eagles",3,38,8,166,130,36,0,28,522,414,108,0,2008-09-07,0,0,"ram",-35
"2","Sun","September 14","L","","0-2",TRUE,"New York Giants",13,41,13,201,133,68,1,25,441,241,200,0,2008-09-14,-1,0,"ram",-28
"3","Sun","September 21","L","","0-3",FALSE,"Seattle Seahawks",13,37,14,240,175,65,2,24,407,162,245,1,2008-09-21,-1,0,"ram",-24
"4","Sun","September 28","L","","0-4",TRUE,"Buffalo Bills",14,31,16,380,213,167,2,14,277,166,111,1,2008-09-28,-1,0,"ram",-17
"6","Sun","October 12","W","","1-4",FALSE,"Washington Redskins",19,17,8,200,124,76,1,22,368,187,181,3,2008-10-12,2,1,"ram",2
"7","Sun","October 19","W","","2-4",TRUE,"Dallas Cowboys",34,14,18,325,135,190,0,17,341,217,124,4,2008-10-19,4,1,"ram",20
"8","Sun","October 26","L","","2-5",FALSE,"New England Patriots",16,23,15,358,268,90,1,23,348,250,98,2,2008-10-26,1,0,"ram",-7
"9","Sun","November 2","L","","2-6",TRUE,"Arizona Cardinals",13,34,13,231,170,61,3,24,510,334,176,0,2008-11-02,-3,0,"ram",-21
"10","Sun","November 9","L","","2-7",FALSE,"New York Jets",3,47,11,200,120,80,5,24,373,167,206,0,2008-11-09,-5,0,"ram",-44
"11","Sun","November 16","L","","2-8",FALSE,"San Francisco 49ers",16,35,22,406,280,126,3,19,334,199,135,2,2008-11-16,-1,0,"ram",-19
"12","Sun","November 23","L","","2-9",TRUE,"Chicago Bears",3,27,13,207,193,14,4,18,334,126,208,2,2008-11-23,-2,0,"ram",-24
"13","Sun","November 30","L","","2-10",TRUE,"Miami Dolphins",12,16,19,278,149,129,3,16,337,188,149,1,2008-11-30,-2,0,"ram",-4
"14","Sun","December 7","L","","2-11",FALSE,"Arizona Cardinals",10,34,17,308,223,85,3,18,335,272,63,1,2008-12-07,-2,0,"ram",-24
"15","Sun","December 14","L","","2-12",TRUE,"Seattle Seahawks",20,23,18,342,211,131,2,16,333,208,125,2,2008-12-14,0,0,"ram",-3
"16","Sun","December 21","L","","2-13",TRUE,"San Francisco 49ers",16,17,21,343,214,129,1,15,273,190,83,4,2008-12-21,3,0,"ram",-1
"17","Sun","December 28","L","","2-14",FALSE,"Atlanta Falcons",27,31,22,408,206,202,0,17,417,154,263,3,2008-12-28,3,0,"ram",-4
"1","Sun","September 13","L","","0-1",FALSE,"Seattle Seahawks",0,28,13,247,170,77,1,25,446,279,167,3,2009-09-13,2,0,"ram",-28
"2","Sun","September 20","L","","0-2",FALSE,"Washington Redskins",7,9,14,245,119,126,1,21,362,237,125,1,2009-09-20,0,0,"ram",-2
"3","Sun","September 27","L","","0-3",TRUE,"Green Bay Packers",17,36,22,336,187,149,3,24,402,250,152,0,2009-09-27,-3,0,"ram",-19
"4","Sun","October 4","L","","0-4",FALSE,"San Francisco 49ers",0,35,9,177,82,95,3,13,228,132,96,0,2009-10-04,-3,0,"ram",-35
"5","Sun","October 11","L","","0-5",TRUE,"Minnesota Vikings",10,38,27,400,278,122,4,21,377,288,89,1,2009-10-11,-3,0,"ram",-28
"6","Sun","October 18","L","OT","0-6",FALSE,"Jacksonville Jaguars",20,23,13,262,207,55,1,33,492,326,166,3,2009-10-18,2,0,"ram",-3
"7","Sun","October 25","L","","0-7",TRUE,"Indianapolis Colts",6,42,14,272,117,155,2,24,391,235,156,0,2009-10-25,-2,0,"ram",-36
"8","Sun","November 1","W","","1-7",FALSE,"Detroit Lions",17,10,21,362,212,150,1,17,289,162,127,1,2009-11-01,0,1,"ram",7
"10","Sun","November 15","L","","1-8",TRUE,"New Orleans Saints",23,28,23,434,293,141,1,19,420,217,203,3,2009-11-15,2,0,"ram",-5
"11","Sun","November 22","L","","1-9",TRUE,"Arizona Cardinals",13,21,16,314,191,123,1,24,444,261,183,2,2009-11-22,1,0,"ram",-8
"12","Sun","November 29","L","","1-10",TRUE,"Seattle Seahawks",17,27,23,364,251,113,2,15,265,95,170,1,2009-11-29,-1,0,"ram",-10
"13","Sun","December 6","L","","1-11",FALSE,"Chicago Bears",9,17,14,233,98,135,2,14,248,128,120,1,2009-12-06,-1,0,"ram",-8
"14","Sun","December 13","L","","1-12",FALSE,"Tennessee Titans",7,47,15,240,160,80,5,19,446,286,160,1,2009-12-13,-4,0,"ram",-40
"15","Sun","December 20","L","","1-13",TRUE,"Houston Texans",13,16,15,237,149,88,2,22,419,367,52,2,2009-12-20,0,0,"ram",-3
"16","Sun","December 27","L","","1-14",FALSE,"Arizona Cardinals",10,31,14,238,150,88,4,26,407,297,110,1,2009-12-27,-3,0,"ram",-21
"17","Sun","January 3","L","","1-15",TRUE,"San Francisco 49ers",6,28,6,109,22,87,0,16,329,204,125,0,2010-01-03,0,0,"ram",-22
"1","Sun","September 12","L","","0-1",TRUE,"Arizona Cardinals",13,17,20,325,240,85,4,21,378,266,112,4,2010-09-12,0,0,"ram",-4
"2","Sun","September 19","L","","0-2",FALSE,"Oakland Raiders",14,16,16,210,135,75,1,25,404,231,173,2,2010-09-19,1,0,"ram",-2
"3","Sun","September 26","W","","1-2",TRUE,"Washington Redskins",30,16,24,365,232,133,2,15,349,233,116,2,2010-09-26,0,1,"ram",14
"4","Sun","October 3","W","","2-2",TRUE,"Seattle Seahawks",20,3,19,349,261,88,1,15,257,193,64,2,2010-10-03,1,1,"ram",17
"5","Sun","October 10","L","","2-3",FALSE,"Detroit Lions",6,44,23,341,213,128,3,20,322,233,89,0,2010-10-10,-3,0,"ram",-38
"6","Sun","October 17","W","","3-3",TRUE,"San Diego Chargers",20,17,20,300,183,117,0,22,287,208,79,1,2010-10-17,1,1,"ram",3
"7","Sun","October 24","L","","3-4",FALSE,"Tampa Bay Buccaneers",17,18,19,285,124,161,1,17,313,189,124,0,2010-10-24,-1,0,"ram",-1
"8","Sun","October 31","W","","4-4",TRUE,"Carolina Panthers",20,10,15,246,184,62,0,14,201,176,25,4,2010-10-31,4,1,"ram",10
"10","Sun","November 14","L","OT","4-5",FALSE,"San Francisco 49ers",20,23,22,332,228,104,0,19,421,323,98,0,2010-11-14,0,0,"ram",-3
"11","Sun","November 21","L","","4-6",TRUE,"Atlanta Falcons",17,34,15,304,233,71,1,24,391,253,138,0,2010-11-21,-1,0,"ram",-17
"12","Sun","November 28","W","","5-6",FALSE,"Denver Broncos",36,33,24,431,308,123,0,24,449,330,119,2,2010-11-28,2,1,"ram",3
"13","Sun","December 5","W","","6-6",FALSE,"Arizona Cardinals",19,6,18,288,169,119,1,14,224,119,105,2,2010-12-05,1,1,"ram",13
"14","Sun","December 12","L","","6-7",FALSE,"New Orleans Saints",13,31,14,327,191,136,3,22,345,213,132,3,2010-12-12,0,0,"ram",-18
"15","Sun","December 19","L","","6-8",TRUE,"Kansas City Chiefs",13,27,14,224,155,69,2,21,383,173,210,1,2010-12-19,-1,0,"ram",-14
"16","Sun","December 26","W","","7-8",TRUE,"San Francisco 49ers",25,17,19,335,275,60,1,12,331,246,85,2,2010-12-26,1,1,"ram",8
"17","Sun","January 2","L","","7-9",FALSE,"Seattle Seahawks",6,16,10,184,137,47,1,19,333,192,141,1,2011-01-02,0,0,"ram",-10
"1","Sun","September 11","L","","0-1",TRUE,"Philadelphia Eagles",13,31,21,335,181,154,1,27,403,167,236,1,2011-09-11,0,0,"ram",-18
"2","Mon","September 19","L","","0-2",FALSE,"New York Giants",16,28,14,367,308,59,2,22,323,204,119,1,2011-09-19,-1,0,"ram",-12
"3","Sun","September 25","L","","0-3",TRUE,"Baltimore Ravens",7,37,17,244,132,112,2,25,553,385,168,1,2011-09-25,-1,0,"ram",-30
"4","Sun","October 2","L","","0-4",TRUE,"Washington Redskins",10,17,14,172,127,45,1,16,339,143,196,2,2011-10-02,1,0,"ram",-7
"6","Sun","October 16","L","","0-5",FALSE,"Green Bay Packers",3,24,22,424,306,118,1,20,399,309,90,1,2011-10-16,0,0,"ram",-21
"7","Sun","October 23","L","","0-6",FALSE,"Dallas Cowboys",7,34,13,265,195,70,2,24,445,151,294,1,2011-10-23,-1,0,"ram",-27
"8","Sun","October 30","W","","1-6",TRUE,"New Orleans Saints",31,21,21,323,140,183,1,8,283,227,56,2,2011-10-30,1,1,"ram",10
"9","Sun","November 6","L","OT","1-7",FALSE,"Arizona Cardinals",13,19,23,383,233,150,1,16,262,192,70,0,2011-11-06,-1,0,"ram",-6
"10","Sun","November 13","W","","2-7",FALSE,"Cleveland Browns",13,12,17,281,148,133,2,16,335,209,126,1,2011-11-13,-1,1,"ram",1
"11","Sun","November 20","L","","2-8",TRUE,"Seattle Seahawks",7,24,13,185,143,42,3,16,289,163,126,2,2011-11-20,-1,0,"ram",-17
"12","Sun","November 27","L","","2-9",TRUE,"Arizona Cardinals",20,23,12,272,186,86,2,16,374,106,268,3,2011-11-27,1,0,"ram",-3
"13","Sun","December 4","L","","2-10",FALSE,"San Francisco 49ers",0,26,10,157,126,31,2,18,389,245,144,0,2011-12-04,-2,0,"ram",-26
"14","Mon","December 12","L","","2-11",FALSE,"Seattle Seahawks",13,30,19,281,167,114,1,21,359,214,145,1,2011-12-12,0,0,"ram",-17
"15","Sun","December 18","L","","2-12",TRUE,"Cincinnati Bengals",13,20,18,305,210,95,0,19,283,173,110,1,2011-12-18,1,0,"ram",-7
"16","Sat","December 24","L","","2-13",FALSE,"Pittsburgh Steelers",0,27,15,232,68,164,0,17,377,208,169,1,2011-12-24,1,0,"ram",-27
"17","Sun","January 1","L","","2-14",TRUE,"San Francisco 49ers",27,34,18,311,200,111,2,21,321,205,116,0,2012-01-01,-2,0,"ram",-7
"1","Sun","September 8","W","OT","1-0",FALSE,"Cleveland Browns",27,24,15,286,186,100,0,19,357,181,176,3,1985-09-08,3,1,"crd",3
"2","Sun","September 15","W","","2-0",TRUE,"Cincinnati Bengals",41,27,27,447,237,210,2,20,370,254,116,2,1985-09-15,0,1,"crd",14
"3","Sun","September 22","L","","2-1",FALSE,"New York Giants",17,27,18,289,206,83,3,19,318,163,155,1,1985-09-22,-2,0,"crd",-10
"4","Sun","September 29","W","","3-1",TRUE,"Green Bay Packers",43,28,24,397,233,164,1,24,454,238,216,3,1985-09-29,2,1,"crd",15
"5","Mon","October 7","L","","3-2",FALSE,"Washington Redskins",10,27,17,310,215,95,6,17,305,67,238,2,1985-10-07,-4,0,"crd",-17
"6","Sun","October 13","L","","3-3",FALSE,"Philadelphia Eagles",7,30,12,268,187,81,2,18,354,243,111,0,1985-10-13,-2,0,"crd",-23
"7","Sun","October 20","L","","3-4",FALSE,"Pittsburgh Steelers",10,23,22,286,160,126,3,15,326,184,142,1,1985-10-20,-2,0,"crd",-13
"8","Sun","October 27","L","","3-5",TRUE,"Houston Oilers",10,20,22,427,240,187,1,13,229,171,58,2,1985-10-27,1,0,"crd",-10
"9","Mon","November 4","W","","4-5",TRUE,"Dallas Cowboys",21,10,19,286,237,49,0,18,248,159,89,3,1985-11-04,3,1,"crd",11
"10","Sun","November 10","L","","4-6",FALSE,"Tampa Bay Buccaneers",0,16,17,279,184,95,3,16,306,182,124,2,1985-11-10,-1,0,"crd",-16
"11","Sun","November 17","L","","4-7",TRUE,"Philadelphia Eagles",14,24,20,384,147,237,0,21,283,107,176,1,1985-11-17,1,0,"crd",-10
"12","Sun","November 24","L","","4-8",TRUE,"New York Giants",3,34,13,221,181,40,5,20,313,152,161,2,1985-11-24,-3,0,"crd",-31
"13","Thu","November 28","L","","4-9",FALSE,"Dallas Cowboys",17,35,24,365,281,84,3,23,393,277,116,1,1985-11-28,-2,0,"crd",-18
"14","Sun","December 8","W","","5-9",TRUE,"New Orleans Saints",28,16,24,383,197,186,0,21,287,216,71,2,1985-12-08,2,1,"crd",12
"15","Sun","December 15","L","","5-10",FALSE,"Los Angeles Rams",14,46,14,213,131,82,3,22,425,217,208,0,1985-12-15,-3,0,"crd",-32
"16","Sat","December 21","L","","5-11",TRUE,"Washington Redskins",16,27,13,245,90,155,2,28,413,192,221,2,1985-12-21,0,0,"crd",-11
"1","Sun","September 7","L","","0-1",TRUE,"Los Angeles Rams",10,16,14,247,177,70,2,17,269,70,199,2,1986-09-07,0,0,"crd",-6
"2","Sun","September 14","L","","0-2",FALSE,"Atlanta Falcons",13,33,15,265,159,106,1,23,342,152,190,0,1986-09-14,-1,0,"crd",-20
"3","Sun","September 21","L","","0-3",FALSE,"Buffalo Bills",10,17,25,381,259,122,1,10,176,82,94,1,1986-09-21,0,0,"crd",-7
"4","Mon","September 29","L","","0-4",TRUE,"Dallas Cowboys",7,31,13,225,92,133,4,18,287,180,107,2,1986-09-29,-2,0,"crd",-24
"5","Sun","October 5","L","","0-5",TRUE,"New York Giants",6,13,12,241,158,83,2,8,144,83,61,1,1986-10-05,-1,0,"crd",-7
"6","Sun","October 12","W","","1-5",FALSE,"Tampa Bay Buccaneers",30,19,23,431,213,218,1,19,347,257,90,0,1986-10-12,-1,1,"crd",11
"7","Sun","October 19","L","","1-6",FALSE,"Washington Redskins",21,28,20,242,124,118,1,21,354,232,122,3,1986-10-19,2,0,"crd",-7
"8","Sun","October 26","L","","1-7",FALSE,"Dallas Cowboys",6,37,11,200,152,48,1,30,445,268,177,1,1986-10-26,0,0,"crd",-31
"9","Sun","November 2","W","","2-7",TRUE,"Philadelphia Eagles",13,10,14,190,68,122,1,17,228,133,95,0,1986-11-02,-1,1,"crd",3
"10","Sun","November 9","L","","2-8",FALSE,"San Francisco 49ers",17,43,22,364,269,95,4,23,460,296,164,1,1986-11-09,-3,0,"crd",-26
"11","Sun","November 16","L","","2-9",TRUE,"New Orleans Saints",7,16,21,282,168,114,3,15,258,76,182,0,1986-11-16,-3,0,"crd",-9
"12","Sun","November 23","W","","3-9",TRUE,"Kansas City Chiefs",23,14,17,254,162,92,2,20,291,209,82,4,1986-11-23,2,1,"crd",9
"13","Sun","November 30","L","","3-10",TRUE,"Washington Redskins",17,20,13,271,123,148,0,23,353,256,97,1,1986-11-30,1,0,"crd",-3
"14","Sun","December 7","T","OT","3-10-1",FALSE,"Philadelphia Eagles",10,10,23,461,356,105,1,25,354,124,230,1,1986-12-07,0,0,"crd",0
"15","Sun","December 14","L","","3-11-1",FALSE,"New York Giants",7,27,15,184,100,84,2,20,313,62,251,2,1986-12-14,0,0,"crd",-20
"16","Sun","December 21","W","","4-11-1",TRUE,"Tampa Bay Buccaneers",21,17,15,265,136,129,3,15,243,157,86,3,1986-12-21,0,1,"crd",4
"1","Sun","September 13","W","","1-0",TRUE,"Dallas Cowboys",24,13,20,360,252,108,0,19,322,197,125,1,1987-09-13,1,1,"crd",11
"2","Sun","September 20","L","","1-1",FALSE,"San Diego Chargers",24,28,24,471,412,59,2,17,282,152,130,2,1987-09-20,0,0,"crd",-4
"3","Sun","October 4","L","","1-2",FALSE,"Washington Redskins",21,28,27,398,231,167,0,18,452,334,118,1,1987-10-04,1,0,"crd",-7
"4","Sun","October 11","W","","2-2",TRUE,"New Orleans Saints",24,19,9,143,4,139,1,30,368,155,213,4,1987-10-11,3,1,"crd",5
"5","Sun","October 18","L","","2-3",FALSE,"San Francisco 49ers",28,34,18,324,164,160,3,28,448,327,121,3,1987-10-18,0,0,"crd",-6
"6","Sun","October 25","L","","2-4",FALSE,"New York Giants",7,30,19,308,257,51,4,21,394,232,162,1,1987-10-25,-3,0,"crd",-23
"7","Sun","November 1","L","","2-5",TRUE,"Philadelphia Eagles",23,28,27,409,232,177,3,14,328,266,62,2,1987-11-01,-1,0,"crd",-5
"8","Sun","November 8","W","","3-5",TRUE,"Tampa Bay Buccaneers",31,28,26,415,278,137,2,26,377,294,83,1,1987-11-08,-1,1,"crd",3
"9","Sun","November 15","L","","3-6",TRUE,"Los Angeles Rams",24,27,19,280,156,124,1,21,383,144,239,2,1987-11-15,1,0,"crd",-3
"10","Sun","November 22","W","","4-6",FALSE,"Philadelphia Eagles",31,19,18,324,232,92,3,17,300,240,60,3,1987-11-22,0,1,"crd",12
"11","Sun","November 29","W","","5-6",FALSE,"Atlanta Falcons",34,21,24,476,363,113,2,18,267,147,120,4,1987-11-29,2,1,"crd",13
"12","Sun","December 6","L","","5-7",TRUE,"Washington Redskins",17,34,21,323,195,128,2,18,411,231,180,3,1987-12-06,1,0,"crd",-17
"13","Sun","December 13","W","","6-7",TRUE,"New York Giants",27,24,23,322,164,158,0,23,397,335,62,2,1987-12-13,2,1,"crd",3
"14","Sun","December 20","W","","7-7",FALSE,"Tampa Bay Buccaneers",31,14,24,351,217,134,2,19,370,207,163,4,1987-12-20,2,1,"crd",17
"15","Sun","December 27","L","","7-8",FALSE,"Dallas Cowboys",16,21,26,422,296,126,2,17,285,122,163,0,1987-12-27,-2,0,"crd",-5
"1","Sun","September 4","L","","0-1",FALSE,"Cincinnati Bengals",14,21,23,374,207,167,2,21,403,251,152,1,1988-09-04,-1,0,"crd",-7
"2","Mon","September 12","L","","0-2",TRUE,"Dallas Cowboys",14,17,22,367,237,130,1,18,352,162,190,1,1988-09-12,0,0,"crd",-3
"3","Sun","September 18","W","","1-2",FALSE,"Tampa Bay Buccaneers",30,24,24,475,294,181,0,15,298,184,114,3,1988-09-18,3,1,"crd",6
"4","Sun","September 25","W","","2-2",TRUE,"Washington Redskins",30,21,18,323,138,185,1,20,335,282,53,2,1988-09-25,1,1,"crd",9
"5","Sun","October 2","W","","3-2",FALSE,"Los Angeles Rams",41,27,30,519,332,187,1,23,353,268,85,3,1988-10-02,2,1,"crd",14
"6","Sun","October 9","W","","4-2",TRUE,"Pittsburgh Steelers",31,14,21,388,285,103,3,10,203,125,78,2,1988-10-09,-1,1,"crd",17
"7","Sun","October 16","L","","4-3",FALSE,"Washington Redskins",17,33,23,381,305,76,2,16,386,289,97,1,1988-10-16,-1,0,"crd",-16
"8","Sun","October 23","L","","4-4",TRUE,"Cleveland Browns",21,29,27,330,161,169,4,21,369,301,68,4,1988-10-23,0,0,"crd",-8
"9","Sun","October 30","W","","5-4",FALSE,"Dallas Cowboys",16,10,15,295,135,160,0,11,228,103,125,2,1988-10-30,2,1,"crd",6
"10","Sun","November 6","W","","6-4",TRUE,"San Francisco 49ers",24,23,21,355,288,67,3,22,357,117,240,0,1988-11-06,-3,1,"crd",1
"11","Sun","November 13","W","","7-4",TRUE,"New York Giants",24,17,24,495,351,144,2,21,280,188,92,0,1988-11-13,-2,1,"crd",7
"12","Sun","November 20","L","","7-5",FALSE,"Houston Oilers",20,38,17,314,254,60,2,23,385,261,124,0,1988-11-20,-2,0,"crd",-18
"13","Sun","November 27","L","","7-6",FALSE,"Philadelphia Eagles",21,31,25,369,202,167,5,17,292,201,91,4,1988-11-27,-1,0,"crd",-10
"14","Sun","December 4","L","","7-7",FALSE,"New York Giants",7,44,7,158,91,67,5,25,301,131,170,1,1988-12-04,-4,0,"crd",-37
"15","Sat","December 10","L","","7-8",TRUE,"Philadelphia Eagles",17,23,23,399,353,46,3,16,283,142,141,2,1988-12-10,-1,0,"crd",-6
"16","Sun","December 18","L","","7-9",TRUE,"Green Bay Packers",17,26,16,265,147,118,1,22,344,239,105,3,1988-12-18,2,0,"crd",-9
"1","Sun","September 10","W","","1-0",FALSE,"Detroit Lions",16,13,19,329,264,65,1,13,258,99,159,1,1989-09-10,0,1,"crd",3
"2","Sun","September 17","W","","2-0",FALSE,"Seattle Seahawks",34,24,25,469,298,171,2,23,346,269,77,1,1989-09-17,-1,1,"crd",10
"3","Sun","September 24","L","","2-1",FALSE,"New York Giants",7,35,16,248,183,65,6,16,366,204,162,1,1989-09-24,-5,0,"crd",-28
"4","Sun","October 1","L","","2-2",TRUE,"San Diego Chargers",13,24,17,301,232,69,4,13,268,165,103,0,1989-10-01,-4,0,"crd",-11
"5","Sun","October 8","L","","2-3",FALSE,"Washington Redskins",28,30,19,381,291,90,4,28,508,333,175,1,1989-10-08,-3,0,"crd",-2
"6","Sun","October 15","L","","2-4",TRUE,"Philadelphia Eagles",5,17,20,337,223,114,8,18,353,186,167,4,1989-10-15,-4,0,"crd",-12
"7","Sun","October 22","W","","3-4",TRUE,"Atlanta Falcons",34,20,21,299,174,125,1,22,351,240,111,2,1989-10-22,1,1,"crd",14
"8","Sun","October 29","W","","4-4",FALSE,"Dallas Cowboys",19,10,17,300,142,158,0,18,309,264,45,3,1989-10-29,3,1,"crd",9
"9","Sun","November 5","L","","4-5",TRUE,"New York Giants",13,20,14,186,111,75,1,22,384,174,210,2,1989-11-05,1,0,"crd",-7
"10","Sun","November 12","W","","5-5",TRUE,"Dallas Cowboys",24,20,15,385,316,69,0,21,444,367,77,4,1989-11-12,4,1,"crd",4
"11","Sun","November 19","L","","5-6",FALSE,"Los Angeles Rams",14,37,13,292,216,76,4,16,436,301,135,1,1989-11-19,-3,0,"crd",-23
"12","Sun","November 26","L","","5-7",TRUE,"Tampa Bay Buccaneers",13,14,12,237,194,43,2,23,260,139,121,2,1989-11-26,0,0,"crd",-1
"13","Sun","December 3","L","","5-8",TRUE,"Washington Redskins",10,29,15,263,234,29,3,23,303,168,135,1,1989-12-03,-2,0,"crd",-19
"14","Sun","December 10","L","","5-9",FALSE,"Los Angeles Raiders",14,16,18,248,126,122,2,19,384,230,154,1,1989-12-10,-1,0,"crd",-2
"15","Sat","December 16","L","","5-10",TRUE,"Denver Broncos",0,37,7,101,79,22,3,28,475,271,204,2,1989-12-16,-1,0,"crd",-37
"16","Sun","December 24","L","","5-11",FALSE,"Philadelphia Eagles",14,31,14,265,197,68,3,26,432,165,267,1,1989-12-24,-2,0,"crd",-17
"1","Sun","September 9","L","","0-1",FALSE,"Washington Redskins",0,31,20,294,206,88,5,19,347,229,118,0,1990-09-09,-5,0,"crd",-31
"2","Sun","September 16","W","","1-1",FALSE,"Philadelphia Eagles",23,21,14,234,89,145,1,17,327,223,104,3,1990-09-16,2,1,"crd",2
"3","Sun","September 23","L","","1-2",FALSE,"New Orleans Saints",7,28,15,297,186,111,2,21,297,146,151,1,1990-09-23,-1,0,"crd",-21
"4","Sun","September 30","L","","1-3",TRUE,"Washington Redskins",10,38,13,192,80,112,1,26,436,257,179,0,1990-09-30,-1,0,"crd",-28
"6","Sun","October 14","W","","2-3",TRUE,"Dallas Cowboys",20,3,23,414,191,223,2,9,100,34,66,3,1990-10-14,1,1,"crd",17
"7","Sun","October 21","L","","2-4",FALSE,"New York Giants",19,20,14,221,96,125,0,18,321,164,157,2,1990-10-21,2,0,"crd",-1
"8","Sun","October 28","L","","2-5",TRUE,"Chicago Bears",21,31,19,331,223,108,1,20,382,159,223,1,1990-10-28,0,0,"crd",-10
"9","Sun","November 4","L","","2-6",FALSE,"Miami Dolphins",3,23,11,205,131,74,2,20,350,205,145,1,1990-11-04,-1,0,"crd",-20
"10","Sun","November 11","L","","2-7",FALSE,"Buffalo Bills",14,45,11,127,46,81,4,20,360,154,206,2,1990-11-11,-2,0,"crd",-31
"11","Sun","November 18","L","","2-8",TRUE,"Green Bay Packers",21,24,21,441,280,161,2,22,375,250,125,2,1990-11-18,0,0,"crd",-3
"12","Sun","November 25","W","","3-8",TRUE,"New England Patriots",34,14,25,363,162,201,1,16,256,142,114,2,1990-11-25,1,1,"crd",20
"13","Sun","December 2","W","","4-8",TRUE,"Indianapolis Colts",20,17,17,276,144,132,1,14,251,142,109,2,1990-12-02,1,1,"crd",3
"14","Sun","December 9","W","","5-8",FALSE,"Atlanta Falcons",24,13,20,361,216,145,2,15,318,222,96,4,1990-12-09,2,1,"crd",11
"15","Sun","December 16","L","","5-9",FALSE,"Dallas Cowboys",10,41,9,200,151,49,4,25,354,166,188,3,1990-12-16,-1,0,"crd",-31
"16","Sun","December 23","L","","5-10",TRUE,"New York Giants",21,24,20,452,368,84,2,20,348,185,163,0,1990-12-23,-2,0,"crd",-3
"17","Sat","December 29","L","","5-11",TRUE,"Philadelphia Eagles",21,23,18,337,264,73,2,24,394,220,174,1,1990-12-29,-1,0,"crd",-2
"1","Sun","September 1","W","","1-0",FALSE,"Los Angeles Rams",24,14,13,193,124,69,0,25,375,276,99,7,1991-09-01,7,1,"crd",10
"2","Sun","September 8","W","","2-0",FALSE,"Philadelphia Eagles",26,10,10,297,217,80,2,17,307,229,78,6,1991-09-08,4,1,"crd",16
"3","Sun","September 15","L","","2-1",FALSE,"Washington Redskins",0,34,10,165,110,55,4,22,350,181,169,2,1991-09-15,-2,0,"crd",-34
"4","Sun","September 22","L","","2-2",TRUE,"Dallas Cowboys",9,17,20,322,220,102,1,11,320,139,181,1,1991-09-22,0,0,"crd",-8
"5","Sun","September 29","W","","3-2",TRUE,"New England Patriots",24,10,24,435,300,135,3,12,214,99,115,3,1991-09-29,0,1,"crd",14
"6","Sun","October 6","L","","3-3",FALSE,"New York Giants",9,20,21,307,214,93,2,19,368,200,168,1,1991-10-06,-1,0,"crd",-11
"7","Sun","October 13","L","","3-4",FALSE,"Minnesota Vikings",7,34,17,254,204,50,1,25,385,254,131,0,1991-10-13,-1,0,"crd",-27
"8","Sun","October 20","W","","4-4",TRUE,"Atlanta Falcons",16,10,16,266,98,168,2,15,318,211,107,5,1991-10-20,3,1,"crd",6
"9","Sun","October 27","L","","4-5",TRUE,"Minnesota Vikings",0,28,7,158,122,36,3,23,354,142,212,1,1991-10-27,-2,0,"crd",-28
"10","Sun","November 3","L","","4-6",FALSE,"Dallas Cowboys",7,27,16,239,130,109,3,22,286,165,121,2,1991-11-03,-1,0,"crd",-20
"11","Sun","November 10","L","","4-7",TRUE,"New York Giants",14,21,14,244,189,55,2,17,290,110,180,1,1991-11-10,-1,0,"crd",-7
"12","Sun","November 17","L","","4-8",FALSE,"San Francisco 49ers",10,14,13,176,112,64,0,22,257,169,88,1,1991-11-17,1,0,"crd",-4
"13","Sun","November 24","L","","4-9",TRUE,"Philadelphia Eagles",14,34,14,236,168,68,7,16,289,154,135,3,1991-11-24,-4,0,"crd",-20
"15","Sun","December 8","L","","4-10",TRUE,"Washington Redskins",14,20,11,194,128,66,2,21,384,249,135,1,1991-12-08,-1,0,"crd",-6
"16","Sun","December 15","L","","4-11",FALSE,"Denver Broncos",19,24,13,231,158,73,0,22,365,243,122,3,1991-12-15,3,0,"crd",-5
"17","Sun","December 22","L","","4-12",TRUE,"New Orleans Saints",3,27,18,245,173,72,7,12,190,95,95,1,1991-12-22,-6,0,"crd",-24
"1","Sun","September 6","L","","0-1",FALSE,"Tampa Bay Buccaneers",7,23,14,181,120,61,3,17,268,140,128,0,1992-09-06,-3,0,"crd",-16
"2","Sun","September 13","L","","0-2",TRUE,"Philadelphia Eagles",14,31,14,239,185,54,1,21,365,235,130,2,1992-09-13,1,0,"crd",-17
"3","Sun","September 20","L","","0-3",FALSE,"Dallas Cowboys",20,31,24,438,371,67,2,21,413,263,150,0,1992-09-20,-2,0,"crd",-11
"5","Sun","October 4","W","","1-3",TRUE,"Washington Redskins",27,24,21,266,163,103,2,19,365,258,107,3,1992-10-04,1,1,"crd",3
"6","Sun","October 11","L","","1-4",FALSE,"New York Giants",21,31,22,306,193,113,1,20,399,139,260,0,1992-10-11,-1,0,"crd",-10
"7","Sun","October 18","L","","1-5",TRUE,"New Orleans Saints",21,30,15,254,194,60,1,20,399,349,50,1,1992-10-18,0,0,"crd",-9
"8","Sun","October 25","L","","1-6",FALSE,"Philadelphia Eagles",3,7,13,253,158,95,4,11,247,84,163,1,1992-10-25,-3,0,"crd",-4
"9","Sun","November 1","W","","2-6",TRUE,"San Francisco 49ers",24,14,21,342,197,145,2,19,330,267,63,4,1992-11-01,2,1,"crd",10
"10","Sun","November 8","W","","3-6",FALSE,"Los Angeles Rams",20,14,18,324,216,108,0,19,302,248,54,3,1992-11-08,3,1,"crd",6
"11","Sun","November 15","L","","3-7",FALSE,"Atlanta Falcons",17,20,15,271,239,32,4,19,337,223,114,3,1992-11-15,-1,0,"crd",-3
"12","Sun","November 22","L","","3-8",TRUE,"Dallas Cowboys",10,16,9,149,103,46,1,18,334,237,97,1,1992-11-22,0,0,"crd",-6
"13","Sun","November 29","L","","3-9",FALSE,"Washington Redskins",3,41,14,308,255,53,6,22,334,191,143,2,1992-11-29,-4,0,"crd",-38
"14","Sun","December 6","L","","3-10",TRUE,"San Diego Chargers",21,27,20,323,227,96,5,14,296,267,29,2,1992-12-06,-3,0,"crd",-6
"15","Sat","December 12","W","","4-10",TRUE,"New York Giants",19,0,18,280,101,179,1,8,131,61,70,3,1992-12-12,2,1,"crd",19
"16","Sun","December 20","L","","4-11",FALSE,"Indianapolis Colts",13,16,18,290,131,159,3,21,366,319,47,2,1992-12-20,-1,0,"crd",-3
"17","Sun","December 27","L","","4-12",TRUE,"Tampa Bay Buccaneers",3,7,21,353,233,120,6,12,240,210,30,1,1992-12-27,-5,0,"crd",-4
"1","Sun","September 5","L","","0-1",FALSE,"Philadelphia Eagles",17,23,14,231,183,48,2,22,359,192,167,3,1993-09-05,1,0,"crd",-6
"2","Sun","September 12","W","","1-1",FALSE,"Washington Redskins",17,10,17,303,151,152,2,14,233,175,58,2,1993-09-12,0,1,"crd",7
"3","Sun","September 19","L","","1-2",TRUE,"Dallas Cowboys",10,17,14,273,205,68,1,23,410,280,130,0,1993-09-19,-1,0,"crd",-7
"4","Sun","September 26","L","","1-3",FALSE,"Detroit Lions",20,26,20,343,264,79,3,11,330,183,147,0,1993-09-26,-3,0,"crd",-6
"6","Sun","October 10","L","","1-4",TRUE,"New England Patriots",21,23,13,311,187,124,3,25,432,281,151,1,1993-10-10,-2,0,"crd",-2
"7","Sun","October 17","W","","2-4",TRUE,"Washington Redskins",36,6,18,380,224,156,1,16,246,108,138,4,1993-10-17,3,1,"crd",30
"8","Sun","October 24","L","","2-5",FALSE,"San Francisco 49ers",14,28,25,429,322,107,3,26,428,280,148,1,1993-10-24,-2,0,"crd",-14
"9","Sun","October 31","L","","2-6",TRUE,"New Orleans Saints",17,20,10,143,54,89,2,18,272,176,96,2,1993-10-31,0,0,"crd",-3
"10","Sun","November 7","W","","3-6",TRUE,"Philadelphia Eagles",16,3,21,359,116,243,1,12,201,136,65,1,1993-11-07,0,1,"crd",13
"11","Sun","November 14","L","","3-7",FALSE,"Dallas Cowboys",15,20,15,265,214,51,3,15,311,224,87,2,1993-11-14,-1,0,"crd",-5
"13","Sun","November 28","L","","3-8",FALSE,"New York Giants",17,19,19,303,176,127,1,17,374,328,46,0,1993-11-28,-1,0,"crd",-2
"14","Sun","December 5","W","","4-8",TRUE,"Los Angeles Rams",38,10,22,382,245,137,0,16,303,151,152,2,1993-12-05,2,1,"crd",28
"15","Sun","December 12","L","","4-9",TRUE,"Detroit Lions",14,21,19,287,191,96,3,13,340,235,105,2,1993-12-12,-1,0,"crd",-7
"16","Sun","December 19","W","OT","5-9",FALSE,"Seattle Seahawks",30,27,26,476,405,71,4,19,365,153,212,1,1993-12-19,-3,1,"crd",3
"17","Sun","December 26","W","","6-9",TRUE,"New York Giants",17,6,20,333,189,144,2,16,293,215,78,1,1993-12-26,-1,1,"crd",11
"18","Sun","January 2","W","","7-9",FALSE,"Atlanta Falcons",27,10,22,395,278,117,0,16,270,189,81,4,1994-01-02,4,1,"crd",17
"1","Sun","September 4","L","","0-1",FALSE,"Los Angeles Rams",12,14,23,234,128,106,3,9,152,102,50,2,1994-09-04,-1,0,"crd",-2
"2","Sun","September 11","L","","0-2",TRUE,"New York Giants",17,20,11,174,135,39,3,19,206,88,118,2,1994-09-11,-1,0,"crd",-3
"3","Sun","September 18","L","","0-3",FALSE,"Cleveland Browns",0,32,21,318,255,63,3,17,322,243,79,2,1994-09-18,-1,0,"crd",-32
"5","Sun","October 2","W","","1-3",TRUE,"Minnesota Vikings",17,7,21,309,200,109,2,19,358,340,18,4,1994-10-02,2,1,"crd",10
"6","Sun","October 9","L","","1-4",FALSE,"Dallas Cowboys",3,38,10,221,168,53,5,22,351,273,78,0,1994-10-09,-5,0,"crd",-35
"7","Sun","October 16","W","OT","2-4",FALSE,"Washington Redskins",19,16,19,324,173,151,3,11,234,149,85,5,1994-10-16,2,1,"crd",3
"8","Sun","October 23","L","","2-5",TRUE,"Dallas Cowboys",21,28,22,315,208,107,0,14,312,237,75,0,1994-10-23,0,0,"crd",-7
"9","Sun","October 30","W","OT","3-5",TRUE,"Pittsburgh Steelers",20,17,16,335,236,99,1,12,317,232,85,3,1994-10-30,2,1,"crd",3
"10","Sun","November 6","L","","3-6",FALSE,"Philadelphia Eagles",7,17,21,254,181,73,2,18,322,172,150,1,1994-11-06,-1,0,"crd",-10
"11","Sun","November 13","W","","4-6",FALSE,"New York Giants",10,9,18,239,173,66,1,17,231,81,150,1,1994-11-13,0,1,"crd",1
"12","Sun","November 20","W","","5-6",TRUE,"Philadelphia Eagles",12,6,16,281,123,158,1,14,185,110,75,2,1994-11-20,1,1,"crd",6
"13","Sun","November 27","L","OT","5-7",TRUE,"Chicago Bears",16,19,15,244,177,67,1,20,318,186,132,2,1994-11-27,1,0,"crd",-3
"14","Sun","December 4","W","","6-7",FALSE,"Houston Oilers",30,12,18,332,171,161,1,10,198,161,37,6,1994-12-04,5,1,"crd",18
"15","Sun","December 11","W","","7-7",TRUE,"Washington Redskins",17,15,14,278,194,84,1,19,406,283,123,2,1994-12-11,1,1,"crd",2
"16","Sun","December 18","W","","8-7",TRUE,"Cincinnati Bengals",28,7,24,364,212,152,0,12,189,125,64,3,1994-12-18,3,1,"crd",21
"17","Sat","December 24","L","","8-8",FALSE,"Atlanta Falcons",6,10,18,385,313,72,2,12,307,256,51,1,1994-12-24,-1,0,"crd",-4
"1","Sun","September 3","L","","0-1",FALSE,"Washington Redskins",7,27,10,197,88,109,4,20,456,197,259,2,1995-09-03,-2,0,"crd",-20
"2","Sun","September 10","L","","0-2",TRUE,"Philadelphia Eagles",19,31,17,274,244,30,2,19,338,170,168,1,1995-09-10,-1,0,"crd",-12
"3","Sun","September 17","W","","1-2",FALSE,"Detroit Lions",20,17,18,230,109,121,0,19,358,198,160,3,1995-09-17,3,1,"crd",3
"4","Sun","September 24","L","","1-3",FALSE,"Dallas Cowboys",20,34,22,381,329,52,3,26,440,251,189,1,1995-09-24,-2,0,"crd",-14
"5","Sun","October 1","L","","1-4",TRUE,"Kansas City Chiefs",3,24,16,296,240,56,3,17,293,72,221,2,1995-10-01,-1,0,"crd",-21
"6","Sun","October 8","L","OT","1-5",FALSE,"New York Giants",21,27,29,431,291,140,3,23,344,158,186,4,1995-10-08,1,0,"crd",-6
"7","Sun","October 15","W","","2-5",TRUE,"Washington Redskins",24,20,20,311,198,113,2,13,259,217,42,1,1995-10-15,-1,1,"crd",4
"9","Sun","October 29","W","OT","3-5",TRUE,"Seattle Seahawks",20,14,20,305,190,115,4,17,428,198,230,7,1995-10-29,3,1,"crd",6
"10","Sun","November 5","L","","3-6",FALSE,"Denver Broncos",6,38,18,277,203,74,2,24,406,258,148,1,1995-11-05,-1,0,"crd",-32
"11","Sun","November 12","L","OT","3-7",TRUE,"Minnesota Vikings",24,30,20,322,204,118,2,22,391,302,89,1,1995-11-12,-1,0,"crd",-6
"12","Sun","November 19","L","","3-8",FALSE,"Carolina Panthers",7,27,7,96,62,34,2,23,370,182,188,1,1995-11-19,-1,0,"crd",-20
"13","Sun","November 26","W","OT","4-8",TRUE,"Atlanta Falcons",40,37,28,513,392,121,4,15,294,260,34,4,1995-11-26,0,1,"crd",3
"14","Thu","November 30","L","","4-9",TRUE,"New York Giants",6,10,17,342,250,92,3,14,199,133,66,1,1995-11-30,-2,0,"crd",-4
"15","Sat","December 9","L","","4-10",FALSE,"San Diego Chargers",25,28,13,282,250,32,1,20,380,288,92,6,1995-12-09,5,0,"crd",-3
"16","Sun","December 17","L","","4-11",FALSE,"Philadelphia Eagles",20,21,18,324,231,93,5,11,274,198,76,4,1995-12-17,-1,0,"crd",-1
"17","Mon","December 25","L","","4-12",TRUE,"Dallas Cowboys",13,37,12,285,222,63,3,27,474,373,101,3,1995-12-25,0,0,"crd",-24
"1","Sun","September 1","L","","0-1",FALSE,"Indianapolis Colts",13,20,20,310,226,84,0,19,312,238,74,1,1996-09-01,1,0,"crd",-7
"2","Sun","September 8","L","","0-2",TRUE,"Miami Dolphins",10,38,13,203,176,27,4,26,331,203,128,1,1996-09-08,-3,0,"crd",-28
"3","Sun","September 15","L","","0-3",FALSE,"New England Patriots",0,31,9,170,124,46,4,26,384,221,163,0,1996-09-15,-4,0,"crd",-31
"4","Sun","September 22","W","","1-3",FALSE,"New Orleans Saints",28,14,20,432,165,267,2,15,218,142,76,3,1996-09-22,1,1,"crd",14
"5","Sun","September 29","W","OT","2-3",TRUE,"St. Louis Rams",31,28,27,498,348,150,1,10,222,162,60,3,1996-09-29,2,1,"crd",3
"7","Sun","October 13","L","","2-4",FALSE,"Dallas Cowboys",3,17,13,178,120,58,1,22,324,199,125,1,1996-10-13,0,0,"crd",-14
"8","Sun","October 20","W","","3-4",TRUE,"Tampa Bay Buccaneers",13,9,21,237,133,104,0,19,313,218,95,0,1996-10-20,0,1,"crd",4
"9","Sun","October 27","L","","3-5",TRUE,"New York Jets",21,31,19,353,246,107,1,27,454,246,208,3,1996-10-27,2,0,"crd",-10
"10","Sun","November 3","L","","3-6",FALSE,"New York Giants",8,16,14,245,216,29,2,17,279,144,135,0,1996-11-03,-2,0,"crd",-8
"11","Sun","November 10","W","OT","4-6",FALSE,"Washington Redskins",37,34,32,615,507,108,5,25,416,212,204,2,1996-11-10,-3,1,"crd",3
"12","Sun","November 17","W","","5-6",TRUE,"New York Giants",31,23,20,347,250,97,3,24,331,240,91,4,1996-11-17,1,1,"crd",8
"13","Sun","November 24","W","","6-6",TRUE,"Philadelphia Eagles",36,30,27,447,340,107,1,22,359,292,67,2,1996-11-24,1,1,"crd",6
"14","Sun","December 1","L","","6-7",FALSE,"Minnesota Vikings",17,41,18,280,245,35,3,29,412,263,149,0,1996-12-01,-3,0,"crd",-24
"15","Sun","December 8","L","","6-8",TRUE,"Dallas Cowboys",6,10,20,347,213,134,4,15,334,254,80,2,1996-12-08,-2,0,"crd",-4
"16","Sun","December 15","W","","7-8",TRUE,"Washington Redskins",27,26,20,299,221,78,2,19,329,249,80,1,1996-12-15,-1,1,"crd",1
"17","Sun","December 22","L","","7-9",FALSE,"Philadelphia Eagles",19,29,15,229,158,71,2,22,343,216,127,2,1996-12-22,0,0,"crd",-10
"1","Sun","August 31","L","","0-1",FALSE,"Cincinnati Bengals",21,24,18,323,248,75,2,21,317,230,87,1,1997-08-31,-1,0,"crd",-3
"2","Sun","September 7","W","OT","1-1",TRUE,"Dallas Cowboys",25,22,21,286,220,66,4,15,327,147,180,1,1997-09-07,-3,1,"crd",3
"3","Sun","September 14","L","OT","1-2",FALSE,"Washington Redskins",13,19,14,234,116,118,2,17,328,252,76,1,1997-09-14,-1,0,"crd",-6
"5","Sun","September 28","L","","1-3",FALSE,"Tampa Bay Buccaneers",18,19,23,364,294,70,3,6,167,113,54,1,1997-09-28,-2,0,"crd",-1
"6","Sun","October 5","L","","1-4",TRUE,"Minnesota Vikings",19,20,22,385,277,108,1,20,353,272,81,3,1997-10-05,2,0,"crd",-1
"7","Sun","October 12","L","","1-5",TRUE,"New York Giants",13,27,19,235,208,27,5,23,426,187,239,1,1997-10-12,-4,0,"crd",-14
"8","Sun","October 19","L","OT","1-6",FALSE,"Philadelphia Eagles",10,13,15,235,143,92,1,25,407,277,130,4,1997-10-19,3,0,"crd",-3
"9","Sun","October 26","L","","1-7",TRUE,"Tennessee Oilers",14,41,22,263,157,106,7,15,283,135,148,0,1997-10-26,-7,0,"crd",-27
"10","Sun","November 2","W","","2-7",TRUE,"Philadelphia Eagles",31,21,17,231,141,90,2,18,360,265,95,4,1997-11-02,2,1,"crd",10
"11","Sun","November 9","L","","2-8",FALSE,"Dallas Cowboys",6,24,18,274,173,101,1,19,329,204,125,1,1997-11-09,0,0,"crd",-18
"12","Sun","November 16","L","","2-9",FALSE,"New York Giants",10,19,21,399,350,49,3,21,373,172,201,0,1997-11-16,-3,0,"crd",-9
"13","Sun","November 23","W","","3-9",FALSE,"Baltimore Ravens",16,13,15,273,202,71,2,17,314,185,129,0,1997-11-23,-2,1,"crd",3
"14","Sun","November 30","L","OT","3-10",TRUE,"Pittsburgh Steelers",20,26,18,291,243,48,0,25,342,165,177,0,1997-11-30,0,0,"crd",-6
"15","Sun","December 7","L","","3-11",TRUE,"Washington Redskins",28,38,14,358,301,57,3,17,362,223,139,1,1997-12-07,-2,0,"crd",-10
"16","Sun","December 14","L","","3-12",FALSE,"New Orleans Saints",10,27,18,265,154,111,4,17,382,252,130,1,1997-12-14,-3,0,"crd",-17
"17","Sun","December 21","W","","4-12",TRUE,"Atlanta Falcons",29,26,20,297,231,66,2,22,356,167,189,1,1997-12-21,-1,1,"crd",3
"1","Sun","September 6","L","","0-1",FALSE,"Dallas Cowboys",10,38,13,205,160,45,2,30,444,256,188,3,1998-09-06,1,0,"crd",-28
"2","Sun","September 13","L","","0-2",FALSE,"Seattle Seahawks",14,33,17,274,163,111,4,16,244,121,123,2,1998-09-13,-2,0,"crd",-19
"3","Sun","September 20","W","","1-2",TRUE,"Philadelphia Eagles",17,3,16,282,129,153,1,20,317,226,91,3,1998-09-20,2,1,"crd",14
"4","Sun","September 27","W","","2-2",FALSE,"St. Louis Rams",20,17,22,281,203,78,1,17,264,144,120,0,1998-09-27,-1,1,"crd",3
"5","Sun","October 4","L","","2-3",TRUE,"Oakland Raiders",20,23,16,236,187,49,4,14,222,110,112,3,1998-10-04,-1,0,"crd",-3
"6","Sun","October 11","W","","3-3",TRUE,"Chicago Bears",20,7,21,288,150,138,5,12,289,223,66,8,1998-10-11,3,1,"crd",13
"7","Sun","October 18","L","","3-4",FALSE,"New York Giants",7,34,15,194,132,62,3,26,390,249,141,0,1998-10-18,-3,0,"crd",-27
"9","Sun","November 1","W","","4-4",FALSE,"Detroit Lions",17,15,11,209,172,37,2,18,280,167,113,6,1998-11-01,4,1,"crd",2
"10","Sun","November 8","W","","5-4",TRUE,"Washington Redskins",29,27,23,351,164,187,1,18,256,167,89,2,1998-11-08,1,1,"crd",2
"11","Sun","November 15","L","","5-5",TRUE,"Dallas Cowboys",28,35,28,480,448,32,2,23,354,208,146,0,1998-11-15,-2,0,"crd",-7
"12","Sun","November 22","W","","6-5",FALSE,"Washington Redskins",45,42,25,436,248,188,1,31,421,353,68,2,1998-11-22,1,1,"crd",3
"13","Sun","November 29","L","","6-6",FALSE,"Kansas City Chiefs",24,34,22,338,214,124,2,20,376,248,128,1,1998-11-29,-1,0,"crd",-10
"14","Sun","December 6","L","","6-7",TRUE,"New York Giants",19,23,17,328,253,75,3,15,344,144,200,2,1998-12-06,-1,0,"crd",-4
"15","Sun","December 13","W","OT","7-7",FALSE,"Philadelphia Eagles",20,17,25,424,220,204,2,21,367,219,148,1,1998-12-13,-1,1,"crd",3
"16","Sun","December 20","W","","8-7",TRUE,"New Orleans Saints",19,17,28,513,394,119,3,18,320,238,82,1,1998-12-20,-2,1,"crd",2
"17","Sun","December 27","W","","9-7",TRUE,"San Diego Chargers",16,13,16,270,245,25,0,22,377,203,174,5,1998-12-27,5,1,"crd",3
"WildCard","Sat","January 2","W","","10-7",FALSE,"Dallas Cowboys",20,7,14,346,213,133,2,20,260,164,96,3,1999-01-02,1,1,"crd",13
"Division","Sun","January 10","L","","10-8",FALSE,"Minnesota Vikings",21,41,23,316,242,74,3,26,416,228,188,1,1999-01-10,-2,0,"crd",-20
"1","Sun","September 12","W","","1-0",FALSE,"Philadelphia Eagles",25,24,23,344,266,78,4,13,205,67,138,4,1999-09-12,0,1,"crd",1
"2","Sun","September 19","L","","1-1",FALSE,"Miami Dolphins",16,19,13,184,120,64,4,14,304,221,83,4,1999-09-19,0,0,"crd",-3
"3","Mon","September 27","L","","1-2",TRUE,"San Francisco 49ers",10,24,20,250,149,101,4,18,322,112,210,1,1999-09-27,-3,0,"crd",-14
"4","Sun","October 3","L","","1-3",FALSE,"Dallas Cowboys",7,35,12,208,137,71,5,17,306,192,114,1,1999-10-03,-4,0,"crd",-28
"5","Sun","October 10","W","","2-3",TRUE,"New York Giants",14,3,13,206,175,31,0,15,285,178,107,2,1999-10-10,2,1,"crd",11
"6","Sun","October 17","L","","2-4",TRUE,"Washington Redskins",10,24,15,274,207,67,3,24,410,243,167,3,1999-10-17,0,0,"crd",-14
"8","Sun","October 31","L","","2-5",TRUE,"New England Patriots",3,27,8,166,90,76,2,17,386,244,142,0,1999-10-31,-2,0,"crd",-24
"9","Sun","November 7","L","","2-6",FALSE,"New York Jets",7,12,10,206,151,55,1,15,295,111,184,0,1999-11-07,-1,0,"crd",-5
"10","Sun","November 14","W","","3-6",TRUE,"Detroit Lions",23,19,17,343,184,159,1,17,373,331,42,1,1999-11-14,0,1,"crd",4
"11","Sun","November 21","W","","4-6",TRUE,"Dallas Cowboys",13,9,13,207,105,102,2,15,258,102,156,0,1999-11-21,-2,1,"crd",4
"12","Sun","November 28","W","","5-6",FALSE,"New York Giants",34,24,23,291,222,69,1,20,334,282,52,4,1999-11-28,3,1,"crd",10
"13","Sun","December 5","W","","6-6",TRUE,"Philadelphia Eagles",21,17,16,227,173,54,2,18,294,148,146,2,1999-12-05,0,1,"crd",4
"14","Sun","December 12","L","","6-7",FALSE,"Washington Redskins",3,28,10,173,120,53,4,25,406,180,226,2,1999-12-12,-2,0,"crd",-25
"15","Sun","December 19","L","","6-8",TRUE,"Buffalo Bills",21,31,14,178,108,70,1,25,376,217,159,2,1999-12-19,1,0,"crd",-10
"16","Sun","December 26","L","","6-9",FALSE,"Atlanta Falcons",14,37,17,289,212,77,2,22,393,230,163,0,1999-12-26,-2,0,"crd",-23
"17","Sun","January 2","L","","6-10",FALSE,"Green Bay Packers",24,49,30,464,384,80,4,26,475,299,176,1,2000-01-02,-3,0,"crd",-25
"1","Sun","September 3","L","","0-1",FALSE,"New York Giants",16,21,19,355,312,43,4,20,395,172,223,2,2000-09-03,-2,0,"crd",-5
"2","Sun","September 10","W","","1-1",TRUE,"Dallas Cowboys",32,31,21,322,224,98,1,17,330,240,90,2,2000-09-10,1,1,"crd",1
"4","Sun","September 24","L","","1-2",TRUE,"Green Bay Packers",3,29,12,209,181,28,4,23,455,279,176,1,2000-09-24,-3,0,"crd",-26
"5","Sun","October 1","L","","1-3",FALSE,"San Francisco 49ers",20,27,16,365,239,126,2,18,345,215,130,1,2000-10-01,-1,0,"crd",-7
"6","Sun","October 8","W","","2-3",TRUE,"Cleveland Browns",29,21,20,315,169,146,2,12,240,136,104,0,2000-10-08,-2,1,"crd",8
"7","Sun","October 15","L","","2-4",TRUE,"Philadelphia Eagles",14,33,17,305,207,98,3,28,391,219,172,0,2000-10-15,-3,0,"crd",-19
"8","Sun","October 22","L","","2-5",FALSE,"Dallas Cowboys",7,48,15,276,167,109,3,23,347,147,200,0,2000-10-22,-3,0,"crd",-41
"9","Sun","October 29","L","","2-6",TRUE,"New Orleans Saints",10,21,24,394,269,125,4,17,247,158,89,1,2000-10-29,-3,0,"crd",-11
"10","Sun","November 5","W","","3-6",TRUE,"Washington Redskins",16,15,11,178,133,45,2,27,422,258,164,3,2000-11-05,1,1,"crd",1
"11","Sun","November 12","L","","3-7",FALSE,"Minnesota Vikings",14,31,14,249,198,51,2,29,460,302,158,2,2000-11-12,0,0,"crd",-17
"12","Sun","November 19","L","","3-8",FALSE,"Philadelphia Eagles",9,34,12,210,156,54,1,21,338,204,134,2,2000-11-19,1,0,"crd",-25
"13","Sun","November 26","L","","3-9",TRUE,"New York Giants",7,31,14,267,179,88,4,25,371,225,146,1,2000-11-26,-3,0,"crd",-24
"14","Sun","December 3","L","","3-10",FALSE,"Cincinnati Bengals",13,24,15,340,268,72,2,27,398,106,292,1,2000-12-03,-1,0,"crd",-11
"15","Sun","December 10","L","","3-11",FALSE,"Jacksonville Jaguars",10,44,11,189,149,40,1,25,469,255,214,0,2000-12-10,-1,0,"crd",-34
"16","Sun","December 17","L","","3-12",TRUE,"Baltimore Ravens",7,13,18,309,258,51,4,14,214,37,177,2,2000-12-17,-2,0,"crd",-6
"17","Sun","December 24","L","","3-13",FALSE,"Washington Redskins",3,20,14,245,141,104,5,19,315,175,140,2,2000-12-24,-3,0,"crd",-17
"2","Sun","September 23","L","","0-1",TRUE,"Denver Broncos",17,38,14,308,224,84,3,27,381,234,147,0,2001-09-23,-3,0,"crd",-21
"3","Sun","September 30","L","","0-2",TRUE,"Atlanta Falcons",14,34,21,335,245,90,4,21,379,268,111,0,2001-09-30,-4,0,"crd",-20
"4","Sun","October 7","W","","1-2",FALSE,"Philadelphia Eagles",21,20,19,329,232,97,1,19,440,261,179,2,2001-10-07,1,1,"crd",1
"5","Sun","October 14","L","","1-3",FALSE,"Chicago Bears",13,20,16,288,206,82,1,13,253,116,137,3,2001-10-14,2,0,"crd",-7
"6","Sun","October 21","W","","2-3",TRUE,"Kansas City Chiefs",24,16,20,363,228,135,2,20,459,340,119,2,2001-10-21,0,1,"crd",8
"7","Sun","October 28","L","","2-4",FALSE,"Dallas Cowboys",3,17,17,292,217,75,4,15,225,80,145,2,2001-10-28,-2,0,"crd",-14
"8","Sun","November 4","L","","2-5",TRUE,"Philadelphia Eagles",7,21,20,327,270,57,2,13,332,219,113,1,2001-11-04,-1,0,"crd",-14
"9","Sun","November 11","L","","2-6",TRUE,"New York Giants",10,17,12,213,135,78,3,20,334,148,186,1,2001-11-11,-2,0,"crd",-7
"10","Sun","November 18","W","","3-6",TRUE,"Detroit Lions",45,38,23,417,328,89,1,30,478,429,49,3,2001-11-18,2,1,"crd",7
"11","Sun","November 25","W","","4-6",FALSE,"San Diego Chargers",20,17,18,298,227,71,2,20,392,308,84,1,2001-11-25,-1,1,"crd",3
"12","Sun","December 2","W","OT","5-6",FALSE,"Oakland Raiders",34,31,24,390,245,145,1,26,436,301,135,3,2001-12-02,2,1,"crd",3
"13","Sun","December 9","L","","5-7",TRUE,"Washington Redskins",10,20,17,326,246,80,1,17,331,201,130,0,2001-12-09,-1,0,"crd",-10
"14","Sat","December 15","L","","5-8",FALSE,"New York Giants",13,17,19,285,197,88,1,15,244,139,105,0,2001-12-15,-1,0,"crd",-4
"15","Sun","December 23","W","","6-8",TRUE,"Dallas Cowboys",17,10,11,209,134,75,0,21,343,169,174,3,2001-12-23,3,1,"crd",7
"16","Sun","December 30","W","","7-8",FALSE,"Carolina Panthers",30,7,16,331,173,158,0,20,318,223,95,2,2001-12-30,2,1,"crd",23
"17","Sun","January 6","L","","7-9",FALSE,"Washington Redskins",17,20,10,187,142,45,1,22,340,162,178,1,2002-01-06,0,0,"crd",-3
"1","Sun","September 8","L","","0-1",FALSE,"Washington Redskins",23,31,14,257,187,70,1,21,442,320,122,1,2002-09-08,0,0,"crd",-8
"2","Sun","September 15","W","","1-1",FALSE,"Seattle Seahawks",24,13,19,347,98,249,1,26,426,345,81,1,2002-09-15,0,1,"crd",11
"3","Sun","September 22","L","","1-2",TRUE,"San Diego Chargers",15,23,15,297,200,97,3,19,289,164,125,1,2002-09-22,-2,0,"crd",-8
"4","Sun","September 29","W","","2-2",TRUE,"New York Giants",21,7,18,263,161,102,1,14,263,196,67,3,2002-09-29,2,1,"crd",14
"5","Sun","October 6","W","","3-2",FALSE,"Carolina Panthers",16,13,18,312,221,91,1,12,244,186,58,4,2002-10-06,3,1,"crd",3
"7","Sun","October 20","W","OT","4-2",TRUE,"Dallas Cowboys",9,6,22,380,228,152,1,14,342,194,148,4,2002-10-20,3,1,"crd",3
"8","Sun","October 27","L","","4-3",FALSE,"San Francisco 49ers",28,38,23,420,269,151,4,18,357,252,105,0,2002-10-27,-4,0,"crd",-10
"9","Sun","November 3","L","","4-4",TRUE,"St. Louis Rams",14,27,13,235,171,64,3,23,415,223,192,2,2002-11-03,-1,0,"crd",-13
"10","Sun","November 10","L","","4-5",TRUE,"Seattle Seahawks",6,27,19,337,226,111,5,27,406,255,151,0,2002-11-10,-5,0,"crd",-21
"11","Sun","November 17","L","","4-6",FALSE,"Philadelphia Eagles",14,38,15,248,124,124,1,26,462,250,212,2,2002-11-17,1,0,"crd",-24
"12","Sun","November 24","L","","4-7",TRUE,"Oakland Raiders",20,41,15,263,131,132,3,28,520,333,187,1,2002-11-24,-2,0,"crd",-21
"13","Sun","December 1","L","","4-8",FALSE,"Kansas City Chiefs",0,49,10,122,96,26,4,27,477,261,216,1,2002-12-01,-3,0,"crd",-49
"14","Sun","December 8","W","OT","5-8",TRUE,"Detroit Lions",23,20,21,313,180,133,1,15,203,152,51,1,2002-12-08,0,1,"crd",3
"15","Sun","December 15","L","","5-9",FALSE,"St. Louis Rams",28,30,20,378,249,129,2,20,366,300,66,2,2002-12-15,0,0,"crd",-2
"16","Sat","December 21","L","","5-10",TRUE,"San Francisco 49ers",14,17,14,184,76,108,2,21,358,252,106,2,2002-12-21,0,0,"crd",-3
"17","Sun","December 29","L","","5-11",FALSE,"Denver Broncos",7,37,18,207,123,84,2,24,450,191,259,0,2002-12-29,-2,0,"crd",-30
"1","Sun","September 7","L","","0-1",FALSE,"Detroit Lions",24,42,21,434,339,95,3,16,261,195,66,0,2003-09-07,-3,0,"crd",-18
"2","Sun","September 14","L","","0-2",TRUE,"Seattle Seahawks",0,38,18,286,193,93,6,16,323,193,130,0,2003-09-14,-6,0,"crd",-38
"3","Sun","September 21","W","","1-2",TRUE,"Green Bay Packers",20,13,21,354,273,81,1,18,311,245,66,2,2003-09-21,1,1,"crd",7
"4","Sun","September 28","L","","1-3",FALSE,"St. Louis Rams",13,37,7,161,125,36,3,34,401,268,133,1,2003-09-28,-2,0,"crd",-24
"5","Sun","October 5","L","","1-4",FALSE,"Dallas Cowboys",7,24,9,151,119,32,2,18,365,268,97,1,2003-10-05,-1,0,"crd",-17
"6","Sun","October 12","L","","1-5",TRUE,"Baltimore Ravens",18,26,16,320,230,90,3,13,285,72,213,0,2003-10-12,-3,0,"crd",-8
"8","Sun","October 26","W","OT","2-5",TRUE,"San Francisco 49ers",16,13,18,314,93,221,1,15,255,149,106,1,2003-10-26,0,1,"crd",3
"9","Sun","November 2","W","","3-5",TRUE,"Cincinnati Bengals",17,14,20,304,143,161,1,17,263,215,48,2,2003-11-02,1,1,"crd",3
"10","Sun","November 9","L","","3-6",FALSE,"Pittsburgh Steelers",15,28,19,379,283,96,1,11,246,159,87,1,2003-11-09,0,0,"crd",-13
"11","Sun","November 16","L","","3-7",FALSE,"Cleveland Browns",6,44,10,187,146,41,4,27,481,392,89,0,2003-11-16,-4,0,"crd",-38
"12","Sun","November 23","L","OT","3-8",TRUE,"St. Louis Rams",27,30,15,358,192,166,2,26,415,298,117,5,2003-11-23,3,0,"crd",-3
"13","Sun","November 30","L","","3-9",FALSE,"Chicago Bears",3,28,9,197,151,46,3,25,422,268,154,1,2003-11-30,-2,0,"crd",-25
"14","Sun","December 7","L","","3-10",FALSE,"San Francisco 49ers",14,50,18,210,151,59,2,30,496,264,232,1,2003-12-07,-1,0,"crd",-36
"15","Sun","December 14","L","","3-11",TRUE,"Carolina Panthers",17,20,23,317,146,171,2,17,298,231,67,2,2003-12-14,0,0,"crd",-3
"16","Sun","December 21","L","","3-12",FALSE,"Seattle Seahawks",10,28,17,299,220,79,1,23,340,180,160,4,2003-12-21,3,0,"crd",-18
"17","Sun","December 28","W","","4-12",TRUE,"Minnesota Vikings",18,17,15,219,155,64,1,20,342,192,150,2,2003-12-28,1,1,"crd",1
"1","Sun","September 12","L","","0-1",FALSE,"St. Louis Rams",10,17,14,260,157,103,0,27,448,272,176,3,2004-09-12,3,0,"crd",-7
"2","Sun","September 19","L","","0-2",TRUE,"New England Patriots",12,23,14,167,117,50,2,24,379,207,172,3,2004-09-19,1,0,"crd",-11
"3","Sun","September 26","L","","0-3",FALSE,"Atlanta Falcons",3,6,13,240,179,61,4,15,283,89,194,4,2004-09-26,0,0,"crd",-3
"4","Sun","October 3","W","","1-3",TRUE,"New Orleans Saints",34,10,19,373,162,211,1,14,279,238,41,2,2004-10-03,1,1,"crd",24
"5","Sun","October 10","L","OT","1-4",FALSE,"San Francisco 49ers",28,31,19,320,217,103,1,28,448,391,57,2,2004-10-10,1,0,"crd",-3
"7","Sun","October 24","W","","2-4",TRUE,"Seattle Seahawks",25,17,16,316,189,127,2,12,257,180,77,4,2004-10-24,2,1,"crd",8
"8","Sun","October 31","L","","2-5",FALSE,"Buffalo Bills",14,38,14,213,85,128,0,11,209,81,128,0,2004-10-31,0,0,"crd",-24
"9","Sun","November 7","W","","3-5",FALSE,"Miami Dolphins",24,23,17,270,149,121,1,22,403,235,168,2,2004-11-07,1,1,"crd",1
"10","Sun","November 14","W","","4-5",TRUE,"New York Giants",17,14,18,178,74,104,0,19,308,161,147,0,2004-11-14,0,1,"crd",3
"11","Sun","November 21","L","","4-6",FALSE,"Carolina Panthers",10,35,23,399,314,85,4,16,317,160,157,1,2004-11-21,-3,0,"crd",-25
"12","Sun","November 28","L","","4-7",TRUE,"New York Jets",3,13,17,245,174,71,4,16,325,179,146,0,2004-11-28,-4,0,"crd",-10
"13","Sun","December 5","L","","4-8",FALSE,"Detroit Lions",12,26,15,254,160,94,4,16,398,183,215,1,2004-12-05,-3,0,"crd",-14
"14","Sun","December 12","L","OT","4-9",TRUE,"San Francisco 49ers",28,31,25,374,299,75,2,23,352,184,168,1,2004-12-12,-1,0,"crd",-3
"15","Sun","December 19","W","","5-9",TRUE,"St. Louis Rams",31,7,26,402,271,131,1,12,185,163,22,2,2004-12-19,1,1,"crd",24
"16","Sun","December 26","L","","5-10",FALSE,"Seattle Seahawks",21,24,18,317,220,97,2,16,301,126,175,1,2004-12-26,-1,0,"crd",-3
"17","Sun","January 2","W","","6-10",TRUE,"Tampa Bay Buccaneers",12,7,12,222,115,107,1,11,249,187,62,4,2005-01-02,3,1,"crd",5
"1","Sun","September 11","L","","0-1",FALSE,"New York Giants",19,42,20,318,287,31,2,14,275,154,121,2,2005-09-11,0,0,"crd",-23
"2","Sun","September 18","L","","0-2",TRUE,"St. Louis Rams",12,17,18,379,297,82,2,16,297,189,108,1,2005-09-18,-1,0,"crd",-5
"3","Sun","September 25","L","","0-3",FALSE,"Seattle Seahawks",12,37,15,266,176,90,2,29,447,284,163,0,2005-09-25,-2,0,"crd",-25
"4","Sun","October 2","W","","1-3",TRUE,"San Francisco 49ers",31,14,24,463,366,97,3,8,168,117,51,4,2005-10-02,1,1,"crd",17
"5","Sun","October 9","L","","1-4",TRUE,"Carolina Panthers",20,24,19,468,396,72,4,15,330,243,87,2,2005-10-09,-2,0,"crd",-4
"7","Sun","October 23","W","","2-4",TRUE,"Tennessee Titans",20,10,9,173,118,55,1,16,348,258,90,3,2005-10-23,2,1,"crd",10
"8","Sun","October 30","L","","2-5",FALSE,"Dallas Cowboys",13,34,12,213,142,71,2,21,348,202,146,1,2005-10-30,-1,0,"crd",-21
"9","Sun","November 6","L","","2-6",TRUE,"Seattle Seahawks",19,33,23,378,307,71,4,22,370,162,208,0,2005-11-06,-4,0,"crd",-14
"10","Sun","November 13","L","","2-7",FALSE,"Detroit Lions",21,29,21,397,359,38,1,22,383,226,157,0,2005-11-13,-1,0,"crd",-8
"11","Sun","November 20","W","","3-7",FALSE,"St. Louis Rams",38,28,27,372,278,94,1,19,357,351,6,2,2005-11-20,1,1,"crd",10
"12","Sun","November 27","L","","3-8",TRUE,"Jacksonville Jaguars",17,24,23,368,301,67,2,19,295,133,162,0,2005-11-27,-2,0,"crd",-7
"13","Sun","December 4","W","","4-8",FALSE,"San Francisco 49ers",17,10,18,404,339,65,2,11,220,169,51,4,2005-12-04,2,1,"crd",7
"14","Sun","December 11","L","","4-9",TRUE,"Washington Redskins",13,17,17,302,240,62,4,16,231,122,109,3,2005-12-11,-1,0,"crd",-4
"15","Sun","December 18","L","","4-10",FALSE,"Houston Texans",19,30,16,301,262,39,4,18,253,134,119,2,2005-12-18,-2,0,"crd",-11
"16","Sat","December 24","W","","5-10",TRUE,"Philadelphia Eagles",27,21,19,360,285,75,1,11,189,146,43,1,2005-12-24,0,1,"crd",6
"17","Sun","January 1","L","","5-11",FALSE,"Indianapolis Colts",13,17,23,413,284,129,2,15,218,207,11,1,2006-01-01,-1,0,"crd",-4
"1","Sun","September 10","W","","1-0",TRUE,"San Francisco 49ers",34,27,23,367,283,84,1,19,393,286,107,2,2006-09-10,1,1,"crd",7
"2","Sun","September 17","L","","1-1",FALSE,"Seattle Seahawks",10,21,17,256,191,65,2,20,341,195,146,2,2006-09-17,0,0,"crd",-11
"3","Sun","September 24","L","","1-2",TRUE,"St. Louis Rams",14,16,20,347,246,101,4,18,364,301,63,2,2006-09-24,-2,0,"crd",-2
"4","Sun","October 1","L","","1-3",FALSE,"Atlanta Falcons",10,32,14,187,161,26,4,19,405,143,262,1,2006-10-01,-3,0,"crd",-22
"5","Sun","October 8","L","","1-4",TRUE,"Kansas City Chiefs",20,23,18,298,222,76,1,18,301,262,39,2,2006-10-08,1,0,"crd",-3
"6","Mon","October 16","L","","1-5",TRUE,"Chicago Bears",23,24,17,286,220,66,2,9,168,130,38,6,2006-10-16,4,0,"crd",-1
"7","Sun","October 22","L","","1-6",FALSE,"Oakland Raiders",9,22,9,224,174,50,2,21,395,258,137,5,2006-10-22,3,0,"crd",-13
"8","Sun","October 29","L","","1-7",FALSE,"Green Bay Packers",14,31,20,218,132,86,1,28,383,180,203,0,2006-10-29,-1,0,"crd",-17
"10","Sun","November 12","L","","1-8",TRUE,"Dallas Cowboys",10,27,17,295,209,86,3,20,434,308,126,0,2006-11-12,-3,0,"crd",-17
"11","Sun","November 19","W","","2-8",TRUE,"Detroit Lions",17,10,20,338,228,110,0,19,281,213,68,1,2006-11-19,1,1,"crd",7
"12","Sun","November 26","L","","2-9",FALSE,"Minnesota Vikings",26,31,22,412,395,17,5,30,412,255,157,1,2006-11-26,-4,0,"crd",-5
"13","Sun","December 3","W","","3-9",FALSE,"St. Louis Rams",34,20,24,316,179,137,0,26,394,287,107,3,2006-12-03,3,1,"crd",14
"14","Sun","December 10","W","","4-9",TRUE,"Seattle Seahawks",27,21,20,345,232,113,1,21,348,228,120,3,2006-12-10,2,1,"crd",6
"15","Sun","December 17","L","","4-10",TRUE,"Denver Broncos",20,37,17,295,195,100,2,26,362,256,106,2,2006-12-17,0,0,"crd",-17
"16","Sun","December 24","W","","5-10",FALSE,"San Francisco 49ers",26,20,21,372,249,123,1,14,223,174,49,2,2006-12-24,1,1,"crd",6
"17","Sun","December 31","L","","5-11",FALSE,"San Diego Chargers",20,27,19,444,346,98,1,23,387,218,169,1,2006-12-31,0,0,"crd",-7
"1","Mon","September 10","L","","0-1",FALSE,"San Francisco 49ers",17,20,20,261,100,161,2,16,194,102,92,1,2007-09-10,-1,0,"crd",-3
"2","Sun","September 16","W","","1-1",TRUE,"Seattle Seahawks",23,20,20,431,299,132,1,18,362,278,84,1,2007-09-16,0,1,"crd",3
"3","Sun","September 23","L","","1-2",FALSE,"Baltimore Ravens",23,26,17,364,303,61,1,23,381,252,129,1,2007-09-23,0,0,"crd",-3
"4","Sun","September 30","W","","2-2",TRUE,"Pittsburgh Steelers",21,14,19,301,215,86,2,17,282,205,77,2,2007-09-30,0,1,"crd",7
"5","Sun","October 7","W","","3-2",FALSE,"St. Louis Rams",34,31,24,383,281,102,2,24,375,252,123,3,2007-10-07,1,1,"crd",3
"6","Sun","October 14","L","","3-3",TRUE,"Carolina Panthers",10,25,10,255,159,96,5,14,374,193,181,0,2007-10-14,-5,0,"crd",-15
"7","Sun","October 21","L","","3-4",FALSE,"Washington Redskins",19,21,19,364,280,84,3,10,160,87,73,1,2007-10-21,-2,0,"crd",-2
"9","Sun","November 4","L","","3-5",FALSE,"Tampa Bay Buccaneers",10,17,9,195,172,23,2,18,350,188,162,0,2007-11-04,-2,0,"crd",-7
"10","Sun","November 11","W","","4-5",TRUE,"Detroit Lions",31,21,21,319,246,73,4,16,247,265,-18,5,2007-11-11,1,1,"crd",10
"11","Sun","November 18","W","","5-5",FALSE,"Cincinnati Bengals",35,27,17,247,197,50,0,21,396,324,72,5,2007-11-18,5,1,"crd",8
"12","Sun","November 25","L","OT","5-6",TRUE,"San Francisco 49ers",31,37,25,552,456,96,4,21,374,237,137,0,2007-11-25,-4,0,"crd",-6
"13","Sun","December 2","W","","6-6",TRUE,"Cleveland Browns",27,21,18,302,169,133,1,21,379,295,84,4,2007-12-02,3,1,"crd",6
"14","Sun","December 9","L","","6-7",FALSE,"Seattle Seahawks",21,42,23,355,305,50,5,21,349,269,80,0,2007-12-09,-5,0,"crd",-21
"15","Sun","December 16","L","","6-8",FALSE,"New Orleans Saints",24,31,17,317,214,103,2,24,421,307,114,2,2007-12-16,0,0,"crd",-7
"16","Sun","December 23","W","OT","7-8",TRUE,"Atlanta Falcons",30,27,24,437,369,68,0,21,405,303,102,1,2007-12-23,1,1,"crd",3
"17","Sun","December 30","W","","8-8",TRUE,"St. Louis Rams",48,19,25,422,300,122,2,13,234,159,75,3,2007-12-30,1,1,"crd",29
"1","Sun","September 7","W","","1-0",FALSE,"San Francisco 49ers",23,13,18,285,176,109,0,13,291,183,108,5,2008-09-07,5,1,"crd",10
"2","Sun","September 14","W","","2-0",TRUE,"Miami Dolphins",31,10,22,445,364,81,0,17,236,164,72,0,2008-09-14,0,1,"crd",21
"3","Sun","September 21","L","","2-1",FALSE,"Washington Redskins",17,24,19,313,197,116,2,21,323,187,136,0,2008-09-21,-2,0,"crd",-7
"4","Sun","September 28","L","","2-2",FALSE,"New York Jets",35,56,33,468,426,42,7,23,373,284,89,1,2008-09-28,-6,0,"crd",-21
"5","Sun","October 5","W","","3-2",TRUE,"Buffalo Bills",41,17,28,373,250,123,0,13,287,203,84,4,2008-10-05,4,1,"crd",24
"6","Sun","October 12","W","OT","4-2",TRUE,"Dallas Cowboys",30,24,14,276,226,50,3,15,374,301,73,1,2008-10-12,-2,1,"crd",6
"8","Sun","October 26","L","","4-3",FALSE,"Carolina Panthers",23,27,25,425,375,50,2,22,351,238,113,1,2008-10-26,-1,0,"crd",-4
"9","Sun","November 2","W","","5-3",FALSE,"St. Louis Rams",34,13,24,510,334,176,0,13,231,170,61,3,2008-11-02,3,1,"crd",21
"10","Mon","November 10","W","","6-3",TRUE,"San Francisco 49ers",29,24,21,374,328,46,0,19,336,217,119,3,2008-11-10,3,1,"crd",5
"11","Sun","November 16","W","","7-3",FALSE,"Seattle Seahawks",26,20,24,458,382,76,3,18,196,153,43,4,2008-11-16,1,1,"crd",6
"12","Sun","November 23","L","","7-4",TRUE,"New York Giants",29,37,27,371,348,23,2,18,321,234,87,0,2008-11-23,-2,0,"crd",-8
"13","Thu","November 27","L","","7-5",FALSE,"Philadelphia Eagles",20,48,12,260,235,25,4,32,437,252,185,1,2008-11-27,-3,0,"crd",-28
"14","Sun","December 7","W","","8-5",TRUE,"St. Louis Rams",34,10,18,335,272,63,1,17,308,223,85,3,2008-12-07,2,1,"crd",24
"15","Sun","December 14","L","","8-6",TRUE,"Minnesota Vikings",14,35,16,316,273,43,2,20,396,157,239,1,2008-12-14,-1,0,"crd",-21
"16","Sun","December 21","L","","8-7",FALSE,"New England Patriots",7,47,8,186,142,44,2,27,514,331,183,0,2008-12-21,-2,0,"crd",-40
"17","Sun","December 28","W","","9-7",TRUE,"Seattle Seahawks",34,21,19,457,346,111,2,24,330,243,87,3,2008-12-28,1,1,"crd",13
"WildCard","Sat","January 3","W","","10-7",TRUE,"Atlanta Falcons",30,24,15,357,271,86,1,20,250,190,60,3,2009-01-03,2,1,"crd",6
"Division","Sat","January 10","W","","11-7",FALSE,"Carolina Panthers",33,13,21,360,215,145,1,16,269,194,75,6,2009-01-10,5,1,"crd",20
"ConfChamp","Sun","January 18","W","","12-7",TRUE,"Philadelphia Eagles",32,25,21,369,267,102,1,22,454,357,97,3,2009-01-18,2,1,"crd",7
"SuperBowl","Sun","February 1","L","","12-8",TRUE,"Pittsburgh Steelers",23,27,23,407,374,33,2,20,292,234,58,1,2009-02-01,-1,0,"crd",-4
"1","Sun","September 13","L","","0-1",TRUE,"San Francisco 49ers",16,20,17,299,259,40,2,13,203,182,21,1,2009-09-13,-1,0,"crd",-4
"2","Sun","September 20","W","","1-1",FALSE,"Jacksonville Jaguars",31,17,22,383,265,118,2,18,367,275,92,3,2009-09-20,1,1,"crd",14
"3","Sun","September 27","L","","1-2",TRUE,"Indianapolis Colts",10,31,21,323,299,24,3,22,505,379,126,1,2009-09-27,-2,0,"crd",-21
"5","Sun","October 11","W","","2-2",TRUE,"Houston Texans",28,21,19,340,296,44,1,23,416,371,45,1,2009-10-11,0,1,"crd",7
"6","Sun","October 18","W","","3-2",FALSE,"Seattle Seahawks",27,3,21,344,282,62,2,7,128,114,14,2,2009-10-18,0,1,"crd",24
"7","Sun","October 25","W","","4-2",FALSE,"New York Giants",24,17,15,288,216,72,2,15,327,220,107,4,2009-10-25,2,1,"crd",7
"8","Sun","November 1","L","","4-3",TRUE,"Carolina Panthers",21,34,23,320,226,94,6,13,355,85,270,0,2009-11-01,-6,0,"crd",-13
"9","Sun","November 8","W","","5-3",FALSE,"Chicago Bears",41,21,27,438,256,182,1,20,417,347,70,1,2009-11-08,0,1,"crd",20
"10","Sun","November 15","W","","6-3",TRUE,"Seattle Seahawks",31,20,22,462,340,122,0,29,472,308,164,2,2009-11-15,2,1,"crd",11
"11","Sun","November 22","W","","7-3",FALSE,"St. Louis Rams",21,13,24,444,261,183,2,16,314,191,123,1,2009-11-22,-1,1,"crd",8
"12","Sun","November 29","L","","7-4",FALSE,"Tennessee Titans",17,20,15,292,217,75,0,20,532,369,163,1,2009-11-29,1,0,"crd",-3
"13","Sun","December 6","W","","8-4",TRUE,"Minnesota Vikings",30,17,20,398,285,113,1,22,315,253,62,2,2009-12-06,1,1,"crd",13
"14","Mon","December 14","L","","8-5",FALSE,"San Francisco 49ers",9,24,11,245,160,85,7,18,327,138,189,2,2009-12-14,-5,0,"crd",-15
"15","Sun","December 20","W","","9-5",FALSE,"Detroit Lions",31,24,21,340,218,122,3,15,282,121,161,3,2009-12-20,0,1,"crd",7
"16","Sun","December 27","W","","10-5",TRUE,"St. Louis Rams",31,10,26,407,297,110,1,14,238,150,88,4,2009-12-27,3,1,"crd",21
"17","Sun","January 3","L","","10-6",TRUE,"Green Bay Packers",7,33,13,187,139,48,3,24,345,236,109,1,2010-01-03,-2,0,"crd",-26
"WildCard","Sun","January 10","W","OT","11-6",TRUE,"Green Bay Packers",51,45,30,531,375,156,1,32,493,404,89,3,2010-01-10,2,1,"crd",6
"Division","Sat","January 16","L","","11-7",FALSE,"New Orleans Saints",14,45,15,359,258,101,2,27,418,247,171,0,2010-01-16,-2,0,"crd",-31
"1","Sun","September 12","W","","1-0",FALSE,"St. Louis Rams",17,13,21,378,266,112,4,20,325,240,85,4,2010-09-12,0,1,"crd",4
"2","Sun","September 19","L","","1-1",FALSE,"Atlanta Falcons",7,41,11,267,149,118,3,33,444,223,221,1,2010-09-19,-2,0,"crd",-34
"3","Sun","September 26","W","","2-1",TRUE,"Oakland Raiders",24,23,18,227,108,119,3,20,364,231,133,1,2010-09-26,-2,1,"crd",1
"4","Sun","October 3","L","","2-2",FALSE,"San Diego Chargers",10,41,10,134,87,47,3,23,419,239,180,1,2010-10-03,-2,0,"crd",-31
"5","Sun","October 10","W","","3-2",TRUE,"New Orleans Saints",30,20,12,194,153,41,1,19,358,273,85,4,2010-10-10,3,1,"crd",10
"7","Sun","October 24","L","","3-3",FALSE,"Seattle Seahawks",10,22,13,227,114,113,5,16,302,158,144,1,2010-10-24,-4,0,"crd",-12
"8","Sun","October 31","L","","3-4",TRUE,"Tampa Bay Buccaneers",35,38,22,396,296,100,4,19,407,253,154,2,2010-10-31,-2,0,"crd",-3
"9","Sun","November 7","L","OT","3-5",FALSE,"Minnesota Vikings",24,27,13,225,172,53,1,28,507,427,80,3,2010-11-07,2,0,"crd",-3
"10","Sun","November 14","L","","3-6",TRUE,"Seattle Seahawks",18,36,19,327,286,41,2,24,490,380,110,1,2010-11-14,-1,0,"crd",-18
"11","Sun","November 21","L","","3-7",FALSE,"Kansas City Chiefs",13,31,19,382,281,101,0,17,352,193,159,0,2010-11-21,0,0,"crd",-18
"12","Mon","November 29","L","","3-8",TRUE,"San Francisco 49ers",6,27,8,203,190,13,2,26,386,125,261,1,2010-11-29,-1,0,"crd",-21
"13","Sun","December 5","L","","3-9",TRUE,"St. Louis Rams",6,19,14,224,119,105,2,18,288,169,119,1,2010-12-05,-1,0,"crd",-13
"14","Sun","December 12","W","","4-9",TRUE,"Denver Broncos",43,13,21,357,146,211,1,20,288,156,132,6,2010-12-12,5,1,"crd",30
"15","Sun","December 19","L","","4-10",FALSE,"Carolina Panthers",12,19,11,218,175,43,2,16,303,126,177,1,2010-12-19,-1,0,"crd",-7
"16","Sat","December 25","W","","5-10",TRUE,"Dallas Cowboys",27,26,10,271,178,93,0,24,382,199,183,3,2010-12-25,3,1,"crd",1
"17","Sun","January 2","L","","5-11",FALSE,"San Francisco 49ers",7,38,19,279,201,78,2,16,362,262,100,0,2011-01-02,-2,0,"crd",-31
"1","Sun","September 11","W","","1-0",TRUE,"Carolina Panthers",28,21,15,394,295,99,1,26,477,403,74,1,2011-09-11,0,1,"crd",7
"2","Sun","September 18","L","","1-1",FALSE,"Washington Redskins",21,22,16,324,231,93,2,28,455,283,172,2,2011-09-18,0,0,"crd",-1
"3","Sun","September 25","L","","1-2",FALSE,"Seattle Seahawks",10,13,20,324,234,90,2,16,261,139,122,1,2011-09-25,-1,0,"crd",-3
"4","Sun","October 2","L","","1-3",TRUE,"New York Giants",27,31,22,368,212,156,2,24,360,306,54,2,2011-10-02,0,0,"crd",-4
"5","Sun","October 9","L","","1-4",FALSE,"Minnesota Vikings",10,34,18,291,214,77,4,20,332,160,172,1,2011-10-09,-3,0,"crd",-24
"7","Sun","October 23","L","","1-5",TRUE,"Pittsburgh Steelers",20,32,23,330,257,73,1,26,445,354,91,0,2011-10-23,-1,0,"crd",-12
"8","Sun","October 30","L","","1-6",FALSE,"Baltimore Ravens",27,30,17,207,98,109,1,30,405,298,107,2,2011-10-30,1,0,"crd",-3
"9","Sun","November 6","W","OT","2-6",TRUE,"St. Louis Rams",19,13,16,262,192,70,0,23,383,233,150,1,2011-11-06,1,1,"crd",6
"10","Sun","November 13","W","","3-6",FALSE,"Philadelphia Eagles",21,17,23,370,282,88,2,15,289,123,166,2,2011-11-13,0,1,"crd",4
"11","Sun","November 20","L","","3-7",FALSE,"San Francisco 49ers",7,23,11,229,149,80,5,25,431,267,164,1,2011-11-20,-4,0,"crd",-16
"12","Sun","November 27","W","","4-7",FALSE,"St. Louis Rams",23,20,16,374,106,268,3,12,272,186,86,2,2011-11-27,-1,1,"crd",3
"13","Sun","December 4","W","OT","5-7",TRUE,"Dallas Cowboys",19,13,16,327,224,103,0,20,336,261,75,0,2011-12-04,0,1,"crd",6
"14","Sun","December 11","W","","6-7",TRUE,"San Francisco 49ers",21,19,12,325,270,55,3,12,233,143,90,0,2011-12-11,-3,1,"crd",2
"15","Sun","December 18","W","OT","7-7",TRUE,"Cleveland Browns",20,17,24,363,289,74,1,16,333,213,120,1,2011-12-18,0,1,"crd",3
"16","Sat","December 24","L","","7-8",FALSE,"Cincinnati Bengals",16,23,17,316,257,59,3,21,301,136,165,2,2011-12-24,-1,0,"crd",-7
"17","Sun","January 1","W","OT","8-8",TRUE,"Seattle Seahawks",23,20,20,388,257,131,2,19,369,191,178,1,2012-01-01,-1,1,"crd",3
